firstname,total_male,total_female,prob_male,prob_female,total_names,male_75,female_75,male_95,female_95
"MICHAEL",8564,10,.9988337,.0011663,8574,1,0,1,0
"DAVID",6164,8,.9987038,.0012962,6172,1,0,1,0
"JOHN",6478,13,.9979972,.0020028,6491,1,0,1,0
"JENNIFER",3,3933,.0007622,.9992378,3936,0,1,0,1
"CHRIS",3688,122,.967979,.032021,3810,1,0,1,0
"JESSICA",1,2965,.0003372,.9996628,2966,0,1,0,1
"LISA",2,3159,.0006327,.9993673,3161,0,1,0,1
"MIKE",3226,5,.9984525,.0015475,3231,1,0,1,0
"ANTHONY",3576,4,.9988827,.0011173,3580,1,0,1,0
"JAMES",3510,13,.9963099,.00369,3523,1,0,1,0
"ROBERT",3687,3,.999187,.000813,3690,1,0,1,0
"JASON",3064,2,.9993477,.0006523,3066,1,0,1,0
"BRIAN",2910,1,.9996565,.0003435,2911,1,0,1,0
"KEVIN",3022,5,.9983482,.0016518,3027,1,0,1,0
"ANDREW",2778,5,.9982034,.0017966,2783,1,0,1,0
"MICHELLE",2,2503,.0007984,.9992016,2505,0,1,0,1
"DANIEL",2802,6,.9978632,.0021368,2808,1,0,1,0
"MARIA",3,2725,.0010997,.9989003,2728,0,1,0,1
"NICOLE",2,2213,.0009029,.999097,2215,0,1,0,1
"ALEX",2203,205,.9148671,.0851329,2408,1,0,0,0
"MELISSA",2,2107,.0009483,.9990517,2109,0,1,0,1
"ERIC",2417,1,.9995865,.0004136,2418,1,0,1,0
"SARAH",3,1837,.0016304,.9983696,1840,0,1,0,1
"MARK",2561,5,.9980515,.0019486,2566,1,0,1,0
"JOE",2578,4,.9984508,.0015492,2582,1,0,1,0
"JOSEPH",2870,4,.9986082,.0013918,2874,1,0,1,0
"STEPHANIE",1,2043,.0004892,.9995108,2044,0,1,0,1
"PAUL",2526,0,1,0,2526,1,0,1,0
"PETER",2514,4,.9984114,.0015886,2518,1,0,1,0
"JONATHAN",2402,2,.999168,.0008319,2404,1,0,1,0
"CHRISTOPHER",2423,3,.9987634,.0012366,2426,1,0,1,0
"LAUREN",4,1554,.0025674,.9974326,1558,0,1,0,1
"LAURA",0,1822,0,1,1822,0,1,0,1
"ELIZABETH",0,2022,0,1,2022,0,1,0,1
"MATTHEW",2048,3,.9985373,.0014627,2051,1,0,1,0
"RICHARD",2395,0,1,0,2395,1,0,1,0
"MATT",1845,3,.9983766,.0016234,1848,1,0,1,0
"STEVEN",2202,2,.9990926,.0009074,2204,1,0,1,0
"MARY",2,2036,.0009814,.9990187,2038,0,1,0,1
"ADAM",1802,4,.9977852,.0022148,1806,1,0,1,0
"KAREN",5,1875,.0026596,.9973404,1880,0,1,0,1
"AMY",2,1429,.0013976,.9986024,1431,0,1,0,1
"CHRISTINE",1,1669,.0005988,.9994012,1670,0,1,0,1
"AMANDA",4,1461,.0027304,.9972696,1465,0,1,0,1
"RACHEL",2,1377,.0014503,.9985497,1379,0,1,0,1
"SUSAN",0,1877,0,1,1877,0,1,0,1
"RYAN",1653,34,.9798459,.0201541,1687,1,0,1,0
"CHRISTINA",3,1447,.002069,.9979311,1450,0,1,0,1
"DANIELLE",0,1350,0,1,1350,0,1,0,1
"STEVE",1762,1,.9994328,.0005672,1763,1,0,1,0
"EMILY",0,1222,0,1,1222,0,1,0,1
"WILLIAM",1874,2,.9989339,.0010661,1876,1,0,1,0
"JOSÃ‰",2012,5,.997521,.0024789,2017,1,0,1,0
"SEAN",1611,9,.9944444,.0055556,1620,1,0,1,0
"SCOTT",1526,2,.9986911,.0013089,1528,1,0,1,0
"ANNA",1,1360,.0007348,.9992653,1361,0,1,0,1
"FRANK",1806,3,.9983416,.0016584,1809,1,0,1,0
"THOMAS",1728,8,.9953917,.0046083,1736,1,0,1,0
"NICK",1499,5,.9966756,.0033245,1504,1,0,1,0
"JUSTIN",1480,4,.9973046,.0026954,1484,1,0,1,0
"ASHLEY",42,1260,.0322581,.9677419,1302,0,1,0,1
"DAN",1352,12,.9912024,.0087977,1364,1,0,1,0
"LINDA",1,1593,.0006274,.9993727,1594,0,1,0,1
"ANDREA",95,1197,.0735294,.9264706,1292,0,1,0,0
"JEFF",1374,0,1,0,1374,1,0,1,0
"GEORGE",1523,8,.9947746,.0052253,1531,1,0,1,0
"PATRICK",1392,3,.9978495,.0021505,1395,1,0,1,0
"ANGELA",4,1294,.0030817,.9969183,1298,0,1,0,1
"TOM",1371,3,.9978166,.0021834,1374,1,0,1,0
"KELLY",71,1067,.0623902,.9376099,1138,0,1,0,0
"KATIE",0,928,0,1,928,0,1,0,1
"STEPHEN",1409,0,1,0,1409,1,0,1,0
"Ä_Ä¨Ã„ÅƒÃ…",1,1247,.0008013,.9991987,1248,0,1,0,1
"BARBARA",0,1577,0,1,1577,0,1,0,1
"SAMANTHA",3,1055,.0028355,.9971645,1058,0,1,0,1
"NANCY",1,1364,.0007326,.9992674,1365,0,1,0,1
"PATRÃçCIA",1,1457,.0006859,.9993141,1458,0,1,0,1
"JULIE",1,971,.0010288,.9989712,972,0,1,0,1
"CARLOS",1450,6,.9958791,.0041209,1456,1,0,1,0
"REBECCA",1,949,.0010526,.9989474,950,0,1,0,1
"SARA",2,937,.0021299,.9978701,939,0,1,0,1
"LUÃçS",1444,3,.9979268,.0020733,1447,1,0,1,0
"JAY",1202,50,.9600639,.0399361,1252,1,0,1,0
"DENISE",2,1238,.0016129,.9983871,1240,0,1,0,1
"KIM",65,1023,.0597426,.9402574,1088,0,1,0,0
"ROB",1060,0,1,0,1060,1,0,1,0
"DANNY",1139,10,.9912968,.0087032,1149,1,0,1,0
"ERIN",17,817,.0203837,.9796163,834,0,1,0,1
"BEN",979,2,.9979613,.0020387,981,1,0,1,0
"HEATHER",1,871,.0011468,.9988532,872,0,1,0,1
"VANESSA",1,997,.001002,.998998,998,0,1,0,1
"CHARLES",1190,1,.9991603,.0008396,1191,1,0,1,0
"KATE",1,743,.0013441,.9986559,744,0,1,0,1
"KIMBERLY",1,941,.0010616,.9989384,942,0,1,0,1
"TONY",1198,3,.9975021,.0024979,1201,1,0,1,0
"TIFFANY",0,949,0,1,949,0,1,0,1
"JUAN",1205,8,.9934048,.0065952,1213,1,0,1,0
"SAM",849,115,.8807054,.1192946,964,1,0,0,0
"DONNA",1,1242,.0008045,.9991955,1243,0,1,0,1
"ERICA",1,838,.0011919,.9988081,839,0,1,0,1
"JEFFREY",1106,0,1,0,1106,1,0,1,0
"GREG",954,0,1,0,954,1,0,1,0
"JOSHUA",1013,3,.9970472,.0029528,1016,1,0,1,0
"JOSH",910,0,1,0,910,1,0,1,0
"SANDRA",0,1076,0,1,1076,0,1,0,1
"SHARON",11,1014,.0107317,.9892683,1025,0,1,0,1
"JENNY",2,799,.0024969,.9975031,801,0,1,0,1
"LIZ",1,791,.0012626,.9987374,792,0,1,0,1
"JÃ_LIA",1,761,.0013123,.9986877,762,0,1,0,1
"JAMIE",242,556,.3032582,.6967419,798,0,0,0,0
"TIM",893,1,.9988815,.0011186,894,1,0,1,0
"MICHELE",29,856,.0327684,.9672316,885,0,1,0,1
"MARC",914,1,.9989071,.0010929,915,1,0,1,0
"AARON",880,1,.9988649,.0011351,881,1,0,1,0
"JIM",993,2,.99799,.00201,995,1,0,1,0
"DAVE",882,0,1,0,882,1,0,1,0
"VICTORIA",4,775,.0051348,.9948652,779,0,1,0,1
"CHRISTIAN",905,12,.9869139,.0130862,917,1,0,1,0
"MEGAN",4,648,.006135,.993865,652,0,1,0,1
"JON",849,2,.9976498,.0023502,851,1,0,1,0
"BILL",958,1,.9989573,.0010428,959,1,0,1,0
"ALLISON",1,622,.0016051,.9983948,623,0,1,0,1
"ANDY",828,27,.968421,.0315789,855,1,0,1,0
"CAROL",1,1019,.0009804,.9990196,1020,0,1,0,1
"GARY",971,2,.9979445,.0020555,973,1,0,1,0
"DIANE",1,955,.001046,.998954,956,0,1,0,1
"JACKIE",31,712,.0417227,.9582772,743,0,1,0,1
"CATHERINE",0,784,0,1,784,0,1,0,1
"TARA",0,698,0,1,698,0,1,0,1
"NATALIE",0,685,0,1,685,0,1,0,1
"VÃçCTOR",974,1,.9989744,.0010256,975,1,0,1,0
"KEITH",869,3,.9965596,.0034404,872,1,0,1,0
"EDWARD",956,0,1,0,956,1,0,1,0
"JACK",868,7,.992,.008,875,1,0,1,0
"GINA",1,711,.0014045,.9985955,712,0,1,0,1
"DANA",57,551,.09375,.90625,608,0,1,0,0
"JEREMY",740,5,.9932886,.0067114,745,1,0,1,0
"NICHOLAS",837,0,1,0,837,1,0,1,0
"KRISTEN",5,580,.008547,.991453,585,0,1,0,1
"ANA",2,788,.0025316,.9974684,790,0,1,0,1
"KATHY",2,838,.002381,.997619,840,0,1,0,1
"BRANDON",741,5,.9932976,.0067024,746,1,0,1,0
"ALEXANDRA",1,606,.0016474,.9983525,607,0,1,0,1
"ANNE",3,733,.0040761,.9959239,736,0,1,0,1
"CYNTHIA",0,761,0,1,761,0,1,0,1
"MÃ“NICA",0,676,0,1,676,0,1,0,1
"VINCENT",868,0,1,0,868,1,0,1,0
"JACQUELINE",2,720,.0027701,.9972299,722,0,1,0,1
"MARIE",1,793,.0012594,.9987406,794,0,1,0,1
"DEBORAH",0,806,0,1,806,0,1,0,1
"KATHERINE",0,624,0,1,624,0,1,0,1
"WENDY",3,685,.0043605,.9956396,688,0,1,0,1
"EDDIE",778,2,.9974359,.0025641,780,1,0,1,0
"CINDY",3,660,.0045249,.9954751,663,0,1,0,1
"ALAN",759,0,1,0,759,1,0,1,0
"DEBBIE",0,732,0,1,732,0,1,0,1
"TINA",1,646,.0015456,.9984544,647,0,1,0,1
"JIMMY",695,3,.995702,.004298,698,1,0,1,0
"DAWN",2,708,.0028169,.9971831,710,0,1,0,1
"KATHLEEN",0,708,0,1,708,0,1,0,1
"DENNIS",801,3,.9962686,.0037313,804,1,0,1,0
"CRYSTAL",2,676,.0029499,.9970502,678,0,1,0,1
"LESLIE",69,564,.1090047,.8909953,633,0,1,0,0
"JILL",2,560,.0035587,.9964413,562,0,1,0,1
"ROBIN",103,580,.1508053,.8491947,683,0,1,0,0
"BRYAN",643,2,.9968992,.0031008,645,1,0,1,0
"IAN",621,1,.9983923,.0016077,622,1,0,1,0
"JESSE",621,49,.9268657,.0731343,670,1,0,0,0
"ALEXANDER",702,2,.9971591,.0028409,704,1,0,1,0
"HENRY",718,2,.9972222,.0027778,720,1,0,1,0
"KRISTIN",1,477,.002092,.9979079,478,0,1,0,1
"PAMELA",0,669,0,1,669,0,1,0,1
"BETH",0,533,0,1,533,0,1,0,1
"CRAIG",669,1,.9985074,.0014925,670,1,0,1,0
"JANET",0,716,0,1,716,0,1,0,1
"LORI",3,599,.0049834,.9950166,602,0,1,0,1
"JANE",1,594,.0016807,.9983193,595,0,1,0,1
"GREGORY",718,1,.9986092,.0013908,719,1,0,1,0
"NATASHA",1,603,.0016556,.9983444,604,0,1,0,1
"JEN",3,449,.0066372,.9933628,452,0,1,0,1
"JORDAN",511,91,.8488372,.1511628,602,1,0,0,0
"SHAWN",656,55,.9226441,.0773558,711,1,0,0,0
"KYLE",650,21,.9687034,.0312966,671,1,0,1,0
"THERESA",0,661,0,1,661,0,1,0,1
"CAROLINE",0,505,0,1,505,0,1,0,1
"JOANNE",0,671,0,1,671,0,1,0,1
"JOEL",693,5,.9928367,.0071633,698,1,0,1,0
"ANGEL",631,150,.8079385,.1920615,781,1,0,0,0
"ALICIA",0,594,0,1,594,0,1,0,1
"JOEY",617,34,.9477727,.0522273,651,1,0,0,0
"CARMEN",12,710,.0166205,.9833795,722,0,1,0,1
"KEN",656,2,.9969605,.0030395,658,1,0,1,0
"ELLEN",0,624,0,1,624,0,1,0,1
"LINDSAY",8,415,.0189125,.9810874,423,0,1,0,1
"ANN",1,661,.0015106,.9984894,662,0,1,0,1
"VALERIE",0,618,0,1,618,0,1,0,1
"TRACY",24,555,.0414508,.9585492,579,0,1,0,1
"COURTNEY",87,387,.1835443,.8164557,474,0,1,0,0
"MELANIE",1,524,.0019048,.9980952,525,0,1,0,1
"BENJAMIN",587,1,.9982993,.0017007,588,1,0,1,0
"PHILIP",642,1,.9984448,.0015552,643,1,0,1,0
"JEAN",327,376,.4651494,.5348507,703,0,0,0,0
"KENNETH",704,0,1,0,704,1,0,1,0
"SHANNON",48,424,.1016949,.8983051,472,0,1,0,0
"LARRY",685,2,.9970888,.0029112,687,1,0,1,0
"STACEY",11,517,.0208333,.9791667,528,0,1,0,1
"WILL",552,0,1,0,552,1,0,1,0
"ALISON",2,430,.0046296,.9953704,432,0,1,0,1
"ALEXIS",120,377,.2414487,.7585513,497,0,1,0,0
"BOB",688,4,.9942197,.0057803,692,1,0,1,0
"RAYMOND",618,3,.9951691,.0048309,621,1,0,1,0
"GRACE",1,513,.0019455,.9980545,514,0,1,0,1
"JUDY",0,583,0,1,583,0,1,0,1
"MARGARET",0,605,0,1,605,0,1,0,1
"VERÃ“NICA",1,560,.0017825,.9982175,561,0,1,0,1
"ALI",308,151,.671024,.328976,459,0,0,0,0
"ANNIE",0,462,0,1,462,0,1,0,1
"HELEN",0,564,0,1,564,0,1,0,1
"JORGE",661,1,.9984894,.0015106,662,1,0,1,0
"MAX",513,9,.9827586,.0172414,522,1,0,1,0
"EVAN",516,4,.9923077,.0076923,520,1,0,1,0
"JOHNNY",623,3,.9952077,.0047923,626,1,0,1,0
"CLAUDIA",0,512,0,1,512,0,1,0,1
"JOANNA",0,430,0,1,430,0,1,0,1
"CAROLYN",0,522,0,1,522,0,1,0,1
"ERIKA",1,457,.0021834,.9978166,458,0,1,0,1
"RON",569,1,.9982456,.0017544,570,1,0,1,0
"TIMOTHY",600,1,.9983361,.0016639,601,1,0,1,0
"JÃ‰RRY",631,3,.9952682,.0047319,634,1,0,1,0
"RAY",590,11,.9816971,.0183028,601,1,0,1,0
"ANDRE",598,5,.9917081,.0082919,603,1,0,1,0
"LOUIS",594,1,.9983193,.0016807,595,1,0,1,0
"RICH",539,1,.9981481,.0018519,540,1,0,1,0
"MARTIN",534,6,.9888889,.0111111,540,1,0,1,0
"TOMMY",520,4,.9923664,.0076336,524,1,0,1,0
"MAUREEN",0,543,0,1,543,0,1,0,1
"MÃèGÃ›Ã‰L",612,2,.9967427,.0032573,614,1,0,1,0
"CHERYL",1,552,.0018083,.9981917,553,0,1,0,1
"CATHY",0,562,0,1,562,0,1,0,1
"EILEEN",0,538,0,1,538,0,1,0,1
"TODD",481,0,1,0,481,1,0,1,0
"BÃèLLY",517,5,.9904215,.0095785,522,1,0,1,0
"TANYA",4,484,.0081967,.9918033,488,0,1,0,1
"PAULA",0,507,0,1,507,0,1,0,1
"SANDY",66,430,.1330645,.8669355,496,0,1,0,0
"SUZANNE",0,448,0,1,448,0,1,0,1
"CHARLIE",494,21,.9592233,.0407767,515,1,0,1,0
"JASMINE",0,469,0,1,469,0,1,0,1
"EVELYN",2,556,.0035842,.9964158,558,0,1,0,1
"SABRINA",1,458,.0021786,.9978213,459,0,1,0,1
"NINA",0,425,0,1,425,0,1,0,1
"RENEE",1,485,.0020576,.9979424,486,0,1,0,1
"RICK",535,2,.9962756,.0037244,537,1,0,1,0
"MONIQUE",0,456,0,1,456,0,1,0,1
"LEE",324,130,.7136564,.2863436,454,0,0,0,0
"BOBBY",517,6,.9885277,.0114723,523,1,0,1,0
"BRITTANY",0,389,0,1,389,0,1,0,1
"ED",491,1,.9979675,.0020325,492,1,0,1,0
"MARIO",548,0,1,0,548,1,0,1,0
"EDWIN",558,2,.9964285,.0035714,560,1,0,1,0
"DEBRA",0,528,0,1,528,0,1,0,1
"DEREK",471,0,1,0,471,1,0,1,0
"STACY",10,397,.02457,.97543,407,0,1,0,1
"JOAN",23,542,.040708,.9592921,565,0,1,0,1
"PAT",241,285,.4581749,.5418251,526,0,0,0,0
"GABRIEL",462,6,.9871795,.0128205,468,1,0,1,0
"KENNY",463,4,.9914347,.0085653,467,1,0,1,0
"OMAR",495,2,.9959759,.0040241,497,1,0,1,0
"JAKE",432,4,.9908257,.0091743,436,1,0,1,0
"JAIME",211,193,.5222772,.4777228,404,0,0,0,0
"LEAH",3,348,.008547,.991453,351,0,1,0,1
"ALICE",0,405,0,1,405,0,1,0,1
"IRENE",1,431,.0023148,.9976852,432,0,1,0,1
"ANTONIO",516,1,.9980658,.0019342,517,1,0,1,0
"MAGGIE",0,360,0,1,360,0,1,0,1
"PHIL",410,2,.9951456,.0048544,412,1,0,1,0
"ERIK",440,0,1,0,440,1,0,1,0
"COLLEEN",0,343,0,1,343,0,1,0,1
"ALYSSA",0,311,0,1,311,0,1,0,1
"RAFAEL",513,1,.9980545,.0019455,514,1,0,1,0
"ROSE",1,492,.0020284,.9979716,493,0,1,0,1
"KRISTINA",0,327,0,1,327,0,1,0,1
"BRUCE",495,0,1,0,495,1,0,1,0
"SAMUEL",461,0,1,0,461,1,0,1,0
"ADRIÃÅN",416,34,.9244444,.0755556,450,1,0,0,0
"SONIA",1,434,.0022989,.9977012,435,0,1,0,1
"NIKKI",5,391,.0126263,.9873737,396,0,1,0,1
"ELAINE",0,469,0,1,469,0,1,0,1
"GLORIA",0,457,0,1,457,0,1,0,1
"BRENDA",0,474,0,1,474,0,1,0,1
"JENNA",0,300,0,1,300,0,1,0,1
"JOYCE",0,461,0,1,461,0,1,0,1
"TERESA",2,402,.0049505,.9950495,404,0,1,0,1
"NEIL",406,0,1,0,406,1,0,1,0
"ELENA",1,387,.0025773,.9974227,388,0,1,0,1
"RONALD",516,0,1,0,516,1,0,1,0
"ALBERT",429,2,.9953596,.0046404,431,1,0,1,0
"MARINA",0,342,0,1,342,0,1,0,1
"CARL",426,1,.9976581,.0023419,427,1,0,1,0
"CLAIRE",1,314,.0031746,.9968254,315,0,1,0,1
"MEREDITH",0,249,0,1,249,0,1,0,1
"RUTH",0,412,0,1,412,0,1,0,1
"RANDY",404,26,.9395349,.0604651,430,1,0,0,0
"IVÃÅN",430,2,.9953704,.0046296,432,1,0,1,0
"JACOB",378,1,.9973615,.0026385,379,1,0,1,0
"JARED",352,1,.9971671,.0028329,353,1,0,1,0
"LAURIE",2,382,.0052083,.9947917,384,0,1,0,1
"HÃ‰CTOR",473,1,.9978903,.0021097,474,1,0,1,0
"MEGHAN",0,256,0,1,256,0,1,0,1
"LYNN",13,360,.0348525,.9651474,373,0,1,0,1
"MIRIAM",1,366,.0027248,.9972752,367,0,1,0,1
"BRAD",359,1,.9972222,.0027778,360,1,0,1,0
"LUCY",0,396,0,1,396,0,1,0,1
"EMMA",1,321,.0031056,.9968944,322,0,1,0,1
"RICARDO",443,1,.9977477,.0022523,444,1,0,1,0
"CARRIE",0,301,0,1,301,0,1,0,1
"BRÃ‹NDAN",346,0,1,0,346,1,0,1,0
"REGINA",1,406,.002457,.997543,407,0,1,0,1
"CRISTINA",1,280,.0035587,.9964413,281,0,1,0,1
"HANNAH",1,286,.0034843,.9965157,287,0,1,0,1
"ARIEL",229,105,.6856288,.3143713,334,0,0,0,0
"ESTHER",0,334,0,1,334,0,1,0,1
"CAITLIN",1,224,.0044444,.9955556,225,0,1,0,1
"COREY",343,34,.9098143,.0901857,377,1,0,0,0
"EVA",0,356,0,1,356,0,1,0,1
"BRETT",296,22,.9308176,.0691824,318,1,0,0,0
"DOUG",357,0,1,0,357,1,0,1,0
"DOUGLAS",391,0,1,0,391,1,0,1,0
"EUGENE",358,7,.9808219,.0191781,365,1,0,1,0
"FRED",429,3,.9930556,.0069444,432,1,0,1,0
"TERRY",236,183,.5632458,.4367542,419,0,0,0,0
"DON",401,5,.9876847,.0123153,406,1,0,1,0
"SIMÃ“N",355,2,.9943978,.0056022,357,1,0,1,0
"RALPH",426,0,1,0,426,1,0,1,0
"SETH",347,2,.9942693,.0057307,349,1,0,1,0
"JANICE",0,397,0,1,397,0,1,0,1
"NATHAN",330,1,.9969789,.0030211,331,1,0,1,0
"MARTHA",1,406,.002457,.997543,407,0,1,0,1
"LORRAINE",1,434,.0022989,.9977012,435,0,1,0,1
"MARISSA",1,249,.004,.996,250,0,1,0,1
"MOLLY",0,230,0,1,230,0,1,0,1
"VIVIAN",2,336,.0059172,.9940829,338,0,1,0,1
"TAMARA",1,313,.0031847,.9968153,314,0,1,0,1
"BARRY",391,4,.9898734,.0101266,395,1,0,1,0
"PETE",361,0,1,0,361,1,0,1,0
"SHEILA",1,397,.0025126,.9974874,398,0,1,0,1
"SOPHIA",1,286,.0034843,.9965157,287,0,1,0,1
"MARILYN",1,424,.0023529,.997647,425,0,1,0,1
"ARTHUR",389,1,.9974359,.0025641,390,1,0,1,0
"LAWRENCE",396,1,.9974811,.0025189,397,1,0,1,0
"OLGA",0,319,0,1,319,0,1,0,1
"TYLER",309,17,.9478528,.0521472,326,1,0,0,0
"Ã“SCAR",388,5,.9872773,.0127226,393,1,0,1,0
"KERRY",71,237,.2305195,.7694805,308,0,1,0,0
"JULIO",423,2,.9952941,.0047059,425,1,0,1,0
"CARLA",0,322,0,1,322,0,1,0,1
"YVONNE",2,389,.0051151,.9948849,391,0,1,0,1
"SASHA",68,230,.2281879,.7718121,298,0,1,0,0
"HARRY",361,3,.9917582,.0082418,364,1,0,1,0
"JULIAN",314,6,.98125,.01875,320,1,0,1,0
"TRAVIS",386,1,.997416,.002584,387,1,0,1,0
"DINA",1,276,.0036101,.9963899,277,0,1,0,1
"RITA",0,370,0,1,370,0,1,0,1
"ROGER",378,1,.9973615,.0026385,379,1,0,1,0
"ANGIE",1,301,.0033113,.9966887,302,0,1,0,1
"JOY",10,314,.0308642,.9691358,324,0,1,0,1
"JUDITH",0,376,0,1,376,0,1,0,1
"NELSON",374,1,.9973333,.0026667,375,1,0,1,0
"APRIL",0,326,0,1,326,0,1,0,1
"ROSA",0,373,0,1,373,0,1,0,1
"ANNETTE",0,372,0,1,372,0,1,0,1
"HOWARD",367,0,1,0,367,1,0,1,0
"SHIRLEY",2,313,.0063492,.9936508,315,0,1,0,1
"ANITA",0,329,0,1,329,0,1,0,1
"MARCUS",352,1,.9971671,.0028329,353,1,0,1,0
"FERNANDO",389,3,.9923469,.0076531,392,1,0,1,0
"GAIL",1,398,.0025063,.9974937,399,0,1,0,1
"DONALD",410,0,1,0,410,1,0,1,0
"RICKY",355,7,.980663,.019337,362,1,0,1,0
"SUE",1,306,.0032573,.9967427,307,0,1,0,1
"MARCO",367,1,.9972826,.0027174,368,1,0,1,0
"WAYNE",390,1,.9974425,.0025575,391,1,0,1,0
"JÃ“HANNA",1,277,.0035971,.9964029,278,0,1,0,1
"TAYLOR",102,167,.3791822,.6208178,269,0,0,0,0
"Ã–LIVIA",0,235,0,1,235,0,1,0,1
"AMBER",1,268,.0037175,.9962825,269,0,1,0,1
"MARISA",0,225,0,1,225,0,1,0,1
"AL",356,9,.9753425,.0246575,365,1,0,1,0
"LINDSEY",6,231,.0253165,.9746835,237,0,1,0,1
"JILLIAN",0,241,0,1,241,0,1,0,1
"NADIA",0,269,0,1,269,0,1,0,1
"ROBERTO",353,0,1,0,353,1,0,1,0
"YVETTE",1,339,.0029412,.9970588,340,0,1,0,1
"FRANCISCO",346,0,1,0,346,1,0,1,0
"HOLLY",2,257,.007722,.992278,259,0,1,0,1
"YOLANDA",0,347,0,1,347,0,1,0,1
"JOANN",0,355,0,1,355,0,1,0,1
"SIMONE",28,281,.0906149,.9093851,309,0,1,0,0
"JESSIE",37,220,.1439689,.8560311,257,0,1,0,0
"ZACH",246,1,.9959514,.0040486,247,1,0,1,0
"ANDRÃ‰S",291,0,1,0,291,1,0,1,0
"PEDRO",358,1,.9972145,.0027855,359,1,0,1,0
"LILY",1,229,.0043478,.9956522,230,0,1,0,1
"DREW",269,9,.9676259,.0323741,278,1,0,1,0
"CHAD",283,2,.9929824,.0070175,285,1,0,1,0
"JAVIER",325,1,.9969325,.0030675,326,1,0,1,0
"FRANCES",0,303,0,1,303,0,1,0,1
"CAROLINA",2,266,.0074627,.9925373,268,0,1,0,1
"KATHRYN",0,256,0,1,256,0,1,0,1
"LEO",308,6,.9808917,.0191083,314,1,0,1,0
"NATALIA",1,264,.0037736,.9962264,265,0,1,0,1
"BONNIE",1,294,.0033898,.9966102,295,0,1,0,1
"CASEY",122,116,.5126051,.487395,238,0,0,0,0
"HEIDI",0,247,0,1,247,0,1,0,1
"JOSEPHINE",0,326,0,1,326,0,1,0,1
"NAOMI",2,269,.0073801,.9926199,271,0,1,0,1
"MANUEL",338,2,.9941176,.0058824,340,1,0,1,0
"WALTER",345,1,.9971098,.0028902,346,1,0,1,0
"TRACEY",11,274,.0385965,.9614035,285,0,1,0,1
"DARREN",289,0,1,0,289,1,0,1,0
"GLENN",304,4,.987013,.012987,308,1,0,1,0
"LUKE",278,0,1,0,278,1,0,1,0
"ALLEN",303,4,.9869707,.0130293,307,1,0,1,0
"CAMILLE",6,309,.0190476,.9809524,315,0,1,0,1
"SALLY",1,281,.0035461,.9964539,282,0,1,0,1
"SYLVIA",0,312,0,1,312,0,1,0,1
"FELICIA",0,305,0,1,305,0,1,0,1
"IRIS",1,316,.0031546,.9968454,317,0,1,0,1
"BIANCA",1,249,.004,.996,250,0,1,0,1
"FELIX",326,1,.9969419,.0030581,327,1,0,1,0
"ARLENE",0,328,0,1,328,0,1,0,1
"KARINA",0,249,0,1,249,0,1,0,1
"COLIN",258,0,1,0,258,1,0,1,0
"BROOKE",4,212,.0185185,.9814815,216,0,1,0,1
"ABBY",7,208,.0325581,.9674419,215,0,1,0,1
"MORGAN",88,133,.3981901,.60181,221,0,0,0,0
"TED",283,0,1,0,283,1,0,1,0
"ISAAC",271,2,.992674,.007326,273,1,0,1,0
"JODI",6,235,.0248963,.9751037,241,0,1,0,1
"FRANCESCA",0,223,0,1,223,0,1,0,1
"ADRIENNE",0,250,0,1,250,0,1,0,1
"ANGELO",293,1,.9965987,.0034014,294,1,0,1,0
"ELI",211,10,.9547511,.0452489,221,1,0,1,0
"RUSSELL",273,0,1,0,273,1,0,1,0
"ADRIANA",1,255,.0039063,.9960938,256,0,1,0,1
"CÃ‰SAR",295,2,.993266,.006734,297,1,0,1,0
"TONI",20,281,.0664452,.9335548,301,0,1,0,0
"WANDA",1,323,.0030864,.9969136,324,0,1,0,1
"SAL",285,0,1,0,285,1,0,1,0
"VIRGINIA",0,286,0,1,286,0,1,0,1
"AUDREY",0,258,0,1,258,0,1,0,1
"JENN",1,190,.0052356,.9947644,191,0,1,0,1
"CHELSEA",1,168,.0059172,.9940829,169,0,1,0,1
"LATOYA",0,281,0,1,281,0,1,0,1
"DANIELA",2,210,.009434,.990566,212,0,1,0,1
"TRICIA",0,232,0,1,232,0,1,0,1
"SHANE",259,10,.9628253,.0371747,269,1,0,1,0
"DESIREE",0,256,0,1,256,0,1,0,1
"BETTY",0,284,0,1,284,0,1,0,1
"JANINE",0,231,0,1,231,0,1,0,1
"CONNIE",0,265,0,1,265,0,1,0,1
"KARA",1,186,.0053476,.9946524,187,0,1,0,1
"CASSANDRA",0,264,0,1,264,0,1,0,1
"JEANETTE",0,276,0,1,276,0,1,0,1
"BECKY",0,201,0,1,201,0,1,0,1
"RAQUEL",0,249,0,1,249,0,1,0,1
"PEGGY",1,279,.0035714,.9964285,280,0,1,0,1
"PHILLIP",278,0,1,0,278,1,0,1,0
"KEISHA",1,273,.0036496,.9963503,274,0,1,0,1
"VICKY",2,216,.0091743,.9908257,218,0,1,0,1
"GABRIELLE",0,202,0,1,202,0,1,0,1
"MARLENE",0,250,0,1,250,0,1,0,1
"STEFANIE",1,173,.0057471,.9942529,174,0,1,0,1
"TAMMY",0,230,0,1,230,0,1,0,1
"VINNY",266,4,.9851852,.0148148,270,1,0,1,0
"JESS",21,162,.1147541,.8852459,183,0,1,0,0
"ROY",253,2,.9921569,.0078431,255,1,0,1,0
"DOROTHY",0,275,0,1,275,0,1,0,1
"MANNY",269,2,.9926199,.0073801,271,1,0,1,0
"CANDICE",0,192,0,1,192,0,1,0,1
"DOMINIQUE",37,199,.1567797,.8432204,236,0,1,0,0
"FRANCIS",238,30,.8880597,.1119403,268,1,0,0,0
"KATRINA",1,221,.0045045,.9954955,222,0,1,0,1
"DIEGO",278,0,1,0,278,1,0,1,0
"RICHIE",271,3,.9890511,.0109489,274,1,0,1,0
"INGRID",0,239,0,1,239,0,1,0,1
"TATIANA",2,222,.0089286,.9910714,224,0,1,0,1
"DEAN",224,2,.9911504,.0088496,226,1,0,1,0
"DWAYNE",294,0,1,0,294,1,0,1,0
"CARA",0,182,0,1,182,0,1,0,1
"DEE",89,166,.3490196,.6509804,255,0,0,0,0
"MARCIA",1,266,.0037453,.9962547,267,0,1,0,1
"SOPHIE",0,180,0,1,180,0,1,0,1
"SHAUN",220,7,.969163,.030837,227,1,0,1,0
"ZACHARY",212,0,1,0,212,1,0,1,0
"ARI",172,24,.877551,.122449,196,1,0,0,0
"TROY",268,5,.981685,.018315,273,1,0,1,0
"EDGAR",264,0,1,0,264,1,0,1,0
"FRANKIE",242,20,.9236641,.0763359,262,1,0,0,0
"MAYA",3,153,.0192308,.9807692,156,0,1,0,1
"DERRICK",263,0,1,0,263,1,0,1,0
"JEANNE",0,247,0,1,247,0,1,0,1
"SALVATORE",276,0,1,0,276,1,0,1,0
"LYDIA",0,219,0,1,219,0,1,0,1
"NADINE",0,239,0,1,239,0,1,0,1
"ROBYN",3,191,.0154639,.9845361,194,0,1,0,1
"NORA",0,186,0,1,186,0,1,0,1
"ROSEMARY",0,256,0,1,256,0,1,0,1
"PATTY",2,217,.0091324,.9908676,219,0,1,0,1
"PHYLLIS",0,288,0,1,288,0,1,0,1
"ALBERTO",285,1,.9965035,.0034965,286,1,0,1,0
"SEBASTIAN",229,0,1,0,229,1,0,1,0
"BETSY",0,208,0,1,208,0,1,0,1
"LILLIAN",1,246,.0040486,.9959514,247,0,1,0,1
"EMMANUEL",254,0,1,0,254,1,0,1,0
"IRINA",0,205,0,1,205,0,1,0,1
"DEVON",161,50,.7630332,.2369668,211,1,0,0,0
"NOAH",194,1,.9948718,.0051282,195,1,0,1,0
"STANLEY",245,2,.9919028,.0080972,247,1,0,1,0
"DYLAN",192,11,.9458128,.0541872,203,1,0,0,0
"JACLYN",0,151,0,1,151,0,1,0,1
"SHERRY",0,207,0,1,207,0,1,0,1
"ANGELICA",0,227,0,1,227,0,1,0,1
"BRIDGET",0,169,0,1,169,0,1,0,1
"ROSS",199,2,.9900498,.0099502,201,1,0,1,0
"EBONY",0,235,0,1,235,0,1,0,1
"RAMON",268,0,1,0,268,1,0,1,0
"RUBÃ‰N",237,0,1,0,237,1,0,1,0
"DAISY",1,216,.0046083,.9953917,217,0,1,0,1
"CHARLOTTE",1,186,.0053476,.9946524,187,0,1,0,1
"TREVOR",224,0,1,0,224,1,0,1,0
"MARVIN",243,0,1,0,243,1,0,1,0
"MAURICE",251,1,.9960318,.0039683,252,1,0,1,0
"MADELINE",0,234,0,1,234,0,1,0,1
"EDUARDO",241,0,1,0,241,1,0,1,0
"GENE",229,3,.987069,.012931,232,1,0,1,0
"MIA",0,196,0,1,196,0,1,0,1
"PRISCILLA",0,203,0,1,203,0,1,0,1
"LUZ",1,247,.0040323,.9959677,248,0,1,0,1
"ROSEMARIE",0,249,0,1,249,0,1,0,1
"SERGIO",241,0,1,0,241,1,0,1,0
"WHITNEY",13,170,.0710383,.9289618,183,0,1,0,0
"LEON",217,0,1,0,217,1,0,1,0
"PAOLA",1,195,.005102,.994898,196,0,1,0,1
"PABLO",225,0,1,0,225,1,0,1,0
"SHARI",1,179,.0055556,.9944444,180,0,1,0,1
"RONNIE",168,67,.7148936,.2851064,235,0,0,0,0
"ABIGAIL",0,165,0,1,165,0,1,0,1
"RAÃ_L",235,2,.9915612,.0084388,237,1,0,1,0
"ALEXA",0,154,0,1,154,0,1,0,1
"ELISA",0,176,0,1,176,0,1,0,1
"ETHAN",196,1,.9949238,.0050761,197,1,0,1,0
"JOCELYN",4,166,.0235294,.9764706,170,0,1,0,1
"MELINDA",1,185,.0053763,.9946237,186,0,1,0,1
"MARYANN",0,221,0,1,221,0,1,0,1
"OLIVER",198,0,1,0,198,1,0,1,0
"STUART",215,0,1,0,215,1,0,1,0
"CECILIA",0,196,0,1,196,0,1,0,1
"KRISTINE",0,172,0,1,172,0,1,0,1
"ISABEL",0,192,0,1,192,0,1,0,1
"ALEJANDRO",208,0,1,0,208,1,0,1,0
"AVI",168,2,.9882353,.0117647,170,1,0,1,0
"JEROME",243,2,.9918367,.0081633,245,1,0,1,0
"DORIS",2,219,.0090498,.9909502,221,0,1,0,1
"FRAN",11,217,.0482456,.9517544,228,0,1,0,1
"CORY",154,14,.9166667,.0833333,168,1,0,0,0
"MARLON",228,0,1,0,228,1,0,1,0
"LIZA",0,175,0,1,175,0,1,0,1
"CHARLENE",0,199,0,1,199,0,1,0,1
"KRYSTAL",0,191,0,1,191,0,1,0,1
"TANIA",0,154,0,1,154,0,1,0,1
"DOREEN",0,230,0,1,230,0,1,0,1
"STELLA",1,186,.0053476,.9946524,187,0,1,0,1
"CHUCK",216,2,.9908257,.0091743,218,1,0,1,0
"JAN",115,86,.5721393,.4278607,201,0,0,0,0
"LINA",0,180,0,1,180,0,1,0,1
"ANTOINETTE",0,197,0,1,197,0,1,0,1
"PAM",0,173,0,1,173,0,1,0,1
"RÃ“DNEY",221,0,1,0,221,1,0,1,0
"JESÃ_S",235,3,.9873949,.012605,238,1,0,1,0
"WILSON",199,3,.9851485,.0148515,202,1,0,1,0
"JUSTINE",2,134,.0147059,.9852941,136,0,1,0,1
"BERNADETTE",0,212,0,1,212,0,1,0,1
"CURTIS",229,2,.991342,.008658,231,1,0,1,0
"BEVERLY",0,249,0,1,249,0,1,0,1
"LOUISE",0,210,0,1,210,0,1,0,1
"SAMMY",164,26,.8631579,.1368421,190,1,0,0,0
"AHMED",198,0,1,0,198,1,0,1,0
"LARA",0,139,0,1,139,0,1,0,1
"KRIS",127,47,.729885,.2701149,174,0,0,0,0
"DEVIN",139,27,.8373494,.1626506,166,1,0,0,0
"LOU",185,19,.9068627,.0931373,204,1,0,0,0
"MARIANNE",0,172,0,1,172,0,1,0,1
"NOEL",185,22,.8937198,.1062802,207,1,0,0,0
"CALVIN",214,0,1,0,214,1,0,1,0
"MEG",0,135,0,1,135,0,1,0,1
"CHRISTY",2,139,.0141844,.9858156,141,0,1,0,1
"MARISOL",0,215,0,1,215,0,1,0,1
"GABRIELA",0,151,0,1,151,0,1,0,1
"LANCE",196,0,1,0,196,1,0,1,0
"RACHAEL",0,150,0,1,150,0,1,0,1
"GIOVANNI",211,4,.9813954,.0186047,215,1,0,1,0
"MINDY",0,172,0,1,172,0,1,0,1
"NATE",191,3,.9845361,.0154639,194,1,0,1,0
"ALLAN",213,0,1,0,213,1,0,1,0
"KARL",179,0,1,0,179,1,0,1,0
"TYRONE",242,0,1,0,242,1,0,1,0
"GUY",188,1,.994709,.005291,189,1,0,1,0
"MARSHA",1,193,.0051546,.9948454,194,0,1,0,1
"WARREN",206,2,.9903846,.0096154,208,1,0,1,0
"KELVIN",213,1,.9953271,.0046729,214,1,0,1,0
"JENNIE",0,147,0,1,147,0,1,0,1
"MITCHELL",203,3,.9854369,.0145631,206,1,0,1,0
"JAMAL",204,0,1,0,204,1,0,1,0
"KAYLA",0,128,0,1,128,0,1,0,1
"NICOLÃÅS",189,0,1,0,189,1,0,1,0
"AUSTIN",160,7,.9580838,.0419162,167,1,0,1,0
"KARLA",1,167,.0059524,.9940476,168,0,1,0,1
"MOHAMED",221,2,.9910314,.0089686,223,1,0,1,0
"GERARD",212,0,1,0,212,1,0,1,0
"DEANNA",0,147,0,1,147,0,1,0,1
"KAY",40,122,.2469136,.7530864,162,0,1,0,0
"FREDDY",197,0,1,0,197,1,0,1,0
"JUNIOR",208,1,.9952153,.0047847,209,1,0,1,0
"ERICK",213,0,1,0,213,1,0,1,0
"MARITZA",0,178,0,1,178,0,1,0,1
"MIMI",1,158,.0062893,.9937107,159,0,1,0,1
"NORMA",1,212,.0046948,.9953052,213,0,1,0,1
"CARLY",2,135,.0145985,.9854015,137,0,1,0,1
"HAROLD",220,0,1,0,220,1,0,1,0
"RHONDA",0,193,0,1,193,0,1,0,1
"SHELLY",6,167,.0346821,.9653179,173,0,1,0,1
"ALANA",0,132,0,1,132,0,1,0,1
"AIMEE",1,118,.0084034,.9915966,119,0,1,0,1
"ANASTASIA",0,148,0,1,148,0,1,0,1
"DOMINICK",194,2,.9897959,.0102041,196,1,0,1,0
"VICKI",1,159,.00625,.99375,160,0,1,0,1
"MARGARITA",0,178,0,1,178,0,1,0,1
"MANDY",1,142,.006993,.993007,143,0,1,0,1
"DARRYL",193,3,.9846939,.0153061,196,1,0,1,0
"DARLENE",0,200,0,1,200,0,1,0,1
"MOHAMMED",193,1,.9948454,.0051546,194,1,0,1,0
"RANDI",3,139,.0211268,.9788733,142,0,1,0,1
"LENNY",173,10,.9453552,.0546448,183,1,0,0,0
"ROMAN",164,1,.9939394,.0060606,165,1,0,1,0
"BERNARD",186,0,1,0,186,1,0,1,0
"FRANCINE",0,189,0,1,189,0,1,0,1
"DAMIAN",193,0,1,0,193,1,0,1,0
"JUNE",19,171,.1,.9,190,0,1,0,0
"SOFIA",0,160,0,1,160,0,1,0,1
"XAVIER",179,2,.9889503,.0110497,181,1,0,1,0
"ORLANDO",194,0,1,0,194,1,0,1,0
"ZOE",3,129,.0227273,.9772727,132,0,1,0,1
"KURT",186,0,1,0,186,1,0,1,0
"LEIGH",20,107,.1574803,.8425197,127,0,1,0,0
"TERRI",2,172,.0114943,.9885057,174,0,1,0,1
"LENA",0,122,0,1,122,0,1,0,1
"NATHANIEL",168,1,.9940829,.0059172,169,1,0,1,0
"STEFAN",167,0,1,0,167,1,0,1,0
"ELISE",0,132,0,1,132,0,1,0,1
"RENE",154,31,.8324324,.1675676,185,1,0,0,0
"TASHA",1,182,.0054645,.9945355,183,0,1,0,1
"GERALD",199,0,1,0,199,1,0,1,0
"JASMIN",5,156,.0310559,.9689441,161,0,1,0,1
"MARTA",0,151,0,1,151,0,1,0,1
"AISHA",0,164,0,1,164,0,1,0,1
"SHANA",0,154,0,1,154,0,1,0,1
"KAT",0,132,0,1,132,0,1,0,1
"PATRICE",24,147,.1403509,.8596491,171,0,1,0,0
"GREGG",148,0,1,0,148,1,0,1,0
"SILVIA",0,140,0,1,140,0,1,0,1
"DEIRDRE",0,136,0,1,136,0,1,0,1
"PIERRE",167,2,.9881657,.0118343,169,1,0,1,0
"ALVIN",186,0,1,0,186,1,0,1,0
"JERMAINE",198,1,.9949749,.0050251,199,1,0,1,0
"KATY",0,117,0,1,117,0,1,0,1
"AMIT",160,2,.9876543,.0123457,162,1,0,1,0
"JANELLE",0,133,0,1,133,0,1,0,1
"JO",29,128,.1847134,.8152866,157,0,1,0,0
"TEDDY",148,3,.9801325,.0198676,151,1,0,1,0
"BORIS",156,0,1,0,156,1,0,1,0
"CHRISSY",0,121,0,1,121,0,1,0,1
"CHLOE",0,124,0,1,124,0,1,0,1
"ROBERTA",0,184,0,1,184,0,1,0,1
"ZACK",141,0,1,0,141,1,0,1,0
"KAREEM",184,0,1,0,184,1,0,1,0
"PAULINE",0,148,0,1,148,0,1,0,1
"MARCOS",180,0,1,0,180,1,0,1,0
"SUNNY",103,46,.6912752,.3087248,149,0,0,0,0
"BRENT",156,0,1,0,156,1,0,1,0
"IGOR",159,0,1,0,159,1,0,1,0
"ROSIE",0,149,0,1,149,0,1,0,1
"SPENCER",116,1,.991453,.008547,117,1,0,1,0
"AMELIA",1,132,.0075188,.9924812,133,0,1,0,1
"MARJORIE",1,171,.005814,.994186,172,0,1,0,1
"TAMIKA",0,152,0,1,152,0,1,0,1
"KRISTA",0,118,0,1,118,0,1,0,1
"LUCAS",165,2,.9880239,.011976,167,1,0,1,0
"BRADLEY",148,0,1,0,148,1,0,1,0
"JEANINE",0,128,0,1,128,0,1,0,1
"HILARY",3,105,.0277778,.9722222,108,0,1,0,1
"KRISTY",0,115,0,1,115,0,1,0,1
"TERRENCE",176,1,.9943503,.0056497,177,1,0,1,0
"YESENIA",0,140,0,1,140,0,1,0,1
"DOMINIC",151,1,.9934211,.0065789,152,1,0,1,0
"GLADYS",0,182,0,1,182,0,1,0,1
"ALLIE",4,90,.0425532,.9574468,94,0,1,0,1
"BLAKE",116,17,.8721805,.1278196,133,1,0,0,0
"BRIANNA",0,110,0,1,110,0,1,0,1
"BENNY",155,3,.9810126,.0189873,158,1,0,1,0
"KERRI",1,118,.0084034,.9915966,119,0,1,0,1
"CLARA",0,130,0,1,130,0,1,0,1
"GUSTAVO",158,1,.9937107,.0062893,159,1,0,1,0
"IVY",1,121,.0081967,.9918033,122,0,1,0,1
"ROXANNE",0,146,0,1,146,0,1,0,1
"GISELLE",0,148,0,1,148,0,1,0,1
"MELVIN",173,1,.9942529,.0057471,174,1,0,1,0
"MONA",1,142,.006993,.993007,143,0,1,0,1
"STAN",159,4,.9754601,.0245399,163,1,0,1,0
"VLADIMIR",170,2,.9883721,.0116279,172,1,0,1,0
"CORINNE",0,121,0,1,121,0,1,0,1
"LÃ‰ONARD",180,2,.989011,.010989,182,1,0,1,0
"AJ",127,10,.9270073,.0729927,137,1,0,0,0
"NATHALIE",0,116,0,1,116,0,1,0,1
"CHRISTIE",0,114,0,1,114,0,1,0,1
"MELODY",1,145,.0068493,.9931507,146,0,1,0,1
"MERCEDES",0,149,0,1,149,0,1,0,1
"MITCH",149,1,.9933333,.0066667,150,1,0,1,0
"ALISA",0,106,0,1,106,0,1,0,1
"HILLARY",3,105,.0277778,.9722222,108,0,1,0,1
"JEANNETTE",0,151,0,1,151,0,1,0,1
"LANA",0,122,0,1,122,0,1,0,1
"ANNMARIE",2,146,.0135135,.9864865,148,0,1,0,1
"ELLIOT",132,0,1,0,132,1,0,1,0
"GABRIELLA",0,107,0,1,107,0,1,0,1
"KIRK",142,3,.9793103,.0206897,145,1,0,1,0
"MOSHE",126,0,1,0,126,1,0,1,0
"NORMAN",176,0,1,0,176,1,0,1,0
"GABE",118,0,1,0,118,1,0,1,0
"JULIANA",0,110,0,1,110,0,1,0,1
"KIRSTEN",2,100,.0196078,.9803922,102,0,1,0,1
"MONIKA",0,117,0,1,117,0,1,0,1
"EVE",0,128,0,1,128,0,1,0,1
"JADE",7,99,.0660377,.9339623,106,0,1,0,0
"FLORENCE",0,156,0,1,156,0,1,0,1
"MARTY",139,12,.9205298,.0794702,151,1,0,0,0
"ENRIQUE",168,0,1,0,168,1,0,1,0
"ILANA",0,99,0,1,99,0,1,0,1
"ARIELLE",0,101,0,1,101,0,1,0,1
"ALFRED",154,1,.9935484,.0064516,155,1,0,1,0
"CAMERON",117,18,.8666667,.1333333,135,1,0,0,0
"FATIMA",1,121,.0081967,.9918033,122,0,1,0,1
"MAYRA",0,143,0,1,143,0,1,0,1
"ANGELINA",0,137,0,1,137,0,1,0,1
"SUSIE",0,106,0,1,106,0,1,0,1
"CANDACE",0,118,0,1,118,0,1,0,1
"DALE",105,39,.7291667,.2708333,144,0,0,0,0
"HÃ‰LÃˆNE",0,134,0,1,134,0,1,0,1
"MARION",11,133,.0763889,.9236111,144,0,1,0,0
"PAIGE",2,107,.0183486,.9816514,109,0,1,0,1
"SERENA",0,116,0,1,116,0,1,0,1
"WILLIE",157,5,.9691358,.0308642,162,1,0,1,0
"IRA",137,9,.9383562,.0616438,146,1,0,0,0
"RUDY",136,2,.9855072,.0144928,138,1,0,1,0
"MARA",1,91,.0108696,.9891304,92,0,1,0,1
"NICKY",65,58,.5284553,.4715447,123,0,0,0,0
"GORDON",135,4,.971223,.028777,139,1,0,1,0
"MAURICIO",133,0,1,0,133,1,0,1,0
"MARI",0,106,0,1,106,0,1,0,1
"SHELLEY",3,124,.023622,.976378,127,0,1,0,1
"FIONA",1,105,.009434,.990566,106,0,1,0,1
"JEANNIE",0,135,0,1,135,0,1,0,1
"RUBY",5,118,.0406504,.9593496,123,0,1,0,1
"DAMON",130,1,.9923664,.0076336,131,1,0,1,0
"FRANKLIN",155,4,.9748428,.0251572,159,1,0,1,0
"KELSEY",5,82,.0574713,.9425287,87,0,1,0,0
"JODY",30,92,.2459016,.7540984,122,0,1,0,0
"NEAL",136,2,.9855072,.0144928,138,1,0,1,0
"TONYA",1,135,.0073529,.9926471,136,0,1,0,1
"ALINA",0,95,0,1,95,0,1,0,1
"GERALDINE",0,131,0,1,131,0,1,0,1
"MOHAMMAD",144,1,.9931034,.0068966,145,1,0,1,0
"DENIS",124,5,.9612403,.0387597,129,1,0,1,0
"GILLIAN",0,93,0,1,93,0,1,0,1
"KENDRA",0,110,0,1,110,0,1,0,1
"MARIANA",0,119,0,1,119,0,1,0,1
"DANIELLA",0,103,0,1,103,0,1,0,1
"KING",136,2,.9855072,.0144928,138,1,0,1,0
"MIKEY",125,4,.9689922,.0310078,129,1,0,1,0
"OWEN",129,0,1,0,129,1,0,1,0
"LUCIA",0,109,0,1,109,0,1,0,1
"BECCA",0,87,0,1,87,0,1,0,1
"CAROLE",0,156,0,1,156,0,1,0,1
"CASSIE",0,104,0,1,104,0,1,0,1
"DAMIEN",128,1,.9922481,.0077519,129,1,0,1,0
"DANI",31,67,.3163265,.6836734,98,0,0,0,0
"ELISABETH",0,103,0,1,103,0,1,0,1
"FABIÃÅN",134,1,.9925926,.0074074,135,1,0,1,0
"PATTI",1,121,.0081967,.9918033,122,0,1,0,1
"CELESTE",1,134,.0074074,.9925926,135,0,1,0,1
"KARIN",0,99,0,1,99,0,1,0,1
"SHERYL",0,125,0,1,125,0,1,0,1
"BELINDA",0,123,0,1,123,0,1,0,1
"DARA",5,87,.0543478,.9456522,92,0,1,0,0
"LOURDES",0,132,0,1,132,0,1,0,1
"MILLIE",1,144,.0068966,.9931034,145,0,1,0,1
"LESLEY",7,95,.0686275,.9313725,102,0,1,0,0
"WINNIE",0,100,0,1,100,0,1,0,1
"FAITH",2,109,.018018,.981982,111,0,1,0,1
"LA",26,98,.2096774,.7903226,124,0,1,0,0
"LOUIE",131,1,.9924242,.0075758,132,1,0,1,0
"ALFREDO",150,0,1,0,150,1,0,1,0
"ALISSA",0,77,0,1,77,0,1,0,1
"MEL",79,36,.6869565,.3130435,115,0,0,0,0
"DIANNE",0,125,0,1,125,0,1,0,1
"LISSETTE",0,129,0,1,129,0,1,0,1
"MARIBEL",0,127,0,1,127,0,1,0,1
"NICOLA",39,76,.3391304,.6608695,115,0,0,0,0
"CRISTIAN",140,4,.9722222,.0277778,144,1,0,1,0
"LORETTA",1,131,.0075758,.9924242,132,0,1,0,1
"LYNNE",0,126,0,1,126,0,1,0,1
"YOUNG",113,17,.8692307,.1307692,130,1,0,0,0
"CODY",103,12,.8956522,.1043478,115,1,0,0,0
"TRISHA",0,104,0,1,104,0,1,0,1
"YAEL",4,107,.036036,.963964,111,0,1,0,1
"GLEN",129,2,.9847328,.0152672,131,1,0,1,0
"HOPE",2,119,.0165289,.9834711,121,0,1,0,1
"MAY",3,83,.0348837,.9651163,86,0,1,0,1
"ROCHELLE",0,134,0,1,134,0,1,0,1
"TANISHA",0,114,0,1,114,0,1,0,1
"GEORGIA",0,109,0,1,109,0,1,0,1
"NIGEL",123,2,.984,.016,125,1,0,1,0
"AMIR",126,1,.992126,.007874,127,1,0,1,0
"ANTON",131,1,.9924242,.0075758,132,1,0,1,0
"KRISTI",1,74,.0133333,.9866667,75,0,1,0,1
"LOIS",1,137,.0072464,.9927536,138,0,1,0,1
"DOLORES",0,147,0,1,147,0,1,0,1
"AIDA",0,131,0,1,131,0,1,0,1
"ELEANOR",0,108,0,1,108,0,1,0,1
"LUISA",0,115,0,1,115,0,1,0,1
"WESLEY",120,1,.9917355,.0082645,121,1,0,1,0
"ANTOINE",124,0,1,0,124,1,0,1,0
"ISRAEL",144,2,.9863014,.0136986,146,1,0,1,0
"LEONARDO",135,0,1,0,135,1,0,1,0
"NOELLE",1,87,.0113636,.9886364,88,0,1,0,1
"PRINCE",139,0,1,0,139,1,0,1,0
"EDDY",121,3,.9758065,.0241935,124,1,0,1,0
"ERNEST",137,2,.9856115,.0143885,139,1,0,1,0
"REGINALD",147,0,1,0,147,1,0,1,0
"GIL",105,2,.9813084,.0186916,107,1,0,1,0
"HUGO",121,1,.9918033,.0081967,122,1,0,1,0
"JIN",68,36,.6538461,.3461539,104,0,0,0,0
"MAURA",0,72,0,1,72,0,1,0,1
"BLAIR",27,65,.2934783,.7065217,92,0,0,0,0
"LIAM",118,2,.9833333,.0166667,120,1,0,1,0
"MALCOLM",116,1,.991453,.008547,117,1,0,1,0
"ABRAHAM",123,0,1,0,123,1,0,1,0
"ARIANA",0,84,0,1,84,0,1,0,1
"ELLIE",2,95,.0206186,.9793814,97,0,1,0,1
"HELENA",0,89,0,1,89,0,1,0,1
"MIRANDA",0,94,0,1,94,0,1,0,1
"BEATRICE",0,116,0,1,116,0,1,0,1
"DUSTIN",109,1,.9909091,.0090909,110,1,0,1,0
"GEOFFREY",100,0,1,0,100,1,0,1,0
"JAMEL",132,4,.9705882,.0294118,136,1,0,1,0
"REGGIE",127,4,.9694657,.0305344,131,1,0,1,0
"SHELDON",138,0,1,0,138,1,0,1,0
"VERA",1,102,.0097087,.9902912,103,0,1,0,1
"BRIANA",0,73,0,1,73,0,1,0,1
"FELIPE",118,1,.9915966,.0084034,119,1,0,1,0
"GENEVIEVE",0,89,0,1,89,0,1,0,1
"MARGIE",0,118,0,1,118,0,1,0,1
"TERENCE",119,0,1,0,119,1,0,1,0
"MARIAN",5,124,.0387597,.9612403,129,0,1,0,1
"ELANA",0,80,0,1,80,0,1,0,1
"FREDERICK",130,0,1,0,130,1,0,1,0
"ILYA",110,1,.990991,.009009,111,1,0,1,0
"YELENA",0,92,0,1,92,0,1,0,1
"KERI",2,88,.0222222,.9777778,90,0,1,0,1
"CARLO",110,0,1,0,110,1,0,1,0
"GAVIN",103,0,1,0,103,1,0,1,0
"ELIAS",112,0,1,0,112,1,0,1,0
"LOLA",1,105,.009434,.990566,106,0,1,0,1
"CLIFF",119,0,1,0,119,1,0,1,0
"NICHOLE",0,106,0,1,106,0,1,0,1
"MALIK",130,1,.9923664,.0076336,131,1,0,1,0
"NANA",41,78,.3445378,.6554622,119,0,0,0,0
"RODRIGO",117,0,1,0,117,1,0,1,0
"ARMANDO",116,0,1,0,116,1,0,1,0
"LORENA",1,97,.0102041,.9897959,98,0,1,0,1
"SYDNEY",16,66,.1951219,.8048781,82,0,1,0,0
"GRANT",85,6,.9340659,.0659341,91,1,0,0,0
"JULISSA",0,102,0,1,102,0,1,0,1
"KAI",81,15,.84375,.15625,96,1,0,0,0
"LYNDA",1,116,.008547,.991453,117,0,1,0,1
"YAN",51,45,.53125,.46875,96,0,0,0,0
"ALISHA",0,109,0,1,109,0,1,0,1
"BELLA",1,113,.0087719,.991228,114,0,1,0,1
"ELYSE",1,93,.0106383,.9893617,94,0,1,0,1
"LADY",0,135,0,1,135,0,1,0,1
"PENNY",0,112,0,1,112,0,1,0,1
"RAJ",112,0,1,0,112,1,0,1,0
"ALEJANDRA",0,104,0,1,104,0,1,0,1
"KELLI",0,89,0,1,89,0,1,0,1
"DAPHNE",1,92,.0107527,.9892473,93,0,1,0,1
"GEOFF",88,0,1,0,88,1,0,1,0
"MO",81,17,.8265306,.1734694,98,1,0,0,0
"PERRY",110,6,.9482759,.0517241,116,1,0,0,0
"SONYA",0,96,0,1,96,0,1,0,1
"AGNÃˆS",0,105,0,1,105,0,1,0,1
"ALLYSON",1,83,.0119048,.9880952,84,0,1,0,1
"DARRELL",119,0,1,0,119,1,0,1,0
"DUANE",127,1,.9921875,.0078125,128,1,0,1,0
"RAPHAEL",118,1,.9915966,.0084034,119,1,0,1,0
"SHEENA",1,103,.0096154,.9903846,104,0,1,0,1
"AILEEN",0,91,0,1,91,0,1,0,1
"ELVIS",124,0,1,0,124,1,0,1,0
"JULIET",1,96,.0103093,.9896907,97,0,1,0,1
"GARRETT",105,3,.9722222,.0277778,108,1,0,1,0
"TRISH",0,82,0,1,82,0,1,0,1
"VALENTINA",1,84,.0117647,.9882353,85,0,1,0,1
"MAXINE",0,110,0,1,110,0,1,0,1
"MILTON",127,1,.9921875,.0078125,128,1,0,1,0
"RAVI",101,0,1,0,101,1,0,1,0
"CELIA",0,90,0,1,90,0,1,0,1
"IVETTE",0,109,0,1,109,0,1,0,1
"LLOYD",130,1,.9923664,.0076336,131,1,0,1,0
"LORENZO",101,0,1,0,101,1,0,1,0
"MICHAL",30,53,.3614458,.6385542,83,0,0,0,0
"BETHANY",0,79,0,1,79,0,1,0,1
"ELLA",0,94,0,1,94,0,1,0,1
"GRETCHEN",0,99,0,1,99,0,1,0,1
"HASSAN",114,0,1,0,114,1,0,1,0
"LILIANA",0,95,0,1,95,0,1,0,1
"SHIRA",0,69,0,1,69,0,1,0,1
"TOBY",70,36,.6603774,.3396226,106,0,0,0,0
"ALYSON",0,64,0,1,64,0,1,0,1
"DEB",2,82,.0238095,.9761904,84,0,1,0,1
"RORY",81,20,.8019802,.1980198,101,1,0,0,0
"YANA",1,85,.0116279,.9883721,86,0,1,0,1
"CANDY",5,102,.046729,.953271,107,0,1,0,1
"GUILLERMO",109,1,.9909091,.0090909,110,1,0,1,0
"NELLY",6,109,.0521739,.9478261,115,0,1,0,0
"ROLAND",108,0,1,0,108,1,0,1,0
"STÃ‰PHAN",116,0,1,0,116,1,0,1,0
"WINSTON",116,0,1,0,116,1,0,1,0
"CLARE",2,70,.0277778,.9722222,72,0,1,0,1
"DAMARIS",0,104,0,1,104,0,1,0,1
"ISABELLA",0,87,0,1,87,0,1,0,1
"JANA",0,91,0,1,91,0,1,0,1
"ROBBIE",89,11,.89,.11,100,1,0,0,0
"STEPH",5,60,.0769231,.9230769,65,0,1,0,0
"TALIA",0,57,0,1,57,0,1,0,1
"DARYL",100,10,.9090909,.0909091,110,1,0,0,0
"KAITLIN",0,68,0,1,68,0,1,0,1
"MEAGHAN",0,67,0,1,67,0,1,0,1
"VITO",107,1,.9907407,.0092593,108,1,0,1,0
"LEA",0,84,0,1,84,0,1,0,1
"SYED",110,3,.9734513,.0265487,113,1,0,1,0
"VINCE",103,1,.9903846,.0096154,104,1,0,1,0
"GIUSEPPE",124,0,1,0,124,1,0,1,0
"RACHELLE",1,86,.0114943,.9885057,87,0,1,0,1
"DWIGHT",109,0,1,0,109,1,0,1,0
"ELIZA",0,69,0,1,69,0,1,0,1
"GUS",107,0,1,0,107,1,0,1,0
"GILBERT",110,2,.9821429,.0178571,112,1,0,1,0
"MILDRED",0,121,0,1,121,0,1,0,1
"GIGI",3,81,.0357143,.9642857,84,0,1,0,1
"KAITLYN",0,65,0,1,65,0,1,0,1
"MINA",18,57,.24,.76,75,0,1,0,0
"SHERI",0,88,0,1,88,0,1,0,1
"BEATRIZ",0,93,0,1,93,0,1,0,1
"BYRON",105,0,1,0,105,1,0,1,0
"LEWIS",102,2,.9807692,.0192308,104,1,0,1,0
"ANTONIA",0,94,0,1,94,0,1,0,1
"BRYANT",94,1,.9894737,.0105263,95,1,0,1,0
"DARNELL",111,2,.9823009,.0176991,113,1,0,1,0
"YASMIN",1,84,.0117647,.9882353,85,0,1,0,1
"ARNOLD",110,1,.990991,.009009,111,1,0,1,0
"GWEN",0,87,0,1,87,0,1,0,1
"MISSY",0,90,0,1,90,0,1,0,1
"ROSEANN",0,104,0,1,104,0,1,0,1
"ALEC",88,1,.988764,.011236,89,1,0,1,0
"BRUNO",105,1,.990566,.009434,106,1,0,1,0
"PRIYA",2,87,.0224719,.9775281,89,0,1,0,1
"EARL",104,1,.9904762,.0095238,105,1,0,1,0
"ERNESTO",103,0,1,0,103,1,0,1,0
"JOSIE",0,93,0,1,93,0,1,0,1
"WEI",60,21,.7407407,.2592593,81,0,0,0,0
"AVA",0,83,0,1,83,0,1,0,1
"CARMINE",104,0,1,0,104,1,0,1,0
"GRAHAM",81,1,.9878049,.0121951,82,1,0,1,0
"MIN",37,49,.4302326,.5697674,86,0,0,0,0
"ADA",2,85,.0229885,.9770115,87,0,1,0,1
"ALLY",6,69,.08,.92,75,0,1,0,0
"KENYA",10,93,.0970874,.9029126,103,0,1,0,0
"KIRA",3,70,.0410959,.9589041,73,0,1,0,1
"RAMONA",0,90,0,1,90,0,1,0,1
"ELISSA",0,70,0,1,70,0,1,0,1
"FRANCESCO",91,0,1,0,91,1,0,1,0
"HAYLEY",0,67,0,1,67,0,1,0,1
"LOREN",23,60,.2771084,.7228916,83,0,0,0,0
"ELSA",1,91,.0108696,.9891304,92,0,1,0,1
"FABIO",91,1,.9891304,.0108696,92,1,0,1,0
"JOHNATHAN",108,1,.9908257,.0091743,109,1,0,1,0
"KÃÅRI",4,76,.05,.95,80,0,1,0,0
"SVETLANA",0,78,0,1,78,0,1,0,1
"TRISTAN",86,1,.9885057,.0114943,87,1,0,1,0
"EDITH",0,97,0,1,97,0,1,0,1
"INNA",0,82,0,1,82,0,1,0,1
"MEAGAN",0,67,0,1,67,0,1,0,1
"ISABELLE",0,79,0,1,79,0,1,0,1
"HANNA",4,69,.0547945,.9452055,73,0,1,0,0
"KELLEY",9,68,.1168831,.8831169,77,0,1,0,0
"LETICIA",0,106,0,1,106,0,1,0,1
"JACKSON",82,2,.9761904,.0238095,84,1,0,1,0
"TRINA",0,93,0,1,93,0,1,0,1
"TY",75,13,.8522727,.1477273,88,1,0,0,0
"CHARMAINE",0,104,0,1,104,0,1,0,1
"KELLIE",1,80,.0123457,.9876543,81,0,1,0,1
"MAGDALENA",0,78,0,1,78,0,1,0,1
"RENÃÅTA",0,88,0,1,88,0,1,0,1
"ROSANNA",0,72,0,1,72,0,1,0,1
"GERRY",67,24,.7362638,.2637363,91,0,0,0,0
"MARCELA",0,76,0,1,76,0,1,0,1
"MICKEY",67,23,.7444444,.2555556,90,0,0,0,0
"ALEXANDRIA",0,73,0,1,73,0,1,0,1
"ANDREAS",86,0,1,0,86,1,0,1,0
"HARVEY",108,3,.972973,.027027,111,1,0,1,0
"ISAIAH",108,0,1,0,108,1,0,1,0
"JUANITA",0,111,0,1,111,0,1,0,1
"LEILA",0,69,0,1,69,0,1,0,1
"LI",38,47,.4470588,.5529412,85,0,0,0,0
"RAHUL",97,0,1,0,97,1,0,1,0
"HUGH",92,0,1,0,92,1,0,1,0
"JUN",68,22,.7555556,.2444444,90,1,0,0,0
"LATISHA",0,94,0,1,94,0,1,0,1
"MUSTAFA",105,0,1,0,105,1,0,1,0
"PAULETTE",0,94,0,1,94,0,1,0,1
"RENA",0,61,0,1,61,0,1,0,1
"ROSALIE",1,93,.0106383,.9893617,94,0,1,0,1
"VLAD",81,0,1,0,81,1,0,1,0
"MARCY",1,78,.0126582,.9873418,79,0,1,0,1
"EMILIO",86,0,1,0,86,1,0,1,0
"GABBY",6,49,.1090909,.8909091,55,0,1,0,0
"JAYSON",86,0,1,0,86,1,0,1,0
"JULIEN",71,3,.9594595,.0405405,74,1,0,1,0
"LAUREL",1,76,.012987,.987013,77,0,1,0,1
"EDNA",0,97,0,1,97,0,1,0,1
"JAE",56,21,.7272727,.2727273,77,0,0,0,0
"SHERRI",0,89,0,1,89,0,1,0,1
"ASIA",1,85,.0116279,.9883721,86,0,1,0,1
"NOREEN",0,87,0,1,87,0,1,0,1
"RUSS",70,0,1,0,70,1,0,1,0
"SHANI",2,65,.0298507,.9701493,67,0,1,0,1
"TAMAR",4,60,.0625,.9375,64,0,1,0,0
"THEODORE",96,0,1,0,96,1,0,1,0
"ABDUL",110,1,.990991,.009009,111,1,0,1,0
"ALMA",0,84,0,1,84,0,1,0,1
"CARMELA",0,88,0,1,88,0,1,0,1
"ELIJAH",80,3,.9638554,.0361446,83,1,0,1,0
"TIA",1,67,.0147059,.9852941,68,0,1,0,1
"ABE",82,0,1,0,82,1,0,1,0
"MOE",69,19,.7840909,.2159091,88,1,0,0,0
"NIKI",8,57,.1230769,.8769231,65,0,1,0,0
"TARYN",0,49,0,1,49,0,1,0,1
"ALESSANDRA",0,63,0,1,63,0,1,0,1
"BRANDI",0,72,0,1,72,0,1,0,1
"FARAH",3,70,.0410959,.9589041,73,0,1,0,1
"LYNETTE",0,84,0,1,84,0,1,0,1
"PAOLO",81,0,1,0,81,1,0,1,0
"PAULINA",0,64,0,1,64,0,1,0,1
"CALEB",82,0,1,0,82,1,0,1,0
"HILDA",2,93,.0210526,.9789473,95,0,1,0,1
"ILENE",0,87,0,1,87,0,1,0,1
"LAURENCE",65,17,.7926829,.2073171,82,1,0,0,0
"LUCA",85,4,.9550562,.0449438,89,1,0,1,0
"ELLIOTT",76,1,.987013,.012987,77,1,0,1,0
"HARRIET",1,101,.0098039,.990196,102,0,1,0,1
"MARIANNA",0,71,0,1,71,0,1,0,1
"RANDALL",71,2,.9726027,.0273973,73,1,0,1,0
"VIVIANA",1,66,.0149254,.9850746,67,0,1,0,1
"ANGELIQUE",0,81,0,1,81,0,1,0,1
"LILLY",0,71,0,1,71,0,1,0,1
"GABY",7,59,.1060606,.8939394,66,0,1,0,0
"JULIUS",90,0,1,0,90,1,0,1,0
"LIBBY",0,64,0,1,64,0,1,0,1
"CARYN",0,64,0,1,64,0,1,0,1
"CHANEL",0,77,0,1,77,0,1,0,1
"JEANNINE",0,83,0,1,83,0,1,0,1
"LIZZIE",0,53,0,1,53,0,1,0,1
"MARLA",0,69,0,1,69,0,1,0,1
"MARTINA",0,68,0,1,68,0,1,0,1
"MILAGROS",0,93,0,1,93,0,1,0,1
"MILES",76,1,.987013,.012987,77,1,0,1,0
"RAVEN",7,74,.0864198,.9135802,81,0,1,0,0
"STACIE",0,81,0,1,81,0,1,0,1
"SUSANNA",0,62,0,1,62,0,1,0,1
"ALFONSO",91,1,.9891304,.0108696,92,1,0,1,0
"EL",71,12,.8554217,.1445783,83,1,0,0,0
"TRACI",1,60,.0163934,.9836066,61,0,1,0,1
"YURI",40,24,.625,.375,64,0,0,0,0
"AHMAD",89,1,.9888889,.0111111,90,1,0,1,0
"BROOKLYN",47,32,.5949367,.4050633,79,0,0,0,0
"DANTE",91,2,.9784946,.0215054,93,1,0,1,0
"DEXTER",95,1,.9895833,.0104167,96,1,0,1,0
"KENT",70,0,1,0,70,1,0,1,0
"LARISSA",0,65,0,1,65,0,1,0,1
"LIA",0,67,0,1,67,0,1,0,1
"MEI",1,62,.015873,.984127,63,0,1,0,1
"SAUL",91,0,1,0,91,1,0,1,0
"ANYA",0,59,0,1,59,0,1,0,1
"HALEY",2,53,.0363636,.9636363,55,0,1,0,1
"JEREMIAH",71,0,1,0,71,1,0,1,0
"KIKI",4,71,.0533333,.9466667,75,0,1,0,0
"LUCILLE",0,100,0,1,100,0,1,0,1
"MATHEW",72,2,.972973,.027027,74,1,0,1,0
"PHILIPPE",83,0,1,0,83,1,0,1,0
"TERI",0,72,0,1,72,0,1,0,1
"TIMMY",71,1,.9861111,.0138889,72,1,0,1,0
"ALLA",1,65,.0151515,.9848485,66,0,1,0,1
"BLANCA",0,86,0,1,86,0,1,0,1
"BRITTNEY",0,74,0,1,74,0,1,0,1
"CHAIM",75,0,1,0,75,1,0,1,0
"FANNY",3,76,.0379747,.9620253,79,0,1,0,1
"LUIGI",92,1,.9892473,.0107527,93,1,0,1,0
"YOSSI",70,0,1,0,70,1,0,1,0
"GIOVANNA",0,72,0,1,72,0,1,0,1
"NICO",62,10,.8611111,.1388889,72,1,0,0,0
"SANTIAGO",81,2,.9759036,.0240964,83,1,0,1,0
"SIOBHAN",0,58,0,1,58,0,1,0,1
"SUSANNE",0,66,0,1,66,0,1,0,1
"TERRANCE",90,0,1,0,90,1,0,1,0
"BO",51,20,.7183099,.2816902,71,0,0,0,0
"DIANNA",0,73,0,1,73,0,1,0,1
"KARYN",1,63,.015625,.984375,64,0,1,0,1
"LIONEL",90,0,1,0,90,1,0,1,0
"ROHAN",76,1,.987013,.012987,77,1,0,1,0
"CHASE",67,5,.9305556,.0694444,72,1,0,0,0
"CONOR",53,1,.9814815,.0185185,54,1,0,1,0
"DENA",0,58,0,1,58,0,1,0,1
"JACKY",48,19,.7164179,.2835821,67,0,0,0,0
"MICHEL",71,16,.816092,.183908,87,1,0,0,0
"RINA",0,62,0,1,62,0,1,0,1
"SHELBY",9,53,.1451613,.8548387,62,0,1,0,0
"GINGER",3,65,.0441176,.9558824,68,0,1,0,1
"LIANA",1,56,.0175439,.9824561,57,0,1,0,1
"MARSHALL",75,1,.9868421,.0131579,76,1,0,1,0
"MEHMET",79,0,1,0,79,1,0,1,0
"TOMÃÅS",77,1,.9871795,.0128205,78,1,0,1,0
"GLENDA",0,80,0,1,80,0,1,0,1
"KARIM",74,2,.9736842,.0263158,76,1,0,1,0
"LEROY",85,1,.9883721,.0116279,86,1,0,1,0
"ATHEÃ‘A",0,72,0,1,72,0,1,0,1
"DESMOND",84,0,1,0,84,1,0,1,0
"JONAH",67,1,.9852941,.0147059,68,1,0,1,0
"KRYSTLE",0,67,0,1,67,0,1,0,1
"MARCEL",83,3,.9651163,.0348837,86,1,0,1,0
"TERRELL",83,7,.9222222,.0777778,90,1,0,0,0
"ALVARO",78,0,1,0,78,1,0,1,0
"ANIL",72,0,1,0,72,1,0,1,0
"BERNICE",0,71,0,1,71,0,1,0,1
"CONNOR",61,2,.968254,.031746,63,1,0,1,0
"DINO",66,0,1,0,66,1,0,1,0
"IMRAN",75,0,1,0,75,1,0,1,0
"PHOEBE",0,64,0,1,64,0,1,0,1
"ROCCO",97,1,.9897959,.0102041,98,1,0,1,0
"SABINA",1,44,.0222222,.9777778,45,0,1,0,1
"SERGE",68,0,1,0,68,1,0,1,0
"SUSANA",0,68,0,1,68,0,1,0,1
"ADELE",0,72,0,1,72,0,1,0,1
"HUNTER",66,1,.9850746,.0149254,67,1,0,1,0
"MUHAMMAD",88,2,.9777778,.0222222,90,1,0,1,0
"ROCKY",76,7,.9156626,.0843373,83,1,0,0,0
"AVERY",55,14,.7971014,.2028985,69,1,0,0,0
"ELENI",0,62,0,1,62,0,1,0,1
"GAYLE",1,73,.0135135,.9864865,74,0,1,0,1
"ISMAEL",83,0,1,0,83,1,0,1,0
"MYRA",0,70,0,1,70,0,1,0,1
"REBEKAH",1,59,.0166667,.9833333,60,0,1,0,1
"SAMIR",78,2,.975,.025,80,1,0,1,0
"SHAUNA",1,63,.015625,.984375,64,0,1,0,1
"SUZY",0,56,0,1,56,0,1,0,1
"TATYANA",0,64,0,1,64,0,1,0,1
"THEO",71,2,.9726027,.0273973,73,1,0,1,0
"TORI",6,50,.1071429,.8928571,56,0,1,0,0
"WILFREDO",100,0,1,0,100,1,0,1,0
"ARTURO",79,0,1,0,79,1,0,1,0
"AVIVA",0,60,0,1,60,0,1,0,1
"DMITRIY",77,0,1,0,77,1,0,1,0
"DMITRY",65,0,1,0,65,1,0,1,0
"DORA",0,66,0,1,66,0,1,0,1
"GERMAN",76,0,1,0,76,1,0,1,0
"JAZMIN",0,60,0,1,60,0,1,0,1
"JOJO",34,30,.53125,.46875,64,0,0,0,0
"LIN",26,49,.3466667,.6533333,75,0,0,0,0
"LOGAN",48,9,.8421053,.1578947,57,1,0,0,0
"MARCELO",80,0,1,0,80,1,0,1,0
"SAMI",52,19,.7323943,.2676056,71,0,0,0,0
"SHANNA",0,71,0,1,71,0,1,0,1
"TESSA",1,55,.0178571,.9821429,56,0,1,0,1
"HOWIE",69,0,1,0,69,1,0,1,0
"MARGO",1,66,.0149254,.9850746,67,0,1,0,1
"CARISSA",0,58,0,1,58,0,1,0,1
"CHANTAL",0,64,0,1,64,0,1,0,1
"GERARDO",84,0,1,0,84,1,0,1,0
"IRMA",0,80,0,1,80,0,1,0,1
"LAMAR",79,5,.9404762,.0595238,84,1,0,0,0
"VISHAL",67,0,1,0,67,1,0,1,0
"ALESSANDRO",67,0,1,0,67,1,0,1,0
"DARIO",70,0,1,0,70,1,0,1,0
"HARRISON",53,0,1,0,53,1,0,1,0
"JONNY",71,0,1,0,71,1,0,1,0
"KENDALL",38,28,.5757576,.4242424,66,0,0,0,0
"ART",65,4,.942029,.057971,69,1,0,0,0
"CLAUDIO",70,0,1,0,70,1,0,1,0
"CLIFFORD",79,0,1,0,79,1,0,1,0
"COLETTE",0,65,0,1,65,0,1,0,1
"DORIAN",46,24,.6571429,.3428572,70,0,0,0,0
"JING",14,53,.2089552,.7910448,67,0,1,0,0
"JUDE",60,15,.8,.2,75,1,0,0,0
"KATERINA",0,62,0,1,62,0,1,0,1
"MING",43,23,.6515151,.3484848,66,0,0,0,0
"CLAUDE",59,7,.8939394,.1060606,66,1,0,0,0
"EUNICE",0,60,0,1,60,0,1,0,1
"HERBERT",85,0,1,0,85,1,0,1,0
"MARGOT",0,55,0,1,55,0,1,0,1
"OLEG",71,0,1,0,71,1,0,1,0
"SOLOMON",70,0,1,0,70,1,0,1,0
"TABITHA",0,72,0,1,72,0,1,0,1
"WILLY",74,0,1,0,74,1,0,1,0
"ALEKSANDRA",0,52,0,1,52,0,1,0,1
"CLARISSA",1,53,.0185185,.9814815,54,0,1,0,1
"DELIA",1,63,.015625,.984375,64,0,1,0,1
"JULIANNE",0,55,0,1,55,0,1,0,1
"KISHA",2,77,.0253165,.9746835,79,0,1,0,1
"LISETTE",0,61,0,1,61,0,1,0,1
"MORRIS",67,2,.9710145,.0289855,69,1,0,1,0
"NIKITA",27,43,.3857143,.6142857,70,0,0,0,0
"SHAY",28,42,.4,.6,70,0,0,0,0
"EMANUEL",88,0,1,0,88,1,0,1,0
"JAYNE",0,73,0,1,73,0,1,0,1
"MOSES",73,0,1,0,73,1,0,1,0
"SONJA",0,59,0,1,59,0,1,0,1
"SONNY",71,4,.9466667,.0533333,75,1,0,0,0
"TAL",38,14,.7307692,.2692308,52,0,0,0,0
"ALIZA",0,47,0,1,47,0,1,0,1
"DONOVAN",67,0,1,0,67,1,0,1,0
"HANS",81,0,1,0,81,1,0,1,0
"LAMONT",80,0,1,0,80,1,0,1,0
"TAMI",0,57,0,1,57,0,1,0,1
"ERICKA",0,52,0,1,52,0,1,0,1
"KWAME",72,0,1,0,72,1,0,1,0
"OLIVIER",59,0,1,0,59,1,0,1,0
"VALERIA",0,71,0,1,71,0,1,0,1
"ADINA",0,48,0,1,48,0,1,0,1
"HARRIS",59,3,.9516129,.0483871,62,1,0,1,0
"JOHAN",75,2,.974026,.025974,77,1,0,1,0
"MYRNA",0,90,0,1,90,0,1,0,1
"NOEMI",0,65,0,1,65,0,1,0,1
"PARIS",24,42,.3636364,.6363636,66,0,0,0,0
"TEE",25,44,.3623188,.6376812,69,0,0,0,0
"VAL",27,35,.4354839,.5645161,62,0,0,0,0
"ALANNA",0,55,0,1,55,0,1,0,1
"EMILIE",0,56,0,1,56,0,1,0,1
"EZRA",48,1,.9795918,.0204082,49,1,0,1,0
"FLORA",0,58,0,1,58,0,1,0,1
"PEARL",2,59,.0327869,.9672131,61,0,1,0,1
"SHAWNA",0,61,0,1,61,0,1,0,1
"SHOSHANA",0,62,0,1,62,0,1,0,1
"STEFANO",68,1,.9855072,.0144928,69,1,0,1,0
"ARIANNA",0,47,0,1,47,0,1,0,1
"CHRISTA",0,55,0,1,55,0,1,0,1
"DEEJAY",71,7,.9102564,.0897436,78,1,0,0,0
"DIMITRI",62,1,.984127,.015873,63,1,0,1,0
"KAROLINA",0,44,0,1,44,0,1,0,1
"KITTY",7,56,.1111111,.8888889,63,0,1,0,0
"MICHAELA",0,53,0,1,53,0,1,0,1
"REY",75,2,.974026,.025974,77,1,0,1,0
"YING",7,51,.1206897,.8793104,58,0,1,0,0
"ASHISH",58,1,.9830508,.0169492,59,1,0,1,0
"CHANDRA",10,59,.1449275,.8550724,69,0,1,0,0
"CONRAD",61,1,.983871,.016129,62,1,0,1,0
"DANE",63,5,.9264706,.0735294,68,1,0,0,0
"DIONNE",0,68,0,1,68,0,1,0,1
"FRANCO",63,1,.984375,.015625,64,1,0,1,0
"HAL",65,0,1,0,65,1,0,1,0
"IDA",0,82,0,1,82,0,1,0,1
"JONAS",63,0,1,0,63,1,0,1,0
"MARYANNE",0,63,0,1,63,0,1,0,1
"MERYL",0,59,0,1,59,0,1,0,1
"OREN",56,1,.9824561,.0175439,57,1,0,1,0
"AUDRA",0,59,0,1,59,0,1,0,1
"CHANTEL",0,61,0,1,61,0,1,0,1
"DONNY",60,0,1,0,60,1,0,1,0
"FREDDIE",65,1,.9848485,.0151515,66,1,0,1,0
"JAMILA",0,56,0,1,56,0,1,0,1
"KATHARINE",0,46,0,1,46,0,1,0,1
"LEVI",59,3,.9516129,.0483871,62,1,0,1,0
"MAGDA",0,64,0,1,64,0,1,0,1
"MALLORY",0,45,0,1,45,0,1,0,1
"SUZETTE",0,70,0,1,70,0,1,0,1
"AUBREY",33,31,.515625,.484375,64,0,0,0,0
"GINO",59,0,1,0,59,1,0,1,0
"JAIRO",71,1,.9861111,.0138889,72,1,0,1,0
"JOHNSON",52,14,.7878788,.2121212,66,1,0,0,0
"ROCÃçO",0,60,0,1,60,0,1,0,1
"SELENA",0,61,0,1,61,0,1,0,1
"ANNEMARIE",0,57,0,1,57,0,1,0,1
"CAT",5,55,.0833333,.9166667,60,0,1,0,0
"DARIA",0,50,0,1,50,0,1,0,1
"FABIOLA",0,70,0,1,70,0,1,0,1
"MARIELA",0,69,0,1,69,0,1,0,1
"NIA",2,52,.037037,.962963,54,0,1,0,1
"SUMMER",1,57,.0172414,.9827586,58,0,1,0,1
"AMI",13,47,.2166667,.7833334,60,0,1,0,0
"MADELEINE",0,42,0,1,42,0,1,0,1
"MADISON",6,47,.1132075,.8867925,53,0,1,0,0
"MARIEL",0,46,0,1,46,0,1,0,1
"PRESTON",71,2,.9726027,.0273973,73,1,0,1,0
"SELINA",0,58,0,1,58,0,1,0,1
"ALAIN",68,2,.9714286,.0285714,70,1,0,1,0
"CONSTANCE",0,61,0,1,61,0,1,0,1
"EMIL",62,2,.96875,.03125,64,1,0,1,0
"GENESIS",6,56,.0967742,.9032258,62,0,1,0,0
"JACQUELYN",0,62,0,1,62,0,1,0,1
"JODIE",2,50,.0384615,.9615384,52,0,1,0,1
"MAXWELL",58,0,1,0,58,1,0,1,0
"MILENA",0,62,0,1,62,0,1,0,1
"NISHA",0,51,0,1,51,0,1,0,1
"VADIM",67,0,1,0,67,1,0,1,0
"ALEXANDRE",56,1,.9824561,.0175439,57,1,0,1,0
"AYANA",0,68,0,1,68,0,1,0,1
"BRIANNE",0,45,0,1,45,0,1,0,1
"CLARENCE",75,0,1,0,75,1,0,1,0
"ELIANA",0,58,0,1,58,0,1,0,1
"JULIETTE",0,46,0,1,46,0,1,0,1
"KATIA",0,51,0,1,51,0,1,0,1
"ROSARIO",35,40,.4666667,.5333334,75,0,0,0,0
"VICKIE",0,73,0,1,73,0,1,0,1
"AYESHA",1,55,.0178571,.9821429,56,0,1,0,1
"BRIGITTE",0,52,0,1,52,0,1,0,1
"ESTEBAN",67,0,1,0,67,1,0,1,0
"HANK",71,0,1,0,71,1,0,1,0
"HAZEL",2,55,.0350877,.9649123,57,0,1,0,1
"JAZMINE",0,63,0,1,63,0,1,0,1
"KATELYN",0,48,0,1,48,0,1,0,1
"MARCELLA",0,57,0,1,57,0,1,0,1
"WADE",64,3,.9552239,.0447761,67,1,0,1,0
"CRIS",41,25,.6212121,.3787879,66,0,0,0,0
"DARIUS",69,0,1,0,69,1,0,1,0
"IZZY",39,15,.7222222,.2777778,54,0,0,0,0
"JOELLE",0,52,0,1,52,0,1,0,1
"KIMBERLEY",0,62,0,1,62,0,1,0,1
"KRISTIE",0,52,0,1,52,0,1,0,1
"NELLIE",0,58,0,1,58,0,1,0,1
"SARI",1,41,.0238095,.9761904,42,0,1,0,1
"TESS",0,53,0,1,53,0,1,0,1
"YUKI",17,39,.3035714,.6964286,56,0,0,0,0
"ALIX",22,37,.3728814,.6271186,59,0,0,0,0
"BRANDY",1,63,.015625,.984375,64,0,1,0,1
"CARY",29,11,.725,.275,40,0,0,0,0
"COLE",49,7,.875,.125,56,1,0,0,0
"DESTINY",1,62,.015873,.984127,63,0,1,0,1
"DIAMOND",9,58,.1343284,.8656716,67,0,1,0,0
"LEANNE",0,43,0,1,43,0,1,0,1
"LORNA",0,61,0,1,61,0,1,0,1
"MURAT",64,1,.9846154,.0153846,65,1,0,1,0
"PAULO",63,0,1,0,63,1,0,1,0
"STEWART",60,1,.9836066,.0163934,61,1,0,1,0
"Ä°BRAHIM",67,0,1,0,67,1,0,1,0
"ALTHEA",0,64,0,1,64,0,1,0,1
"ASHLEIGH",1,51,.0192308,.9807692,52,0,1,0,1
"CARINA",0,47,0,1,47,0,1,0,1
"CARLTON",77,1,.9871795,.0128205,78,1,0,1,0
"GWENDOLYN",0,71,0,1,71,0,1,0,1
"LESTER",71,0,1,0,71,1,0,1,0
"LOUISA",0,49,0,1,49,0,1,0,1
"ROLANDO",68,0,1,0,68,1,0,1,0
"SADE",2,67,.0289855,.9710145,69,0,1,0,1
"YONI",39,0,1,0,39,1,0,1,0
"ANDI",15,31,.326087,.6739131,46,0,0,0,0
"CHEN",37,26,.5873016,.4126984,63,0,0,0,0
"DAYNA",0,46,0,1,46,0,1,0,1
"FAYE",0,53,0,1,53,0,1,0,1
"FEDERICO",58,0,1,0,58,1,0,1,0
"SANJAY",62,0,1,0,62,1,0,1,0
"SERGEY",76,0,1,0,76,1,0,1,0
"ANTONELLA",0,53,0,1,53,0,1,0,1
"CHANA",0,44,0,1,44,0,1,0,1
"DAMION",69,0,1,0,69,1,0,1,0
"ELINA",0,40,0,1,40,0,1,0,1
"EUGENIA",0,60,0,1,60,0,1,0,1
"KASIA",0,49,0,1,49,0,1,0,1
"KRISTIAN",56,2,.9655172,.0344828,58,1,0,1,0
"MIKHAIL",63,0,1,0,63,1,0,1,0
"SUNIL",54,0,1,0,54,1,0,1,0
"TISHA",0,71,0,1,71,0,1,0,1
"VENUS",1,60,.0163934,.9836066,61,0,1,0,1
"ALBA",0,54,0,1,54,0,1,0,1
"ASHA",2,45,.0425532,.9574468,47,0,1,0,1
"COLLIN",57,1,.9827586,.0172414,58,1,0,1,0
"EMILIA",0,43,0,1,43,0,1,0,1
"LEN",63,3,.9545454,.0454545,66,1,0,1,0
"ROBBY",60,1,.9836066,.0163934,61,1,0,1,0
"RONNY",60,5,.9230769,.0769231,65,1,0,0,0
"SIDNEY",55,10,.8461539,.1538462,65,1,0,0,0
"XIOMARA",0,63,0,1,63,0,1,0,1
"CAREY",12,31,.2790698,.7209302,43,0,0,0,0
"CHIP",55,1,.9821429,.0178571,56,1,0,1,0
"ELVIN",68,0,1,0,68,1,0,1,0
"ERNIE",58,0,1,0,58,1,0,1,0
"FARRAH",0,37,0,1,37,0,1,0,1
"JENNI",0,37,0,1,37,0,1,0,1
"JESSY",11,47,.1896552,.8103448,58,0,1,0,0
"JULES",22,13,.6285715,.3714286,35,0,0,0,0
"MARIAM",0,43,0,1,43,0,1,0,1
"MOLLIE",1,44,.0222222,.9777778,45,0,1,0,1
"SHANIQUA",1,63,.015625,.984375,64,0,1,0,1
"VINCENZO",77,0,1,0,77,1,0,1,0
"AJAY",59,0,1,0,59,1,0,1,0
"ELSIE",0,59,0,1,59,0,1,0,1
"IVONNE",1,60,.0163934,.9836066,61,0,1,0,1
"KASEY",4,37,.097561,.902439,41,0,1,0,0
"LEXI",0,41,0,1,41,0,1,0,1
"MICAH",40,4,.9090909,.0909091,44,1,0,0,0
"PRECIOUS",1,60,.0163934,.9836066,61,0,1,0,1
"SHAYNA",0,47,0,1,47,0,1,0,1
"TALI",1,38,.025641,.974359,39,0,1,0,1
"TITO",70,0,1,0,70,1,0,1,0
"VIN",49,0,1,0,49,1,0,1,0
"WES",61,0,1,0,61,1,0,1,0
"AYANNA",0,49,0,1,49,0,1,0,1
"COCO",11,49,.1833333,.8166667,60,0,1,0,0
"DEENA",0,37,0,1,37,0,1,0,1
"MOISES",62,1,.984127,.015873,63,1,0,1,0
"ROHIT",58,0,1,0,58,1,0,1,0
"YULIYA",0,53,0,1,53,0,1,0,1
"ADI",22,31,.4150943,.5849057,53,0,0,0,0
"BERNIE",55,10,.8461539,.1538462,65,1,0,0,0
"DEIDRE",0,61,0,1,61,0,1,0,1
"GERI",2,56,.0344828,.9655172,58,0,1,0,1
"HANA",1,46,.0212766,.9787234,47,0,1,0,1
"HASAN",59,0,1,0,59,1,0,1,0
"LATASHA",0,67,0,1,67,0,1,0,1
"LILI",0,52,0,1,52,0,1,0,1
"PETRA",0,52,0,1,52,0,1,0,1
"RIA",0,48,0,1,48,0,1,0,1
"ROSANNE",0,62,0,1,62,0,1,0,1
"URSULA",1,53,.0185185,.9814815,54,0,1,0,1
"VIOLET",1,53,.0185185,.9814815,54,0,1,0,1
"YI",21,37,.362069,.637931,58,0,0,0,0
"AKEEM",64,1,.9846154,.0153846,65,1,0,1,0
"AMINA",0,49,0,1,49,0,1,0,1
"ANDERSON",55,3,.9482759,.0517241,58,1,0,0,0
"DOM",40,2,.952381,.047619,42,1,0,1,0
"FERNANDA",0,55,0,1,55,0,1,0,1
"IRVING",55,0,1,0,55,1,0,1,0
"JED",44,1,.9777778,.0222222,45,1,0,1,0
"KATYA",0,43,0,1,43,0,1,0,1
"LARISA",0,51,0,1,51,0,1,0,1
"LES",58,2,.9666666,.0333333,60,1,0,1,0
"LILIAN",0,50,0,1,50,0,1,0,1
"MARCI",1,43,.0227273,.9772727,44,0,1,0,1
"NICOLETTE",0,40,0,1,40,0,1,0,1
"NIKO",44,5,.8979592,.1020408,49,1,0,0,0
"ASHLEE",1,50,.0196078,.9803922,51,0,1,0,1
"ASTRID",0,40,0,1,40,0,1,0,1
"BART",57,1,.9827586,.0172414,58,1,0,1,0
"CAREN",0,55,0,1,55,0,1,0,1
"HERMAN",60,0,1,0,60,1,0,1,0
"INDIRA",0,52,0,1,52,0,1,0,1
"JOSUÃ‹",66,1,.9850746,.0149254,67,1,0,1,0
"JUDI",0,64,0,1,64,0,1,0,1
"KIERAN",42,2,.9545454,.0454545,44,1,0,1,0
"LILA",0,42,0,1,42,0,1,0,1
"ROXANA",0,51,0,1,51,0,1,0,1
"SANDEEP",52,2,.962963,.037037,54,1,0,1,0
"SANDI",3,48,.0588235,.9411765,51,0,1,0,0
"SUZIE",0,39,0,1,39,0,1,0,1
"VERNON",71,0,1,0,71,1,0,1,0
"CLAUDINE",0,44,0,1,44,0,1,0,1
"GARRY",61,0,1,0,61,1,0,1,0
"VIJAY",52,1,.9811321,.0188679,53,1,0,1,0
"IVANA",0,35,0,1,35,0,1,0,1
"KIT",17,27,.3863636,.6136364,44,0,0,0,0
"OMER",51,0,1,0,51,1,0,1,0
"RISA",0,37,0,1,37,0,1,0,1
"ROMEO",75,0,1,0,75,1,0,1,0
"SILVANA",0,51,0,1,51,0,1,0,1
"ARON",53,1,.9814815,.0185185,54,1,0,1,0
"CAMILO",51,0,1,0,51,1,0,1,0
"CHARISSE",0,54,0,1,54,0,1,0,1
"CLAY",52,0,1,0,52,1,0,1,0
"CLINT",62,0,1,0,62,1,0,1,0
"KIARA",1,43,.0227273,.9772727,44,0,1,0,1
"LIZETTE",0,50,0,1,50,0,1,0,1
"MARIYA",0,44,0,1,44,0,1,0,1
"MARTINE",0,50,0,1,50,0,1,0,1
"MARYELLEN",0,58,0,1,58,0,1,0,1
"QUINCY",52,5,.9122807,.0877193,57,1,0,0,0
"SAMEER",53,0,1,0,53,1,0,1,0
"TIANA",1,45,.0217391,.9782609,46,0,1,0,1
"VAUGHN",62,1,.984127,.015873,63,1,0,1,0
"ALEXIA",1,44,.0222222,.9777778,45,0,1,0,1
"ANDREY",49,1,.98,.02,50,1,0,1,0
"CHAYA",0,40,0,1,40,0,1,0,1
"GIANNA",0,36,0,1,36,0,1,0,1
"JANNA",0,33,0,1,33,0,1,0,1
"JI",21,38,.3559322,.6440678,59,0,0,0,0
"KEREN",0,31,0,1,31,0,1,0,1
"NEHA",0,43,0,1,43,0,1,0,1
"PILAR",0,45,0,1,45,0,1,0,1
"QUENTIN",49,2,.9607843,.0392157,51,1,0,1,0
"ROD",50,2,.9615384,.0384615,52,1,0,1,0
"TAWANA",1,55,.0178571,.9821429,56,0,1,0,1
"VIC",43,1,.9772727,.0227273,44,1,0,1,0
"AIDAN",44,3,.9361702,.0638298,47,1,0,0,0
"CAMILA",0,51,0,1,51,0,1,0,1
"CEDRIC",58,1,.9830508,.0169492,59,1,0,1,0
"CHERRY",2,55,.0350877,.9649123,57,0,1,0,1
"DALIA",0,32,0,1,32,0,1,0,1
"DANIELE",28,22,.56,.44,50,0,0,0,0
"DARWIN",57,0,1,0,57,1,0,1,0
"ERROL",58,0,1,0,58,1,0,1,0
"KRISTOPHER",49,0,1,0,49,1,0,1,0
"LORA",0,43,0,1,43,0,1,0,1
"MIRA",1,49,.02,.98,50,0,1,0,1
"PIA",0,43,0,1,43,0,1,0,1
"RISHI",45,2,.9574468,.0425532,47,1,0,1,0
"RONI",14,36,.28,.72,50,0,0,0,0
"TYRELL",72,1,.9863014,.0136986,73,1,0,1,0
"CHI",29,14,.6744186,.3255814,43,0,0,0,0
"ELLE",0,43,0,1,43,0,1,0,1
"GEORGINA",0,48,0,1,48,0,1,0,1
"GIA",0,48,0,1,48,0,1,0,1
"JENIFER",0,42,0,1,42,0,1,0,1
"JORDANA",0,27,0,1,27,0,1,0,1
"KHALID",51,0,1,0,51,1,0,1,0
"MABEL",0,44,0,1,44,0,1,0,1
"MARIAH",1,40,.0243902,.9756098,41,0,1,0,1
"TARIQ",55,2,.9649123,.0350877,57,1,0,1,0
"THERESE",0,37,0,1,37,0,1,0,1
"YU",28,27,.5090909,.4909091,55,0,0,0,0
"ANAND",48,1,.9795918,.0204082,49,1,0,1,0
"ASH",26,21,.5531915,.4468085,47,0,0,0,0
"CARTER",38,8,.8260869,.173913,46,1,0,0,0
"CHERIE",0,48,0,1,48,0,1,0,1
"CLARK",44,2,.9565217,.0434783,46,1,0,1,0
"DUNCAN",46,1,.9787234,.0212766,47,1,0,1,0
"LIZZY",1,29,.0333333,.9666666,30,0,1,0,1
"MYRIAM",0,53,0,1,53,0,1,0,1
"OKSANA",0,46,0,1,46,0,1,0,1
"RICO",44,2,.9565217,.0434783,46,1,0,1,0
"VIVEK",52,0,1,0,52,1,0,1,0
"WIL",43,1,.9772727,.0227273,44,1,0,1,0
"CLINTON",54,0,1,0,54,1,0,1,0
"EFRAIN",60,1,.9836066,.0163934,61,1,0,1,0
"KAMAL",58,1,.9830508,.0169492,59,1,0,1,0
"LENORE",0,59,0,1,59,0,1,0,1
"LULU",2,38,.05,.95,40,0,1,0,0
"MICHEAL",55,2,.9649123,.0350877,57,1,0,1,0
"NESTOR",48,0,1,0,48,1,0,1,0
"RACQUEL",0,53,0,1,53,0,1,0,1
"TAMEKA",0,60,0,1,60,0,1,0,1
"TREY",50,0,1,0,50,1,0,1,0
"ALDO",62,0,1,0,62,1,0,1,0
"CELINE",0,30,0,1,30,0,1,0,1
"JACQUES",59,0,1,0,59,1,0,1,0
"MYLES",41,1,.9761904,.0238095,42,1,0,1,0
"NAT",40,10,.8,.2,50,1,0,0,0
"NY",31,13,.7045454,.2954545,44,0,0,0,0
"ANIKA",1,47,.0208333,.9791667,48,0,1,0,1
"AURORA",0,44,0,1,44,0,1,0,1
"BLACK",38,11,.7755102,.2244898,49,1,0,0,0
"CIARA",0,46,0,1,46,0,1,0,1
"DEBBY",0,47,0,1,47,0,1,0,1
"GINNY",0,51,0,1,51,0,1,0,1
"JAMAAL",55,0,1,0,55,1,0,1,0
"JANETTE",0,53,0,1,53,0,1,0,1
"JIA",15,27,.3571429,.6428571,42,0,0,0,0
"MAI",2,37,.0512821,.948718,39,0,1,0,0
"MELISA",0,39,0,1,39,0,1,0,1
"MIGDALIA",0,63,0,1,63,0,1,0,1
"REINA",1,48,.0204082,.9795918,49,0,1,0,1
"ABEL",57,0,1,0,57,1,0,1,0
"AGNIESZKA",0,41,0,1,41,0,1,0,1
"ARIELLA",0,33,0,1,33,0,1,0,1
"DION",47,5,.9038461,.0961538,52,1,0,0,0
"GAURAV",49,0,1,0,49,1,0,1,0
"IMANI",6,47,.1132075,.8867925,53,0,1,0,0
"JIAN",35,9,.7954546,.2045455,44,1,0,0,0
"MARGUERITE",0,47,0,1,47,0,1,0,1
"YAHAIRA",0,49,0,1,49,0,1,0,1
"ANDREI",48,1,.9795918,.0204082,49,1,0,1,0
"CLYDE",52,2,.962963,.037037,54,1,0,1,0
"EDMUND",58,0,1,0,58,1,0,1,0
"ILIANA",0,47,0,1,47,0,1,0,1
"KAVITA",0,43,0,1,43,0,1,0,1
"KIA",1,53,.0185185,.9814815,54,0,1,0,1
"MARKUS",46,0,1,0,46,1,0,1,0
"STACI",0,32,0,1,32,0,1,0,1
"ALLI",3,24,.1111111,.8888889,27,0,1,0,0
"ARTIE",48,2,.96,.04,50,1,0,1,0
"ARUN",42,0,1,0,42,1,0,1,0
"AUTUMN",1,39,.025,.975,40,0,1,0,1
"BIBI",2,39,.0487805,.9512195,41,0,1,0,1
"DEANA",0,36,0,1,36,0,1,0,1
"DILLON",42,2,.9545454,.0454545,44,1,0,1,0
"GILBERTO",58,1,.9830508,.0169492,59,1,0,1,0
"ILONA",0,38,0,1,38,0,1,0,1
"JEFFERSON",50,0,1,0,50,1,0,1,0
"MELINA",1,39,.025,.975,40,0,1,0,1
"MISHA",29,20,.5918368,.4081633,49,0,0,0,0
"NILDA",0,62,0,1,62,0,1,0,1
"REX",49,0,1,0,49,1,0,1,0
"STEPHANY",1,43,.0227273,.9772727,44,0,1,0,1
"TYSON",52,1,.9811321,.0188679,53,1,0,1,0
"VERONIKA",0,45,0,1,45,0,1,0,1
"WING",27,16,.627907,.372093,43,0,0,0,0
"BERT",51,3,.9444444,.0555556,54,1,0,0,0
"CARMELO",57,0,1,0,57,1,0,1,0
"DE",29,13,.6904762,.3095238,42,0,0,0,0
"DIMA",35,3,.9210526,.0789474,38,1,0,0,0
"ELVIRA",0,51,0,1,51,0,1,0,1
"LAURENT",47,1,.9791667,.0208333,48,1,0,1,0
"MARYBETH",0,46,0,1,46,0,1,0,1
"NICKI",0,39,0,1,39,0,1,0,1
"QUINN",27,17,.6136364,.3863636,44,0,0,0,0
"DARCY",7,33,.175,.825,40,0,1,0,0
"INÃ‰S",0,43,0,1,43,0,1,0,1
"JEWEL",7,40,.1489362,.8510638,47,0,1,0,0
"JUNG",23,16,.5897436,.4102564,39,0,0,0,0
"KUNAL",43,0,1,0,43,1,0,1,0
"LASHAWN",1,55,.0178571,.9821429,56,0,1,0,1
"MASHA",0,34,0,1,34,0,1,0,1
"ROSALIND",0,59,0,1,59,0,1,0,1
"SABINE",0,41,0,1,41,0,1,0,1
"SORAYA",1,41,.0238095,.9761904,42,0,1,0,1
"SUNG",22,13,.6285715,.3714286,35,0,0,0,0
"VINNIE",38,5,.8837209,.1162791,43,1,0,0,0
"YEHUDA",44,0,1,0,44,1,0,1,0
"ADNAN",43,0,1,0,43,1,0,1,0
"CLAYTON",47,0,1,0,47,1,0,1,0
"MARYAM",0,37,0,1,37,0,1,0,1
"MEIR",39,0,1,0,39,1,0,1,0
"REMY",34,9,.7906977,.2093023,43,1,0,0,0
"ROBINSON",49,4,.9245283,.0754717,53,1,0,0,0
"SHAINA",0,31,0,1,31,0,1,0,1
"VAN",34,10,.7727273,.2272727,44,1,0,0,0
"VILMA",0,49,0,1,49,0,1,0,1
"ALON",40,0,1,0,40,1,0,1,0
"BRITT",4,26,.1333333,.8666667,30,0,1,0,0
"DOLLY",0,48,0,1,48,0,1,0,1
"JACQUI",0,36,0,1,36,0,1,0,1
"KIRAN",21,12,.6363636,.3636364,33,0,0,0,0
"LUCKY",44,14,.7586207,.2413793,58,1,0,0,0
"POOJA",0,31,0,1,31,0,1,0,1
"TRUDY",1,50,.0196078,.9803922,51,0,1,0,1
"BRIDGETTE",0,40,0,1,40,0,1,0,1
"IGNACIO",47,0,1,0,47,1,0,1,0
"JEANIE",0,47,0,1,47,0,1,0,1
"MATTEO",42,0,1,0,42,1,0,1,0
"NAKIA",4,42,.0869565,.9130435,46,0,1,0,0
"SHARLENE",0,45,0,1,45,0,1,0,1
"SID",38,0,1,0,38,1,0,1,0
"TIARA",0,47,0,1,47,0,1,0,1
"TING",13,33,.2826087,.7173913,46,0,0,0,0
"WENDELL",55,0,1,0,55,1,0,1,0
"BEAU",36,3,.9230769,.0769231,39,1,0,0,0
"BRYCE",41,1,.9761904,.0238095,42,1,0,1,0
"CATALINA",0,37,0,1,37,0,1,0,1
"DENIZ",18,17,.5142857,.4857143,35,0,0,0,0
"ENID",1,43,.0227273,.9772727,44,0,1,0,1
"MAC",39,2,.9512195,.0487805,41,1,0,1,0
"POLINA",0,32,0,1,32,0,1,0,1
"RAFI",33,3,.9166667,.0833333,36,1,0,0,0
"SHANTEL",0,53,0,1,53,0,1,0,1
"SHLOMO",30,0,1,0,30,1,0,1,0
"SIMONA",0,35,0,1,35,0,1,0,1
"TIFFANI",0,31,0,1,31,0,1,0,1
"ZAK",45,0,1,0,45,1,0,1,0
"ALY",13,19,.40625,.59375,32,0,0,0,0
"ANNY",0,37,0,1,37,0,1,0,1
"BRITNEY",0,52,0,1,52,0,1,0,1
"CHERI",0,34,0,1,34,0,1,0,1
"DELILAH",0,52,0,1,52,0,1,0,1
"DENISSE",0,40,0,1,40,0,1,0,1
"DONNIE",47,1,.9791667,.0208333,48,1,0,1,0
"FAISAL",50,0,1,0,50,1,0,1,0
"GIANCARLO",39,1,.975,.025,40,1,0,1,0
"HAYDEE",0,47,0,1,47,0,1,0,1
"ILAN",35,1,.9722222,.0277778,36,1,0,1,0
"INDIA",0,37,0,1,37,0,1,0,1
"INEZ",0,47,0,1,47,0,1,0,1
"JAMAR",48,0,1,0,48,1,0,1,0
"LACEY",1,28,.0344828,.9655172,29,0,1,0,1
"MADELYN",0,48,0,1,48,0,1,0,1
"RILEY",33,14,.7021276,.2978723,47,0,0,0,0
"SHAKIRA",0,48,0,1,48,0,1,0,1
"TRENT",46,1,.9787234,.0212766,47,1,0,1,0
"ABBEY",4,36,.1,.9,40,0,1,0,0
"AMAR",47,5,.9038461,.0961538,52,1,0,0,0
"AMIE",0,37,0,1,37,0,1,0,1
"CATHLEEN",1,31,.03125,.96875,32,0,1,0,1
"CORI",1,30,.0322581,.9677419,31,0,1,0,1
"EDISON",45,0,1,0,45,1,0,1,0
"EKATERINA",0,44,0,1,44,0,1,0,1
"GRETA",0,45,0,1,45,0,1,0,1
"GUILLAUME",29,1,.9666666,.0333333,30,1,0,1,0
"ILEANA",0,36,0,1,36,0,1,0,1
"LOVE",15,29,.3409091,.6590909,44,0,0,0,0
"MADDY",2,33,.0571429,.9428571,35,0,1,0,0
"MALIKA",0,36,0,1,36,0,1,0,1
"MIKI",15,25,.375,.625,40,0,0,0,0
"MINERVA",0,56,0,1,56,0,1,0,1
"RAJESH",42,0,1,0,42,1,0,1,0
"RED",36,17,.6792453,.3207547,53,0,0,0,0
"SAMARA",0,41,0,1,41,0,1,0,1
"SHANTE",0,50,0,1,50,0,1,0,1
"SOL",21,26,.4468085,.5531915,47,0,0,0,0
"TAI",24,23,.5106383,.4893617,47,0,0,0,0
"THEA",0,39,0,1,39,0,1,0,1
"YANG",24,17,.5853658,.4146341,41,0,0,0,0
"YUNG",49,4,.9245283,.0754717,53,1,0,0,0
"CAMILLA",0,35,0,1,35,0,1,0,1
"CLAUDETTE",0,48,0,1,48,0,1,0,1
"DARIN",37,1,.9736842,.0263158,38,1,0,1,0
"DEEPAK",46,0,1,0,46,1,0,1,0
"HAKAN",45,0,1,0,45,1,0,1,0
"JANIE",0,37,0,1,37,0,1,0,1
"KRISSY",0,33,0,1,33,0,1,0,1
"MARNI",0,29,0,1,29,0,1,0,1
"NED",28,0,1,0,28,1,0,1,0
"PENÃˆLOPE",1,41,.0238095,.9761904,42,0,1,0,1
"PRINCESS",0,45,0,1,45,0,1,0,1
"ROSALYN",0,44,0,1,44,0,1,0,1
"ADRIANNA",0,32,0,1,32,0,1,0,1
"AJA",0,36,0,1,36,0,1,0,1
"ALENA",0,38,0,1,38,0,1,0,1
"ASIF",41,0,1,0,41,1,0,1,0
"BERNARDO",45,0,1,0,45,1,0,1,0
"ELISHA",13,30,.3023256,.6976744,43,0,0,0,0
"GALINA",0,45,0,1,45,0,1,0,1
"JOAQUÃçN",52,0,1,0,52,1,0,1,0
"JUSTINA",0,37,0,1,37,0,1,0,1
"KENIA",0,45,0,1,45,0,1,0,1
"KONSTANTIN",41,0,1,0,41,1,0,1,0
"LEX",32,7,.8205128,.1794872,39,1,0,0,0
"MANUELA",0,43,0,1,43,0,1,0,1
"MARQUIS",49,0,1,0,49,1,0,1,0
"MENDY",33,6,.8461539,.1538462,39,1,0,0,0
"PAVEL",46,0,1,0,46,1,0,1,0
"REYNALDO",50,0,1,0,50,1,0,1,0
"RUTHIE",0,36,0,1,36,0,1,0,1
"SHEA",13,25,.3421053,.6578947,38,0,0,0,0
"TAISHA",0,37,0,1,37,0,1,0,1
"DEBORA",0,45,0,1,45,0,1,0,1
"DORI",2,30,.0625,.9375,32,0,1,0,0
"ERWIN",39,0,1,0,39,1,0,1,0
"JO-ANN",0,45,0,1,45,0,1,0,1
"LUCIANA",0,43,0,1,43,0,1,0,1
"RHEA",0,35,0,1,35,0,1,0,1
"RODERICK",43,0,1,0,43,1,0,1,0
"ROSEANNE",0,41,0,1,41,0,1,0,1
"SKY",35,11,.7608696,.2391304,46,1,0,0,0
"TARIK",43,0,1,0,43,1,0,1,0
"TENZIN",30,15,.6666667,.3333333,45,0,0,0,0
"YADIRA",0,45,0,1,45,0,1,0,1
"ZAC",36,0,1,0,36,1,0,1,0
"ADRIANNE",0,36,0,1,36,0,1,0,1
"ANJALI",0,31,0,1,31,0,1,0,1
"AWILDA",0,49,0,1,49,0,1,0,1
"BETTINA",0,39,0,1,39,0,1,0,1
"CAITLYN",0,26,0,1,26,0,1,0,1
"CHRISTOPHE",35,1,.9722222,.0277778,36,1,0,1,0
"CYRUS",39,0,1,0,39,1,0,1,0
"DA",28,13,.6829268,.3170732,41,0,0,0,0
"DAHLIA",0,35,0,1,35,0,1,0,1
"DEMETRIUS",48,1,.9795918,.0204082,49,1,0,1,0
"DENNY",31,3,.9117647,.0882353,34,1,0,0,0
"EMRE",40,0,1,0,40,1,0,1,0
"FAY",1,37,.0263158,.9736842,38,0,1,0,1
"JESSENIA",0,45,0,1,45,0,1,0,1
"JOVAN",41,5,.8913044,.1086956,46,1,0,0,0
"LIDIA",0,42,0,1,42,0,1,0,1
"MIKA",4,31,.1142857,.8857143,35,0,1,0,0
"NIKHIL",32,0,1,0,32,1,0,1,0
"RAMI",41,1,.9761904,.0238095,42,1,0,1,0
"SEEMA",0,40,0,1,40,0,1,0,1
"TOBIAS",33,0,1,0,33,1,0,1,0
"TRACIE",0,35,0,1,35,0,1,0,1
"XIAO",18,25,.4186046,.5813953,43,0,0,0,0
"YONG",40,1,.9756098,.0243902,41,1,0,1,0
"ASHER",36,0,1,0,36,1,0,1,0
"AYA",0,26,0,1,26,0,1,0,1
"DAVON",48,0,1,0,48,1,0,1,0
"EDEN",7,25,.21875,.78125,32,0,1,0,0
"FRANCOIS",36,0,1,0,36,1,0,1,0
"FREDERIC",39,0,1,0,39,1,0,1,0
"JELANI",43,0,1,0,43,1,0,1,0
"JULIANNA",0,39,0,1,39,0,1,0,1
"LAILA",0,31,0,1,31,0,1,0,1
"LING",9,30,.2307692,.7692308,39,0,1,0,0
"MANISH",36,0,1,0,36,1,0,1,0
"RASHAD",42,1,.9767442,.0232558,43,1,0,1,0
"RASHIDA",0,32,0,1,32,0,1,0,1
"REID",38,3,.9268293,.0731707,41,1,0,0,0
"REUBEN",49,0,1,0,49,1,0,1,0
"ROSLYN",1,50,.0196078,.9803922,51,0,1,0,1
"STEPHANE",28,7,.8,.2,35,1,0,0,0
"TONIA",0,48,0,1,48,0,1,0,1
"YUKO",0,29,0,1,29,0,1,0,1
"YURIY",32,0,1,0,32,1,0,1,0
"CHRISTOS",40,0,1,0,40,1,0,1,0
"ELBA",0,46,0,1,46,0,1,0,1
"FLOR",0,46,0,1,46,0,1,0,1
"JANIS",4,38,.0952381,.9047619,42,0,1,0,0
"JEFFERY",47,0,1,0,47,1,0,1,0
"LAKISHA",0,43,0,1,43,0,1,0,1
"MATTY",36,2,.9473684,.0526316,38,1,0,0,0
"MILAN",28,5,.8484849,.1515152,33,1,0,0,0
"NYC",22,9,.7096774,.2903226,31,0,0,0,0
"STU",40,0,1,0,40,1,0,1,0
"WALLY",36,7,.8372093,.1627907,43,1,0,0,0
"YASMINE",0,29,0,1,29,0,1,0,1
"AMALIA",0,33,0,1,33,0,1,0,1
"FELICE",3,40,.0697674,.9302326,43,0,1,0,0
"FRITZ",42,1,.9767442,.0232558,43,1,0,1,0
"GEMMA",0,38,0,1,38,0,1,0,1
"Há»’NG",26,18,.5909091,.4090909,44,0,0,0,0
"JAIMIE",5,28,.1515152,.8484849,33,0,1,0,0
"JAMIL",42,1,.9767442,.0232558,43,1,0,1,0
"JESSI",2,25,.0740741,.9259259,27,0,1,0,0
"JUANA",0,43,0,1,43,0,1,0,1
"NINO",35,14,.7142857,.2857143,49,0,0,0,0
"REED",40,1,.9756098,.0243902,41,1,0,1,0
"THOM",38,0,1,0,38,1,0,1,0
"ACE",41,1,.9761904,.0238095,42,1,0,1,0
"AKIKO",0,35,0,1,35,0,1,0,1
"BARBIE",1,38,.025641,.974359,39,0,1,0,1
"BARI",2,22,.0833333,.9166667,24,0,1,0,0
"DICK",43,0,1,0,43,1,0,1,0
"INGA",0,27,0,1,27,0,1,0,1
"JASPER",36,2,.9473684,.0526316,38,1,0,0,0
"JOHNNIE",40,4,.9090909,.0909091,44,1,0,0,0
"KARAN",36,5,.8780488,.1219512,41,1,0,0,0
"MARKO",40,0,1,0,40,1,0,1,0
"NYDIA",0,41,0,1,41,0,1,0,1
"RAE",3,32,.0857143,.9142857,35,0,1,0,0
"RENATO",37,0,1,0,37,1,0,1,0
"SANA",3,27,.1,.9,30,0,1,0,0
"SANG",27,6,.8181818,.1818182,33,1,0,0,0
"SHAI",21,8,.7241379,.2758621,29,0,0,0,0
"SHAVON",1,40,.0243902,.9756098,41,0,1,0,1
"SUSANNAH",0,24,0,1,24,0,1,0,1
"VIKRAM",34,0,1,0,34,1,0,1,0
"CARI",0,31,0,1,31,0,1,0,1
"GONZALO",42,0,1,0,42,1,0,1,0
"HEATH",23,0,1,0,23,1,0,1,0
"LEANDRO",43,1,.9772727,.0227273,44,1,0,1,0
"MACKENZIE",6,19,.24,.76,25,0,1,0,0
"MARCIE",0,33,0,1,33,0,1,0,1
"MILA",1,32,.030303,.969697,33,0,1,0,1
"PASCAL",31,3,.9117647,.0882353,34,1,0,0,0
"RAJIV",44,0,1,0,44,1,0,1,0
"SANTOS",43,5,.8958333,.1041667,48,1,0,0,0
"SUNITA",0,43,0,1,43,0,1,0,1
"TAINA",0,34,0,1,34,0,1,0,1
"ZORAIDA",0,44,0,1,44,0,1,0,1
"ABHISHEK",51,0,1,0,51,1,0,1,0
"BAILEY",16,21,.4324324,.5675676,37,0,0,0,0
"CARLENE",0,39,0,1,39,0,1,0,1
"CLIFTON",37,0,1,0,37,1,0,1,0
"DEBI",0,33,0,1,33,0,1,0,1
"ELIE",35,3,.9210526,.0789474,38,1,0,0,0
"ELYSSA",0,27,0,1,27,0,1,0,1
"GEE",32,8,.8,.2,40,1,0,0,0
"GIANNI",37,3,.925,.075,40,1,0,0,0
"HERNÃÅN",48,0,1,0,48,1,0,1,0
"JARRETT",39,0,1,0,39,1,0,1,0
"JAYME",7,25,.21875,.78125,32,0,1,0,0
"JONI",4,28,.125,.875,32,0,1,0,0
"KYLIE",0,34,0,1,34,0,1,0,1
"LARS",40,2,.952381,.047619,42,1,0,1,0
"MAIA",0,26,0,1,26,0,1,0,1
"MAJA",0,30,0,1,30,0,1,0,1
"MARCELLO",43,0,1,0,43,1,0,1,0
"MASON",31,2,.9393939,.0606061,33,1,0,0,0
"NIK",30,2,.9375,.0625,32,1,0,0,0
"POLLY",1,34,.0285714,.9714286,35,0,1,0,1
"SHARIF",27,0,1,0,27,1,0,1,0
"STEVIE",23,12,.6571429,.3428572,35,0,0,0,0
"YUSUF",33,0,1,0,33,1,0,1,0
"YVES",36,2,.9473684,.0526316,38,1,0,0,0
"BOBBI",2,34,.0555556,.9444444,36,0,1,0,0
"CECIL",44,2,.9565217,.0434783,46,1,0,1,0
"CHERISE",0,39,0,1,39,0,1,0,1
"DARRIN",34,0,1,0,34,1,0,1,0
"EFFIE",1,33,.0294118,.9705882,34,0,1,0,1
"EVIE",0,28,0,1,28,0,1,0,1
"JANEL",1,34,.0285714,.9714286,35,0,1,0,1
"MAE",1,34,.0285714,.9714286,35,0,1,0,1
"MASSIMO",47,0,1,0,47,1,0,1,0
"MILANA",0,24,0,1,24,0,1,0,1
"REENA",0,34,0,1,34,0,1,0,1
"SUN",19,18,.5135135,.4864865,37,0,0,0,0
"WAI",18,13,.5806451,.4193548,31,0,0,0,0
"BEATA",0,36,0,1,36,0,1,0,1
"BILAL",41,0,1,0,41,1,0,1,0
"BREE",0,36,0,1,36,0,1,0,1
"BRET",31,0,1,0,31,1,0,1,0
"COLEEN",0,39,0,1,39,0,1,0,1
"ELAN",26,1,.962963,.037037,27,1,0,1,0
"EMMY",1,33,.0294118,.9705882,34,0,1,0,1
"FRANTZ",37,0,1,0,37,1,0,1,0
"GIO",31,4,.8857143,.1142857,35,1,0,0,0
"HUMBERTO",37,0,1,0,37,1,0,1,0
"JHON",41,0,1,0,41,1,0,1,0
"KATARINA",0,21,0,1,21,0,1,0,1
"LAYLA",0,35,0,1,35,0,1,0,1
"MARIANO",47,0,1,0,47,1,0,1,0
"MAURO",40,0,1,0,40,1,0,1,0
"OCTAVIA",0,47,0,1,47,0,1,0,1
"RASHID",39,0,1,0,39,1,0,1,0
"REBECA",0,36,0,1,36,0,1,0,1
"SHANICE",0,25,0,1,25,0,1,0,1
"STEFANI",0,36,0,1,36,0,1,0,1
"USMAN",37,0,1,0,37,1,0,1,0
"WEN",16,17,.4848485,.5151515,33,0,0,0,0
"YAJAIRA",0,35,0,1,35,0,1,0,1
"AHMET",47,0,1,0,47,1,0,1,0
"ALLEGRA",0,24,0,1,24,0,1,0,1
"ANU",6,23,.2068966,.7931035,29,0,1,0,0
"CELINA",0,36,0,1,36,0,1,0,1
"CHIARA",0,28,0,1,28,0,1,0,1
"JOANA",0,26,0,1,26,0,1,0,1
"LEV",34,1,.9714286,.0285714,35,1,0,1,0
"LEYLA",0,32,0,1,32,0,1,0,1
"LINCOLN",38,0,1,0,38,1,0,1,0
"SACHA",9,16,.36,.64,25,0,0,0,0
"SADIE",0,33,0,1,33,0,1,0,1
"SHAQUANA",0,43,0,1,43,0,1,0,1
"YESSENIA",0,36,0,1,36,0,1,0,1
"ADITYA",31,0,1,0,31,1,0,1,0
"BRIGID",0,26,0,1,26,0,1,0,1
"DRE",36,0,1,0,36,1,0,1,0
"ESTELLE",0,42,0,1,42,0,1,0,1
"FLORIAN",29,0,1,0,29,1,0,1,0
"GIDEON",34,0,1,0,34,1,0,1,0
"GISELA",0,34,0,1,34,0,1,0,1
"INA",0,35,0,1,35,0,1,0,1
"JONATHON",41,0,1,0,41,1,0,1,0
"LUCIANO",47,0,1,0,47,1,0,1,0
"NOLAN",28,0,1,0,28,1,0,1,0
"RAINA",0,25,0,1,25,0,1,0,1
"RAJA",32,1,.969697,.030303,33,1,0,1,0
"SAMIRA",0,35,0,1,35,0,1,0,1
"SEBASTIEN",32,0,1,0,32,1,0,1,0
"SIERRA",0,28,0,1,28,0,1,0,1
"YOKO",0,31,0,1,31,0,1,0,1
"ZINA",0,31,0,1,31,0,1,0,1
"ALECIA",0,30,0,1,30,0,1,0,1
"AMAN",27,4,.8709677,.1290323,31,1,0,0,0
"ANKUR",35,0,1,0,35,1,0,1,0
"ANTONY",38,0,1,0,38,1,0,1,0
"ARTUR",36,0,1,0,36,1,0,1,0
"BRENDON",36,0,1,0,36,1,0,1,0
"CALLIE",0,34,0,1,34,0,1,0,1
"CHEYENNE",4,21,.16,.84,25,0,1,0,0
"CLEMENT",39,0,1,0,39,1,0,1,0
"DIVYA",1,25,.0384615,.9615384,26,0,1,0,1
"GABI",2,19,.0952381,.9047619,21,0,1,0,0
"JENELLE",0,33,0,1,33,0,1,0,1
"JOLIE",0,22,0,1,22,0,1,0,1
"KEIKO",0,33,0,1,33,0,1,0,1
"KIMMY",1,29,.0333333,.9666666,30,0,1,0,1
"LUCIE",0,24,0,1,24,0,1,0,1
"MARCIN",38,0,1,0,38,1,0,1,0
"MILLY",1,35,.0277778,.9722222,36,0,1,0,1
"MISTY",1,25,.0384615,.9615384,26,0,1,0,1
"RODOLFO",40,0,1,0,40,1,0,1,0
"SOO",4,20,.1666667,.8333333,24,0,1,0,0
"ADRIEN",28,5,.8484849,.1515152,33,1,0,0,0
"ALAINA",0,27,0,1,27,0,1,0,1
"BARNEY",40,0,1,0,40,1,0,1,0
"DAVIDE",35,0,1,0,35,1,0,1,0
"EJ",23,7,.7666667,.2333333,30,1,0,0,0
"ELAINA",0,26,0,1,26,0,1,0,1
"HALLIE",1,20,.047619,.952381,21,0,1,0,1
"JAMI",0,30,0,1,30,0,1,0,1
"JOHANA",1,33,.0294118,.9705882,34,0,1,0,1
"KESHA",1,36,.027027,.972973,37,0,1,0,1
"KHALIL",32,0,1,0,32,1,0,1,0
"KIN",26,4,.8666667,.1333333,30,1,0,0,0
"KOFI",41,0,1,0,41,1,0,1,0
"LU",18,24,.4285714,.5714286,42,0,0,0,0
"NOAM",24,0,1,0,24,1,0,1,0
"ROBB",26,0,1,0,26,1,0,1,0
"SACHIN",36,0,1,0,36,1,0,1,0
"SALMAN",31,0,1,0,31,1,0,1,0
"SANDRO",33,0,1,0,33,1,0,1,0
"SKYE",8,25,.2424242,.7575758,33,0,1,0,0
"SMITH",25,17,.5952381,.4047619,42,0,0,0,0
"TOMER",25,0,1,0,25,1,0,1,0
"TOVA",0,24,0,1,24,0,1,0,1
"VARUN",38,0,1,0,38,1,0,1,0
"YANIV",28,0,1,0,28,1,0,1,0
"YULIA",0,34,0,1,34,0,1,0,1
"ANNABELLE",0,32,0,1,32,0,1,0,1
"ARTEM",32,0,1,0,32,1,0,1,0
"COLBY",28,6,.8235294,.1764706,34,1,0,0,0
"CORINA",0,25,0,1,25,0,1,0,1
"CÃ‰CILE",0,29,0,1,29,0,1,0,1
"DEVORAH",0,24,0,1,24,0,1,0,1
"EDGARDO",40,0,1,0,40,1,0,1,0
"EDMOND",38,0,1,0,38,1,0,1,0
"ENRICO",34,0,1,0,34,1,0,1,0
"ESMERALDA",0,39,0,1,39,0,1,0,1
"GENA",3,30,.0909091,.9090909,33,0,1,0,0
"HAYDEN",22,14,.6111111,.3888889,36,0,0,0,0
"IRENA",0,32,0,1,32,0,1,0,1
"KAROL",10,17,.3703704,.6296296,27,0,0,0,0
"KRISHNA",20,8,.7142857,.2857143,28,0,0,0,0
"LIOR",27,3,.9,.1,30,1,0,0,0
"LITTLE",23,17,.575,.425,40,0,0,0,0
"LUKAS",36,0,1,0,36,1,0,1,0
"LUNA",1,30,.0322581,.9677419,31,0,1,0,1
"MURIEL",0,36,0,1,36,0,1,0,1
"NABIL",28,0,1,0,28,1,0,1,0
"NAN",5,33,.131579,.8684211,38,0,1,0,0
"NANETTE",0,29,0,1,29,0,1,0,1
"NIC",24,6,.8,.2,30,1,0,0,0
"PASTOR",33,9,.7857143,.2142857,42,1,0,0,0
"PRIYANKA",0,30,0,1,30,0,1,0,1
"SAMSON",31,0,1,0,31,1,0,1,0
"SU",4,33,.1081081,.8918919,37,0,1,0,0
"YAAKOV",24,0,1,0,24,1,0,1,0
"YOSEF",31,0,1,0,31,1,0,1,0
"ARLEEN",0,45,0,1,45,0,1,0,1
"BEA",2,26,.0714286,.9285714,28,0,1,0,0
"BENNETT",29,0,1,0,29,1,0,1,0
"BRADFORD",30,1,.9677419,.0322581,31,1,0,1,0
"CATE",0,23,0,1,23,0,1,0,1
"CHESTER",37,2,.948718,.0512821,39,1,0,0,0
"DERICK",30,2,.9375,.0625,32,1,0,0,0
"DONNELL",39,2,.9512195,.0487805,41,1,0,1,0
"EUN",4,27,.1290323,.8709677,31,0,1,0,0
"GIULIA",0,21,0,1,21,0,1,0,1
"JARROD",40,0,1,0,40,1,0,1,0
"JELENA",0,25,0,1,25,0,1,0,1
"LEONA",0,33,0,1,33,0,1,0,1
"MARNIE",0,24,0,1,24,0,1,0,1
"MOIRA",0,24,0,1,24,0,1,0,1
"ORLY",2,22,.0833333,.9166667,24,0,1,0,0
"PASCALE",0,29,0,1,29,0,1,0,1
"SCARLETT",0,25,0,1,25,0,1,0,1
"THIERRY",36,0,1,0,36,1,0,1,0
"TONIANN",0,31,0,1,31,0,1,0,1
"TOYA",1,29,.0333333,.9666666,30,0,1,0,1
"ALIA",0,29,0,1,29,0,1,0,1
"ARIANE",0,21,0,1,21,0,1,0,1
"AXEL",35,0,1,0,35,1,0,1,0
"CHANELLE",0,26,0,1,26,0,1,0,1
"CHAZ",37,0,1,0,37,1,0,1,0
"DELPHINE",0,23,0,1,23,0,1,0,1
"DEON",24,11,.6857143,.3142857,35,0,0,0,0
"GEO",29,2,.9354839,.0645161,31,1,0,0,0
"HERB",33,0,1,0,33,1,0,1,0
"HUI",11,23,.3235294,.6764706,34,0,0,0,0
"IRWIN",40,1,.9756098,.0243902,41,1,0,1,0
"ISA",13,20,.3939394,.6060606,33,0,0,0,0
"JESENIA",0,31,0,1,31,0,1,0,1
"KALI",3,22,.12,.88,25,0,1,0,0
"KYRA",0,26,0,1,26,0,1,0,1
"MAXÃçM",33,0,1,0,33,1,0,1,0
"MERCY",4,32,.1111111,.8888889,36,0,1,0,0
"NELL",2,16,.1111111,.8888889,18,0,1,0,0
"NITIN",31,0,1,0,31,1,0,1,0
"NOELIA",0,37,0,1,37,0,1,0,1
"RAM",33,1,.9705882,.0294118,34,1,0,1,0
"ROXY",1,37,.0263158,.9736842,38,0,1,0,1
"SHAN",17,10,.6296296,.3703704,27,0,0,0,0
"TAE",22,7,.7586207,.2413793,29,1,0,0,0
"ZARA",1,22,.0434783,.9565217,23,0,1,0,1
"ABBIE",0,20,0,1,20,0,1,0,1
"ALEKSANDR",35,0,1,0,35,1,0,1,0
"ANABEL",0,32,0,1,32,0,1,0,1
"ANIA",0,24,0,1,24,0,1,0,1
"BROWN",16,18,.4705882,.5294118,34,0,0,0,0
"CATERINA",0,25,0,1,25,0,1,0,1
"CECELIA",0,39,0,1,39,0,1,0,1
"CECILY",0,30,0,1,30,0,1,0,1
"CLIVE",39,0,1,0,39,1,0,1,0
"CYNDI",0,30,0,1,30,0,1,0,1
"DANILO",37,0,1,0,37,1,0,1,0
"ELLY",7,24,.2258064,.7741935,31,0,1,0,0
"EWA",0,29,0,1,29,0,1,0,1
"FALLON",0,31,0,1,31,0,1,0,1
"FAUSTO",45,0,1,0,45,1,0,1,0
"HAN",25,6,.8064516,.1935484,31,1,0,0,0
"IKE",33,0,1,0,33,1,0,1,0
"IVELISSE",0,33,0,1,33,0,1,0,1
"JENA",0,26,0,1,26,0,1,0,1
"KADEEM",38,0,1,0,38,1,0,1,0
"MARIKO",0,26,0,1,26,0,1,0,1
"MASSIEL",0,28,0,1,28,0,1,0,1
"MATHIEU",32,0,1,0,32,1,0,1,0
"MEHDI",38,0,1,0,38,1,0,1,0
"MICK",32,1,.969697,.030303,33,1,0,1,0
"MINNIE",0,32,0,1,32,0,1,0,1
"NEW",15,7,.6818182,.3181818,22,0,0,0,0
"PARKER",29,5,.8529412,.1470588,34,1,0,0,0
"RANDOLPH",37,0,1,0,37,1,0,1,0
"SHERMAN",33,2,.9428571,.0571429,35,1,0,0,0
"STEFANIA",0,30,0,1,30,0,1,0,1
"STERLING",31,3,.9117647,.0882353,34,1,0,0,0
"URI",34,1,.9714286,.0285714,35,1,0,1,0
"YUAN",13,18,.4193548,.5806451,31,0,0,0,0
"ANJA",0,24,0,1,24,0,1,0,1
"BASIL",39,0,1,0,39,1,0,1,0
"BLUE",17,9,.6538461,.3461539,26,0,0,0,0
"BOBBIE",10,27,.2702703,.7297297,37,0,0,0,0
"BRADY",25,0,1,0,25,1,0,1,0
"BRENNA",0,21,0,1,21,0,1,0,1
"CHAN",22,5,.8148148,.1851852,27,1,0,0,0
"DASHA",0,20,0,1,20,0,1,0,1
"DELORES",0,42,0,1,42,0,1,0,1
"ESTER",0,26,0,1,26,0,1,0,1
"FRANKLYN",36,0,1,0,36,1,0,1,0
"JOANIE",0,36,0,1,36,0,1,0,1
"JOON",24,0,1,0,24,1,0,1,0
"KATHIE",0,35,0,1,35,0,1,0,1
"LIVIA",0,29,0,1,29,0,1,0,1
"LORD",40,1,.9756098,.0243902,41,1,0,1,0
"LYN",2,35,.0540541,.9459459,37,0,1,0,0
"NATALYA",0,26,0,1,26,0,1,0,1
"RONNI",3,32,.0857143,.9142857,35,0,1,0,0
"STARR",3,33,.0833333,.9166667,36,0,1,0,0
"THALIA",0,27,0,1,27,0,1,0,1
"AURA",0,28,0,1,28,0,1,0,1
"BEE",8,17,.32,.68,25,0,0,0,0
"CONSTANTINE",32,0,1,0,32,1,0,1,0
"CORA",0,30,0,1,30,0,1,0,1
"DAVINA",0,22,0,1,22,0,1,0,1
"GARTH",27,0,1,0,27,1,0,1,0
"JADA",4,30,.1176471,.8823529,34,0,1,0,0
"JIE",16,16,.5,.5,32,0,0,0,0
"JOÃƒO",34,1,.9714286,.0285714,35,1,0,1,0
"LANE",20,6,.7692308,.2307692,26,1,0,0,0
"LESLY",12,20,.375,.625,32,0,0,0,0
"LIZBETH",0,37,0,1,37,0,1,0,1
"MAHMOUD",31,0,1,0,31,1,0,1,0
"MARLENA",0,26,0,1,26,0,1,0,1
"MAT",30,0,1,0,30,1,0,1,0
"OSMAN",29,0,1,0,29,1,0,1,0
"OTTO",33,0,1,0,33,1,0,1,0
"RONY",27,1,.9642857,.0357143,28,1,0,1,0
"SADIA",1,23,.0416667,.9583333,24,0,1,0,1
"SAMMI",2,24,.0769231,.9230769,26,0,1,0,0
"SHMUEL",29,0,1,0,29,1,0,1,0
"SOLANGE",0,33,0,1,33,0,1,0,1
"UNIQUE",12,25,.3243243,.6756757,37,0,0,0,0
"ASHTON",26,5,.8387097,.1612903,31,1,0,0,0
"CEM",32,0,1,0,32,1,0,1,0
"DUKE",32,0,1,0,32,1,0,1,0
"ERAN",25,0,1,0,25,1,0,1,0
"FARHAN",29,1,.9666666,.0333333,30,1,0,1,0
"GALE",4,34,.1052632,.8947368,38,0,1,0,0
"HARLEY",17,9,.6538461,.3461539,26,0,0,0,0
"JAVON",33,2,.9428571,.0571429,35,1,0,0,0
"JOSEFINA",0,31,0,1,31,0,1,0,1
"KARINE",0,22,0,1,22,0,1,0,1
"KATI",0,27,0,1,27,0,1,0,1
"LUCINDA",0,19,0,1,19,0,1,0,1
"LYNDSEY",0,25,0,1,25,0,1,0,1
"PAULIE",33,1,.9705882,.0294118,34,1,0,1,0
"RAKESH",31,0,1,0,31,1,0,1,0
"REYNA",0,31,0,1,31,0,1,0,1
"ROMAIN",23,2,.92,.08,25,1,0,0,0
"ROMY",5,17,.2272727,.7727273,22,0,1,0,0
"SHARA",0,22,0,1,22,0,1,0,1
"XIN",19,9,.6785714,.3214286,28,0,0,0,0
"Ä°SMAIL",29,0,1,0,29,1,0,1,0
"ADEL",21,4,.84,.16,25,1,0,0,0
"AGATA",0,27,0,1,27,0,1,0,1
"CARMEL",3,27,.1,.9,30,0,1,0,0
"CLARIBEL",0,29,0,1,29,0,1,0,1
"DAVIS",27,7,.7941176,.2058824,34,1,0,0,0
"ELLIS",22,4,.8461539,.1538462,26,1,0,0,0
"HUBERT",32,0,1,0,32,1,0,1,0
"JAI",22,8,.7333333,.2666667,30,0,0,0,0
"JANINA",0,32,0,1,32,0,1,0,1
"KESHIA",0,34,0,1,34,0,1,0,1
"MARIELLE",0,21,0,1,21,0,1,0,1
"MAURIZIO",35,0,1,0,35,1,0,1,0
"NATACHA",0,29,0,1,29,0,1,0,1
"OSVALDO",35,0,1,0,35,1,0,1,0
"PIOTR",35,0,1,0,35,1,0,1,0
"ROWENA",0,27,0,1,27,0,1,0,1
"RUI",24,10,.7058824,.2941177,34,0,0,0,0
"SALVADOR",37,0,1,0,37,1,0,1,0
"SHA",10,18,.3571429,.6428571,28,0,0,0,0
"SHERRIE",0,30,0,1,30,0,1,0,1
"SHERWIN",27,2,.9310345,.0689655,29,1,0,0,0
"SYLVIE",0,27,0,1,27,0,1,0,1
"THELMA",0,34,0,1,34,0,1,0,1
"VIVIEN",1,25,.0384615,.9615384,26,0,1,0,1
"ALYSE",0,23,0,1,23,0,1,0,1
"ANNAMARIA",0,29,0,1,29,0,1,0,1
"BUDDY",32,1,.969697,.030303,33,1,0,1,0
"CHANI",0,24,0,1,24,0,1,0,1
"CURT",34,0,1,0,34,1,0,1,0
"DEEPA",2,24,.0769231,.9230769,26,0,1,0,0
"DOMENICO",38,0,1,0,38,1,0,1,0
"DULCE",1,23,.0416667,.9583333,24,0,1,0,1
"ELIOT",29,0,1,0,29,1,0,1,0
"EYAL",28,0,1,0,28,1,0,1,0
"HORACE",34,0,1,0,34,1,0,1,0
"ISIS",1,28,.0344828,.9655172,29,0,1,0,1
"JONELLE",1,30,.0322581,.9677419,31,0,1,0,1
"JUST",25,10,.7142857,.2857143,35,0,0,0,0
"KAMIL",34,0,1,0,34,1,0,1,0
"KASHIF",35,0,1,0,35,1,0,1,0
"KYLA",0,25,0,1,25,0,1,0,1
"LAKEISHA",0,37,0,1,37,0,1,0,1
"LEIDY",1,28,.0344828,.9655172,29,0,1,0,1
"LYLE",27,0,1,0,27,1,0,1,0
"MADDIE",0,22,0,1,22,0,1,0,1
"MATTHIAS",37,0,1,0,37,1,0,1,0
"MIRNA",0,29,0,1,29,0,1,0,1
"MURRAY",30,1,.9677419,.0322581,31,1,0,1,0
"NILSA",0,33,0,1,33,0,1,0,1
"NOA",2,27,.0689655,.9310345,29,0,1,0,0
"PASQUALE",34,0,1,0,34,1,0,1,0
"RIC",28,0,1,0,28,1,0,1,0
"ROMINA",0,22,0,1,22,0,1,0,1
"ROMMEL",31,0,1,0,31,1,0,1,0
"SELMA",0,27,0,1,27,0,1,0,1
"XIMENA",0,27,0,1,27,0,1,0,1
"ADOLFO",37,0,1,0,37,1,0,1,0
"ANGELIKA",1,27,.0357143,.9642857,28,0,1,0,1
"ANNE-MARIE",0,17,0,1,17,0,1,0,1
"BURAK",24,0,1,0,24,1,0,1,0
"CYRIL",21,0,1,0,21,1,0,1,0
"DANIA",0,24,0,1,24,0,1,0,1
"DEIDRA",0,34,0,1,34,0,1,0,1
"DOMENICK",35,0,1,0,35,1,0,1,0
"DOMINGO",37,1,.9736842,.0263158,38,1,0,1,0
"DONG",33,3,.9166667,.0833333,36,1,0,0,0
"EITAN",25,1,.9615384,.0384615,26,1,0,1,0
"EMI",2,24,.0769231,.9230769,26,0,1,0,0
"FLAVIA",0,35,0,1,35,0,1,0,1
"GEORGETTE",0,28,0,1,28,0,1,0,1
"GRACIE",0,31,0,1,31,0,1,0,1
"HAILEY",0,20,0,1,20,0,1,0,1
"HYUN",18,13,.5806451,.4193548,31,0,0,0,0
"JACKLYN",0,26,0,1,26,0,1,0,1
"JUSTYNA",0,26,0,1,26,0,1,0,1
"LEI",10,15,.4,.6,25,0,0,0,0
"LISSA",0,27,0,1,27,0,1,0,1
"LONNIE",24,4,.8571429,.1428571,28,1,0,0,0
"NALINI",0,34,0,1,34,0,1,0,1
"ONUR",32,1,.969697,.030303,33,1,0,1,0
"RONIT",3,16,.1578947,.8421053,19,0,1,0,0
"RÃ„Ã‘Ã…",7,15,.3181818,.6818182,22,0,0,0,0
"SAGE",15,13,.5357143,.4642857,28,0,0,0,0
"SAURABH",30,0,1,0,30,1,0,1,0
"SUZAN",0,25,0,1,25,0,1,0,1
"TANESHA",0,24,0,1,24,0,1,0,1
"YANIRA",0,31,0,1,31,0,1,0,1
"YUN",7,19,.2692308,.7307692,26,0,0,0,0
"ADE",21,6,.7777778,.2222222,27,1,0,0,0
"AMAURY",31,1,.96875,.03125,32,1,0,1,0
"ANGELINE",0,32,0,1,32,0,1,0,1
"ANN-MARIE",0,32,0,1,32,0,1,0,1
"ARIF",20,0,1,0,20,1,0,1,0
"ASIM",22,0,1,0,22,1,0,1,0
"BILLIE",3,22,.12,.88,25,0,1,0,0
"CHANIE",0,19,0,1,19,0,1,0,1
"COOPER",24,2,.9230769,.0769231,26,1,0,0,0
"CORRINE",0,29,0,1,29,0,1,0,1
"ERICH",28,0,1,0,28,1,0,1,0
"ETHEL",0,30,0,1,30,0,1,0,1
"FRANZ",39,0,1,0,39,1,0,1,0
"JENI",0,22,0,1,22,0,1,0,1
"JOLENE",0,18,0,1,18,0,1,0,1
"KEILA",0,30,0,1,30,0,1,0,1
"LALA",2,28,.0666667,.9333333,30,0,1,0,0
"LAURI",1,27,.0357143,.9642857,28,0,1,0,1
"MIRI",4,17,.1904762,.8095238,21,0,1,0,0
"NAIMA",0,30,0,1,30,0,1,0,1
"NATALY",0,30,0,1,30,0,1,0,1
"NAVIN",33,0,1,0,33,1,0,1,0
"NEVILLE",30,0,1,0,30,1,0,1,0
"OMARI",29,0,1,0,29,1,0,1,0
"PREETI",0,26,0,1,26,0,1,0,1
"ROZ",0,31,0,1,31,0,1,0,1
"SARINA",0,17,0,1,17,0,1,0,1
"SAVANNAH",0,25,0,1,25,0,1,0,1
"SHALINI",0,22,0,1,22,0,1,0,1
"SHAMIKA",0,32,0,1,32,0,1,0,1
"SHIVANI",0,16,0,1,16,0,1,0,1
"SONDRA",0,44,0,1,44,0,1,0,1
"TORY",12,11,.5217391,.4782609,23,0,0,0,0
"VIKTOR",30,0,1,0,30,1,0,1,0
"YAKOV",31,0,1,0,31,1,0,1,0
"AKI",5,18,.2173913,.7826087,23,0,1,0,0
"CLEO",4,24,.1428571,.8571429,28,0,1,0,0
"CONCETTA",0,29,0,1,29,0,1,0,1
"DAKOTA",18,11,.6206896,.3793103,29,0,0,0,0
"DALLAS",23,5,.8214286,.1785714,28,1,0,0,0
"ELIEZER",33,0,1,0,33,1,0,1,0
"FABIANA",0,27,0,1,27,0,1,0,1
"FABRIZIO",30,0,1,0,30,1,0,1,0
"FATIH",29,0,1,0,29,1,0,1,0
"FERN",2,31,.0606061,.9393939,33,0,1,0,0
"FLOYD",33,0,1,0,33,1,0,1,0
"FRANCHESCA",0,30,0,1,30,0,1,0,1
"JOHANN",25,4,.862069,.137931,29,1,0,0,0
"JOSETTE",0,26,0,1,26,0,1,0,1
"JOSIAH",28,0,1,0,28,1,0,1,0
"KRISTYN",0,14,0,1,14,0,1,0,1
"LUKASZ",32,0,1,0,32,1,0,1,0
"MARGE",0,35,0,1,35,0,1,0,1
"NAVEEN",28,1,.9655172,.0344828,29,1,0,1,0
"NEREIDA",0,28,0,1,28,0,1,0,1
"PALOMA",0,24,0,1,24,0,1,0,1
"REGINE",0,21,0,1,21,0,1,0,1
"REN",17,9,.6538461,.3461539,26,0,0,0,0
"REZA",31,1,.96875,.03125,32,1,0,1,0
"RONA",0,26,0,1,26,0,1,0,1
"SAMIA",0,29,0,1,29,0,1,0,1
"SHANELL",0,34,0,1,34,0,1,0,1
"SHARYN",0,30,0,1,30,0,1,0,1
"WILMA",0,35,0,1,35,0,1,0,1
"YUMI",0,23,0,1,23,0,1,0,1
"YUVAL",20,0,1,0,20,1,0,1,0
"ZAIDA",0,28,0,1,28,0,1,0,1
"ABDULLAH",26,0,1,0,26,1,0,1,0
"AGUSTÃçN",30,0,1,0,30,1,0,1,0
"ALINE",0,29,0,1,29,0,1,0,1
"ANAIS",0,28,0,1,28,0,1,0,1
"CEE",14,17,.4516129,.5483871,31,0,0,0,0
"CHE",18,9,.6666667,.3333333,27,0,0,0,0
"CHRISTI",0,23,0,1,23,0,1,0,1
"GRACIELA",0,28,0,1,28,0,1,0,1
"KIANA",0,30,0,1,30,0,1,0,1
"KRISTAL",0,28,0,1,28,0,1,0,1
"LILIA",1,22,.0434783,.9565217,23,0,1,0,1
"LÃ_",15,18,.4545455,.5454546,33,0,0,0,0
"MATEO",28,0,1,0,28,1,0,1,0
"ORIT",0,19,0,1,19,0,1,0,1
"PORTIA",0,29,0,1,29,0,1,0,1
"REINALDO",34,0,1,0,34,1,0,1,0
"RUSTY",27,3,.9,.1,30,1,0,0,0
"SIVAN",5,20,.2,.8,25,0,1,0,0
"VALENTIN",28,1,.9655172,.0344828,29,1,0,1,0
"VITA",1,24,.04,.96,25,0,1,0,1
"ZEV",22,0,1,0,22,1,0,1,0
"AKIL",33,1,.9705882,.0294118,34,1,0,1,0
"ASAD",26,0,1,0,26,1,0,1,0
"CHARITY",0,27,0,1,27,0,1,0,1
"CHARLEY",19,5,.7916667,.2083333,24,1,0,0,0
"CHRISTAL",0,23,0,1,23,0,1,0,1
"CHRISTIANE",0,24,0,1,24,0,1,0,1
"EDIE",1,20,.047619,.952381,21,0,1,0,1
"EVERETT",29,0,1,0,29,1,0,1,0
"FAHAD",18,0,1,0,18,1,0,1,0
"GREEN",15,10,.6,.4,25,0,0,0,0
"GRIFFIN",22,2,.9166667,.0833333,24,1,0,0,0
"IMAN",5,14,.2631579,.7368421,19,0,0,0,0
"KATINA",1,28,.0344828,.9655172,29,0,1,0,1
"KEV",26,0,1,0,26,1,0,1,0
"KHADIJAH",0,27,0,1,27,0,1,0,1
"KIERA",0,14,0,1,14,0,1,0,1
"KIRBY",21,4,.84,.16,25,1,0,0,0
"MACK",26,3,.8965517,.1034483,29,1,0,0,0
"MAKEDA",0,23,0,1,23,0,1,0,1
"MENACHEM",19,0,1,0,19,1,0,1,0
"RASHEED",31,0,1,0,31,1,0,1,0
"REGAN",12,9,.5714286,.4285714,21,0,0,0,0
"SCOTTY",23,0,1,0,23,1,0,1,0
"SHAMEEKA",0,27,0,1,27,0,1,0,1
"WENDI",0,22,0,1,22,0,1,0,1
"WILLIAMS",16,12,.5714286,.4285714,28,0,0,0,0
"ALIYA",0,19,0,1,19,0,1,0,1
"AMIN",26,0,1,0,26,1,0,1,0
"ANASTASIYA",0,22,0,1,22,0,1,0,1
"ANISSA",0,23,0,1,23,0,1,0,1
"ANNIKA",0,19,0,1,19,0,1,0,1
"ARJUN",23,0,1,0,23,1,0,1,0
"ARNAUD",29,0,1,0,29,1,0,1,0
"CAN",22,3,.88,.12,25,1,0,0,0
"CHRISTIANA",0,17,0,1,17,0,1,0,1
"CRISTAL",0,32,0,1,32,0,1,0,1
"DI",14,8,.6363636,.3636364,22,0,0,0,0
"DIRK",20,0,1,0,20,1,0,1,0
"ESTEE",0,12,0,1,12,0,1,0,1
"GERRI",0,23,0,1,23,0,1,0,1
"HENRI",24,1,.96,.04,25,1,0,1,0
"JACQUIE",0,26,0,1,26,0,1,0,1
"JANELL",0,15,0,1,15,0,1,0,1
"JEANMARIE",0,29,0,1,29,0,1,0,1
"JONES",15,9,.625,.375,24,0,0,0,0
"KINGSLEY",31,0,1,0,31,1,0,1,0
"MEENA",1,21,.0454545,.9545454,22,0,1,0,1
"NADYA",0,24,0,1,24,0,1,0,1
"NICHELLE",0,27,0,1,27,0,1,0,1
"PAWEL",29,0,1,0,29,1,0,1,0
"PERLA",0,30,0,1,30,0,1,0,1
"RHODA",0,31,0,1,31,0,1,0,1
"ROSALIA",0,31,0,1,31,0,1,0,1
"SALIM",23,1,.9583333,.0416667,24,1,0,1,0
"SARITA",1,20,.047619,.952381,21,0,1,0,1
"SEAMUS",29,0,1,0,29,1,0,1,0
"SEUNG",19,5,.7916667,.2083333,24,1,0,0,0
"SLAVA",28,1,.9655172,.0344828,29,1,0,1,0
"TIFFANIE",0,22,0,1,22,0,1,0,1
"TOMASZ",23,0,1,0,23,1,0,1,0
"VIKAS",28,0,1,0,28,1,0,1,0
"VINAY",27,1,.9642857,.0357143,28,1,0,1,0
"VIOLETA",0,29,0,1,29,0,1,0,1
"WALLACE",27,1,.9642857,.0357143,28,1,0,1,0
"WANG",23,7,.7666667,.2333333,30,1,0,0,0
"ZENA",0,23,0,1,23,0,1,0,1
"AKASH",26,0,1,0,26,1,0,1,0
"ALEKSEY",24,0,1,0,24,1,0,1,0
"AMRITA",0,19,0,1,19,0,1,0,1
"ANI",5,18,.2173913,.7826087,23,0,1,0,0
"ANNALISA",0,21,0,1,21,0,1,0,1
"ARYEH",21,0,1,0,21,1,0,1,0
"ASHANTI",4,28,.125,.875,32,0,1,0,0
"AUGUSTO",27,0,1,0,27,1,0,1,0
"CHANTELLE",0,27,0,1,27,0,1,0,1
"CHELSEY",0,25,0,1,25,0,1,0,1
"CORNELIA",0,25,0,1,25,0,1,0,1
"DANNI",3,18,.1428571,.8571429,21,0,1,0,0
"DANY",26,8,.7647059,.2352941,34,1,0,0,0
"DESHAWN",30,4,.8823529,.1176471,34,1,0,0,0
"DEV",23,0,1,0,23,1,0,1,0
"EDUARD",30,0,1,0,30,1,0,1,0
"ELEONORA",0,20,0,1,20,0,1,0,1
"ESPERANZA",0,33,0,1,33,0,1,0,1
"GENEVA",0,23,0,1,23,0,1,0,1
"JOI",1,19,.05,.95,20,0,1,0,0
"JULI",0,23,0,1,23,0,1,0,1
"KHALED",30,0,1,0,30,1,0,1,0
"KRYSTINA",0,22,0,1,22,0,1,0,1
"LEENA",0,19,0,1,19,0,1,0,1
"LIAT",0,22,0,1,22,0,1,0,1
"LUBA",1,21,.0454545,.9545454,22,0,1,0,1
"NIR",26,0,1,0,26,1,0,1,0
"OLA",6,12,.3333333,.6666667,18,0,0,0,0
"PATRICIO",24,0,1,0,24,1,0,1,0
"RESHMA",0,19,0,1,19,0,1,0,1
"SAHAR",2,21,.0869565,.9130435,23,0,1,0,0
"SHAMEKA",0,34,0,1,34,0,1,0,1
"SHU",11,10,.5238096,.4761905,21,0,0,0,0
"TOMOKO",0,23,0,1,23,0,1,0,1
"VALERY",11,15,.4230769,.5769231,26,0,0,0,0
"VIKKI",1,23,.0416667,.9583333,24,0,1,0,1
"VIKTORIA",0,24,0,1,24,0,1,0,1
"WALKER",17,5,.7727273,.2272727,22,1,0,0,0
"ANNAMARIE",0,31,0,1,31,0,1,0,1
"AZIZ",30,0,1,0,30,1,0,1,0
"BARRIE",3,9,.25,.75,12,0,0,0,0
"BING",21,8,.7241379,.2758621,29,0,0,0,0
"BRANDEN",29,0,1,0,29,1,0,1,0
"CARIDAD",0,31,0,1,31,0,1,0,1
"CINTHIA",0,20,0,1,20,0,1,0,1
"CORTNEY",1,12,.0769231,.9230769,13,0,1,0,0
"CRUZ",19,13,.59375,.40625,32,0,0,0,0
"ERI",5,13,.2777778,.7222222,18,0,0,0,0
"GISSELLE",0,21,0,1,21,0,1,0,1
"GOLDIE",4,18,.1818182,.8181818,22,0,1,0,0
"INDRA",7,26,.2121212,.7878788,33,0,1,0,0
"JACKI",2,20,.0909091,.9090909,22,0,1,0,0
"JANEEN",0,27,0,1,27,0,1,0,1
"JOSELYN",1,22,.0434783,.9565217,23,0,1,0,1
"KAMRAN",24,0,1,0,24,1,0,1,0
"KATRIN",0,17,0,1,17,0,1,0,1
"KENJI",27,1,.9642857,.0357143,28,1,0,1,0
"KENNEDY",17,7,.7083333,.2916667,24,0,0,0,0
"KHADIJA",0,27,0,1,27,0,1,0,1
"KIRILL",25,0,1,0,25,1,0,1,0
"LANI",1,21,.0454545,.9545454,22,0,1,0,1
"LEORA",0,16,0,1,16,0,1,0,1
"LYNNETTE",0,29,0,1,29,0,1,0,1
"MAGALY",0,26,0,1,26,0,1,0,1
"MICAELA",0,14,0,1,14,0,1,0,1
"NATALIYA",0,20,0,1,20,0,1,0,1
"ORI",24,1,.96,.04,25,1,0,1,0
"PRASHANT",30,0,1,0,30,1,0,1,0
"RAHEEM",33,0,1,0,33,1,0,1,0
"RAMESH",26,2,.9285714,.0714286,28,1,0,0,0
"REMI",21,8,.7241379,.2758621,29,0,0,0,0
"RICCARDO",29,0,1,0,29,1,0,1,0
"RIKKI",4,18,.1818182,.8181818,22,0,1,0,0
"ROMA",1,20,.047619,.952381,21,0,1,0,1
"SAGAR",22,0,1,0,22,1,0,1,0
"SAHIL",24,0,1,0,24,1,0,1,0
"SERGEI",26,0,1,0,26,1,0,1,0
"SHAYLA",0,24,0,1,24,0,1,0,1
"SHEREE",0,25,0,1,25,0,1,0,1
"SIMA",0,19,0,1,19,0,1,0,1
"SKYLER",22,5,.8148148,.1851852,27,1,0,0,0
"SUMIT",25,0,1,0,25,1,0,1,0
"YAIR",23,0,1,0,23,1,0,1,0
"YARON",26,0,1,0,26,1,0,1,0
"ADONIS",24,3,.8888889,.1111111,27,1,0,0,0
"AMIRA",0,23,0,1,23,0,1,0,1
"ANAT",1,18,.0526316,.9473684,19,0,1,0,0
"ANKIT",24,0,1,0,24,1,0,1,0
"ARIS",18,6,.75,.25,24,0,0,0,0
"BROOK",11,14,.44,.56,25,0,0,0,0
"BROOKS",17,1,.9444444,.0555556,18,1,0,0,0
"CARSON",16,3,.8421053,.1578947,19,1,0,0,0
"CHET",25,1,.9615384,.0384615,26,1,0,1,0
"DANNA",0,23,0,1,23,0,1,0,1
"DELROY",35,0,1,0,35,1,0,1,0
"FRANCK",28,3,.9032258,.0967742,31,1,0,0,0
"GARETH",30,0,1,0,30,1,0,1,0
"GEETA",0,23,0,1,23,0,1,0,1
"HAKIM",27,0,1,0,27,1,0,1,0
"JABARI",23,0,1,0,23,1,0,1,0
"JERI",0,16,0,1,16,0,1,0,1
"KASSANDRA",0,13,0,1,13,0,1,0,1
"KATARZYNA",0,27,0,1,27,0,1,0,1
"KERRIE",0,18,0,1,18,0,1,0,1
"KIMBERLEE",0,25,0,1,25,0,1,0,1
"KYM",1,22,.0434783,.9565217,23,0,1,0,1
"LAVERNE",0,33,0,1,33,0,1,0,1
"LISAMARIE",0,21,0,1,21,0,1,0,1
"MARYLOU",0,27,0,1,27,0,1,0,1
"MONTE",26,1,.962963,.037037,27,1,0,1,0
"NADEGE",0,23,0,1,23,0,1,0,1
"OTIS",29,0,1,0,29,1,0,1,0
"PIETRO",29,0,1,0,29,1,0,1,0
"RAISA",0,25,0,1,25,0,1,0,1
"RAMY",25,1,.9615384,.0384615,26,1,0,1,0
"RANI",3,20,.1304348,.8695652,23,0,1,0,0
"RONDA",0,25,0,1,25,0,1,0,1
"RONEN",23,0,1,0,23,1,0,1,0
"ROSY",0,27,0,1,27,0,1,0,1
"SALINA",0,19,0,1,19,0,1,0,1
"SARIT",0,14,0,1,14,0,1,0,1
"SERDAR",20,0,1,0,20,1,0,1,0
"SHAH",30,2,.9375,.0625,32,1,0,0,0
"SHAYNE",15,8,.6521739,.3478261,23,0,0,0,0
"SIMEON",27,0,1,0,27,1,0,1,0
"SINEAD",0,19,0,1,19,0,1,0,1
"TANIKA",0,29,0,1,29,0,1,0,1
"TANJA",0,26,0,1,26,0,1,0,1
"TAREK",21,0,1,0,21,1,0,1,0
"THEODORA",0,22,0,1,22,0,1,0,1
"TYRA",0,24,0,1,24,0,1,0,1
"VERONIQUE",0,28,0,1,28,0,1,0,1
"WOODY",27,0,1,0,27,1,0,1,0
"ALEKSANDAR",21,0,1,0,21,1,0,1,0
"ALEN",27,0,1,0,27,1,0,1,0
"ALONZO",27,0,1,0,27,1,0,1,0
"AMOS",24,1,.96,.04,25,1,0,1,0
"ANDIE",3,18,.1428571,.8571429,21,0,1,0,0
"ARCHIE",32,0,1,0,32,1,0,1,0
"BENITA",0,24,0,1,24,0,1,0,1
"BUTCH",24,0,1,0,24,1,0,1,0
"CHASTITY",1,19,.05,.95,20,0,1,0,0
"CHIRAG",26,0,1,0,26,1,0,1,0
"DANICA",0,14,0,1,14,0,1,0,1
"DARIEN",19,2,.9047619,.0952381,21,1,0,0,0
"EMELY",0,23,0,1,23,0,1,0,1
"GARFIELD",31,0,1,0,31,1,0,1,0
"GERMAINE",7,24,.2258064,.7741935,31,0,1,0,0
"GIACOMO",24,0,1,0,24,1,0,1,0
"GIORGIO",23,0,1,0,23,1,0,1,0
"KATTY",0,30,0,1,30,0,1,0,1
"KEESHA",0,28,0,1,28,0,1,0,1
"KWESI",25,1,.9615384,.0384615,26,1,0,1,0
"LEEANN",0,17,0,1,17,0,1,0,1
"LYNDON",24,2,.9230769,.0769231,26,1,0,0,0
"MATILDA",0,25,0,1,25,0,1,0,1
"MAXIME",20,0,1,0,20,1,0,1,0
"MILO",23,1,.9583333,.0416667,24,1,0,1,0
"NANCI",0,24,0,1,24,0,1,0,1
"NEEL",17,0,1,0,17,1,0,1,0
"OCTAVIO",24,0,1,0,24,1,0,1,0
"PHOENIX",11,11,.5,.5,22,0,0,0,0
"PRISCILA",0,27,0,1,27,0,1,0,1
"RANIA",0,20,0,1,20,0,1,0,1
"SAMMIE",11,11,.5,.5,22,0,0,0,0
"SHALOM",20,1,.952381,.047619,21,1,0,1,0
"SHIMON",25,1,.9615384,.0384615,26,1,0,1,0
"SHIRIN",0,20,0,1,20,0,1,0,1
"SONAM",12,13,.48,.52,25,0,0,0,0
"TAMER",22,2,.9166667,.0833333,24,1,0,0,0
"VALENCIA",0,21,0,1,21,0,1,0,1
"ZEE",10,4,.7142857,.2857143,14,0,0,0,0
"ADELINE",0,21,0,1,21,0,1,0,1
"ADIL",24,0,1,0,24,1,0,1,0
"AI",2,22,.0833333,.9166667,24,0,1,0,0
"AMR",29,0,1,0,29,1,0,1,0
"ANUJ",26,0,1,0,26,1,0,1,0
"ARELIS",0,24,0,1,24,0,1,0,1
"ARIELA",0,12,0,1,12,0,1,0,1
"AVINASH",24,0,1,0,24,1,0,1,0
"CHANG",19,3,.8636364,.1363636,22,1,0,0,0
"CHRISTEN",1,19,.05,.95,20,0,1,0,0
"DANETTE",0,23,0,1,23,0,1,0,1
"DAYANA",0,21,0,1,21,0,1,0,1
"DIMITRIOS",23,0,1,0,23,1,0,1,0
"DINAH",0,24,0,1,24,0,1,0,1
"ELISHEVA",0,15,0,1,15,0,1,0,1
"ELY",10,9,.5263158,.4736842,19,0,0,0,0
"ESTI",0,16,0,1,16,0,1,0,1
"FILIPPO",25,0,1,0,25,1,0,1,0
"HEIDY",0,24,0,1,24,0,1,0,1
"HIROKO",0,18,0,1,18,0,1,0,1
"IRFAN",19,0,1,0,19,1,0,1,0
"KAREEN",2,21,.0869565,.9130435,23,0,1,0,0
"LATONYA",0,30,0,1,30,0,1,0,1
"LEANNA",0,20,0,1,20,0,1,0,1
"LISBETH",1,25,.0384615,.9615384,26,0,1,0,1
"LORIE",0,22,0,1,22,0,1,0,1
"MAKI",3,19,.1363636,.8636364,22,0,1,0,0
"MANDI",1,19,.05,.95,20,0,1,0,0
"MARCELLE",0,18,0,1,18,0,1,0,1
"MARVA",0,28,0,1,28,0,1,0,1
"NENA",0,23,0,1,23,0,1,0,1
"NIKA",2,19,.0952381,.9047619,21,0,1,0,0
"OMAYRA",0,24,0,1,24,0,1,0,1
"PAYAL",0,15,0,1,15,0,1,0,1
"PHILIPP",20,0,1,0,20,1,0,1,0
"RIVKA",0,19,0,1,19,0,1,0,1
"SABA",5,10,.3333333,.6666667,15,0,0,0,0
"SAI",12,14,.4615385,.5384616,26,0,0,0,0
"SCOT",24,0,1,0,24,1,0,1,0
"SHANELLE",0,26,0,1,26,0,1,0,1
"SHANTA",0,28,0,1,28,0,1,0,1
"SHANTI",2,19,.0952381,.9047619,21,0,1,0,0
"SHERIF",18,1,.9473684,.0526316,19,1,0,0,0
"SKIP",23,0,1,0,23,1,0,1,0
"SO",10,17,.3703704,.6296296,27,0,0,0,0
"SYLVESTER",28,1,.9655172,.0344828,29,1,0,1,0
"TZVI",14,0,1,0,14,1,0,1,0
"VITALIY",23,0,1,0,23,1,0,1,0
"YOEL",25,0,1,0,25,1,0,1,0
"YURY",20,3,.8695652,.1304348,23,1,0,0,0
"ZEYNEP",0,21,0,1,21,0,1,0,1
"ABI",8,14,.3636364,.6363636,22,0,0,0,0
"ABIE",19,2,.9047619,.0952381,21,1,0,0,0
"ADELA",1,18,.0526316,.9473684,19,0,1,0,0
"ALTON",25,0,1,0,25,1,0,1,0
"ANIBAL",29,0,1,0,29,1,0,1,0
"ANISHA",0,19,0,1,19,0,1,0,1
"ASAF",17,0,1,0,17,1,0,1,0
"BELLE",0,21,0,1,21,0,1,0,1
"BENJI",18,0,1,0,18,1,0,1,0
"BEVERLEY",0,27,0,1,27,0,1,0,1
"BRENNAN",20,2,.9090909,.0909091,22,1,0,0,0
"BROCK",24,1,.96,.04,25,1,0,1,0
"CECE",0,22,0,1,22,0,1,0,1
"CHAO",20,7,.7407407,.2592593,27,0,0,0,0
"CHRISTOPH",28,0,1,0,28,1,0,1,0
"CHRYSTAL",0,21,0,1,21,0,1,0,1
"CHUN",16,5,.7619048,.2380952,21,1,0,0,0
"DAREN",21,0,1,0,21,1,0,1,0
"DOV",19,0,1,0,19,1,0,1,0
"ENZO",26,0,1,0,26,1,0,1,0
"FRANCISCA",0,21,0,1,21,0,1,0,1
"IRVIN",22,0,1,0,22,1,0,1,0
"JAHAIRA",0,24,0,1,24,0,1,0,1
"JOSEF",19,0,1,0,19,1,0,1,0
"KA",13,11,.5416667,.4583333,24,0,0,0,0
"KAM",14,5,.7368421,.2631579,19,0,0,0,0
"KARLENE",0,21,0,1,21,0,1,0,1
"LENORA",0,21,0,1,21,0,1,0,1
"LEONOR",0,24,0,1,24,0,1,0,1
"MAHESH",26,0,1,0,26,1,0,1,0
"MAMADOU",32,0,1,0,32,1,0,1,0
"MANU",17,3,.85,.15,20,1,0,0,0
"MARIETTA",0,31,0,1,31,0,1,0,1
"MARIJA",0,17,0,1,17,0,1,0,1
"MIKAEL",22,1,.9565217,.0434783,23,1,0,1,0
"MOHIT",27,0,1,0,27,1,0,1,0
"NAOKO",0,19,0,1,19,0,1,0,1
"NECHAMA",0,17,0,1,17,0,1,0,1
"OZZIE",22,0,1,0,22,1,0,1,0
"PERCY",22,1,.9565217,.0434783,23,1,0,1,0
"RICKI",3,21,.125,.875,24,0,1,0,0
"ROCK",16,9,.64,.36,25,0,0,0,0
"SERKAN",28,0,1,0,28,1,0,1,0
"SHEETAL",0,20,0,1,20,0,1,0,1
"SHIN",17,9,.6538461,.3461539,26,0,0,0,0
"SINDY",0,19,0,1,19,0,1,0,1
"SUZANNA",0,18,0,1,18,0,1,0,1
"SVEN",23,0,1,0,23,1,0,1,0
"VALENTINE",15,9,.625,.375,24,0,0,0,0
"VIKTORIYA",0,17,0,1,17,0,1,0,1
"VIOLA",0,25,0,1,25,0,1,0,1
"YEVGENIY",21,0,1,0,21,1,0,1,0
"YIN",4,17,.1904762,.8095238,21,0,1,0,0
"ADDIE",1,16,.0588235,.9411765,17,0,1,0,0
"AKSHAY",21,0,1,0,21,1,0,1,0
"ALE",11,11,.5,.5,22,0,0,0,0
"ASHRAF",23,2,.92,.08,25,1,0,0,0
"BERTHA",0,26,0,1,26,0,1,0,1
"CHEF",18,10,.6428571,.3571429,28,0,0,0,0
"DMITRI",15,0,1,0,15,1,0,1,0
"EDOUARD",26,0,1,0,26,1,0,1,0
"ELINOR",0,19,0,1,19,0,1,0,1
"ELTON",20,0,1,0,20,1,0,1,0
"EVANS",27,2,.9310345,.0689655,29,1,0,0,0
"FORREST",19,0,1,0,19,1,0,1,0
"FREDRICK",30,0,1,0,30,1,0,1,0
"FREDY",24,0,1,0,24,1,0,1,0
"GILDA",0,22,0,1,22,0,1,0,1
"HAO",21,2,.9130435,.0869565,23,1,0,0,0
"IZABELA",0,17,0,1,17,0,1,0,1
"JANAE",0,21,0,1,21,0,1,0,1
"JANNETTE",0,23,0,1,23,0,1,0,1
"JUDAH",14,4,.7777778,.2222222,18,1,0,0,0
"KERRY-ANN",0,26,0,1,26,0,1,0,1
"KEVON",22,1,.9565217,.0434783,23,1,0,1,0
"LEONEL",26,0,1,0,26,1,0,1,0
"LEONID",23,0,1,0,23,1,0,1,0
"LIMOR",0,18,0,1,18,0,1,0,1
"MAGNUS",23,2,.92,.08,25,1,0,0,0
"MARINÃ‰",1,19,.05,.95,20,0,1,0,0
"MARLEY",15,11,.5769231,.4230769,26,0,0,0,0
"MATTHIEU",17,0,1,0,17,1,0,1,0
"MERT",22,0,1,0,22,1,0,1,0
"NORBERT",22,0,1,0,22,1,0,1,0
"RADHIKA",1,21,.0454545,.9545454,22,0,1,0,1
"RIVKY",0,19,0,1,19,0,1,0,1
"SAAD",16,0,1,0,16,1,0,1,0
"SONALI",0,16,0,1,16,0,1,0,1
"SPIRO",25,0,1,0,25,1,0,1,0
"SWATI",0,20,0,1,20,0,1,0,1
"TYESHA",0,24,0,1,24,0,1,0,1
"UMAR",20,0,1,0,20,1,0,1,0
"VERNA",0,22,0,1,22,0,1,0,1
"VINCENZA",0,27,0,1,27,0,1,0,1
"VITALY",20,0,1,0,20,1,0,1,0
"YOAV",12,1,.9230769,.0769231,13,1,0,0,0
"YUKA",0,20,0,1,20,0,1,0,1
"ZHANNA",0,19,0,1,19,0,1,0,1
"AKILAH",0,21,0,1,21,0,1,0,1
"AKIRA",18,8,.6923077,.3076923,26,0,0,0,0
"ANDERS",20,0,1,0,20,1,0,1,0
"ANNABEL",0,12,0,1,12,0,1,0,1
"ASHWIN",17,0,1,0,17,1,0,1,0
"BARBRA",0,23,0,1,23,0,1,0,1
"BENSON",21,0,1,0,21,1,0,1,0
"BRI",1,12,.0769231,.9230769,13,0,1,0,0
"BRIE",0,11,0,1,11,0,1,0,1
"CASANDRA",0,13,0,1,13,0,1,0,1
"CORNELIUS",22,1,.9565217,.0434783,23,1,0,1,0
"CRISTIN",1,15,.0625,.9375,16,0,1,0,0
"DELANO",23,0,1,0,23,1,0,1,0
"DESI",11,12,.4782609,.5217391,23,0,0,0,0
"ERVIN",27,0,1,0,27,1,0,1,0
"FARHANA",1,16,.0588235,.9411765,17,0,1,0,0
"GUIDO",22,0,1,0,22,1,0,1,0
"GÃ–KHAN",18,0,1,0,18,1,0,1,0
"HARPREET",17,8,.68,.32,25,0,0,0,0
"KATHARINA",0,20,0,1,20,0,1,0,1
"KEENAN",23,0,1,0,23,1,0,1,0
"KOSTAS",19,0,1,0,19,1,0,1,0
"LIZZETTE",0,25,0,1,25,0,1,0,1
"LONG",17,2,.8947368,.1052632,19,1,0,0,0
"MANDEEP",18,5,.7826087,.2173913,23,1,0,0,0
"MÃÅ",6,19,.24,.76,25,0,1,0,0
"NIKOLAI",14,0,1,0,14,1,0,1,0
"NITA",0,20,0,1,20,0,1,0,1
"PING",8,17,.32,.68,25,0,0,0,0
"QI",15,9,.625,.375,24,0,0,0,0
"RAN",14,5,.7368421,.2631579,19,0,0,0,0
"RASHAWN",25,2,.9259259,.0740741,27,1,0,0,0
"ROGELIO",23,0,1,0,23,1,0,1,0
"ROYCE",18,7,.72,.28,25,0,0,0,0
"SAFIYA",0,19,0,1,19,0,1,0,1
"SAIF",16,0,1,0,16,1,0,1,0
"SALMA",1,26,.037037,.962963,27,0,1,0,1
"SHANEQUA",0,21,0,1,21,0,1,0,1
"SHLOMI",22,0,1,0,22,1,0,1,0
"SHRUTI",0,22,0,1,22,0,1,0,1
"VICENTE",22,0,1,0,22,1,0,1,0
"VIVIENNE",0,20,0,1,20,0,1,0,1
"ZULMA",0,22,0,1,22,0,1,0,1
"ABBAS",15,0,1,0,15,1,0,1,0
"ABENA",0,24,0,1,24,0,1,0,1
"ADITI",1,15,.0625,.9375,16,0,1,0,0
"ALIDA",0,21,0,1,21,0,1,0,1
"ANT",16,0,1,0,16,1,0,1,0
"ARACELIS",0,20,0,1,20,0,1,0,1
"ARMAND",24,0,1,0,24,1,0,1,0
"ASMA",0,18,0,1,18,0,1,0,1
"AUGUST",16,1,.9411765,.0588235,17,1,0,0,0
"BLAINE",18,5,.7826087,.2173913,23,1,0,0,0
"CARIN",0,18,0,1,18,0,1,0,1
"CINDI",0,22,0,1,22,0,1,0,1
"CORINNA",0,18,0,1,18,0,1,0,1
"CORRIE",3,14,.1764706,.8235294,17,0,1,0,0
"DEANNE",0,23,0,1,23,0,1,0,1
"DIANDRA",0,17,0,1,17,0,1,0,1
"DOC",23,3,.8846154,.1153846,26,1,0,0,0
"DOMENIC",27,0,1,0,27,1,0,1,0
"DONA",2,19,.0952381,.9047619,21,0,1,0,0
"DOVID",19,0,1,0,19,1,0,1,0
"EMILE",21,0,1,0,21,1,0,1,0
"EMMETT",18,0,1,0,18,1,0,1,0
"EVERTON",29,0,1,0,29,1,0,1,0
"EVETTE",0,22,0,1,22,0,1,0,1
"FABIENNE",0,15,0,1,15,0,1,0,1
"FEMI",12,6,.6666667,.3333333,18,0,0,0,0
"FILIP",18,0,1,0,18,1,0,1,0
"FREDA",0,19,0,1,19,0,1,0,1
"GENNA",0,15,0,1,15,0,1,0,1
"GIAN",19,1,.95,.05,20,1,0,0,0
"HARI",21,1,.9545454,.0454545,22,1,0,1,0
"HARLAN",15,0,1,0,15,1,0,1,0
"JAZZY",10,12,.4545455,.5454546,22,0,0,0,0
"KACEY",1,17,.0555556,.9444444,18,0,1,0,0
"KAMILA",0,20,0,1,20,0,1,0,1
"KATJA",0,18,0,1,18,0,1,0,1
"KEI",12,4,.75,.25,16,0,0,0,0
"KIRSTIN",0,16,0,1,16,0,1,0,1
"KSENIA",0,16,0,1,16,0,1,0,1
"LATANYA",0,24,0,1,24,0,1,0,1
"LENNOX",26,0,1,0,26,1,0,1,0
"LINETTE",0,22,0,1,22,0,1,0,1
"LISANDRA",0,25,0,1,25,0,1,0,1
"LUC",12,2,.8571429,.1428571,14,1,0,0,0
"MANOJ",22,0,1,0,22,1,0,1,0
"MAVIS",0,23,0,1,23,0,1,0,1
"MEERA",0,23,0,1,23,0,1,0,1
"MUSA",23,3,.8846154,.1153846,26,1,0,0,0
"MYA",0,20,0,1,20,0,1,0,1
"MYRON",22,0,1,0,22,1,0,1,0
"NADJA",0,13,0,1,13,0,1,0,1
"NIKOS",17,0,1,0,17,1,0,1,0
"PATSY",4,21,.16,.84,25,0,1,0,0
"PRETTY",5,18,.2173913,.7826087,23,0,1,0,0
"RAJEEV",22,0,1,0,22,1,0,1,0
"RHIANNON",0,14,0,1,14,0,1,0,1
"RITU",0,15,0,1,15,0,1,0,1
"ROE",2,17,.1052632,.8947368,19,0,1,0,0
"ROSSANA",0,21,0,1,21,0,1,0,1
"ROXANNA",0,23,0,1,23,0,1,0,1
"SANTO",23,0,1,0,23,1,0,1,0
"SARAI",0,20,0,1,20,0,1,0,1
"SELENE",0,18,0,1,18,0,1,0,1
"SUKI",1,20,.047619,.952381,21,0,1,0,1
"SUZANA",0,26,0,1,26,0,1,0,1
"TASHI",14,10,.5833333,.4166667,24,0,0,0,0
"WALESKA",0,21,0,1,21,0,1,0,1
"YARITZA",0,14,0,1,14,0,1,0,1
"YUKIKO",0,21,0,1,21,0,1,0,1
"ALEKS",17,3,.85,.15,20,1,0,0,0
"AMAL",6,13,.3157895,.6842105,19,0,0,0,0
"ANGUS",16,0,1,0,16,1,0,1,0
"ANISA",0,18,0,1,18,0,1,0,1
"ANWAR",21,0,1,0,21,1,0,1,0
"BELKIS",0,27,0,1,27,0,1,0,1
"BESS",0,12,0,1,12,0,1,0,1
"CHANCE",24,5,.8275862,.1724138,29,1,0,0,0
"CHENG",18,5,.7826087,.2173913,23,1,0,0,0
"CHRISTIN",1,13,.0714286,.9285714,14,0,1,0,0
"DARIAN",11,4,.7333333,.2666667,15,0,0,0,0
"DEMETRIOS",13,0,1,0,13,1,0,1,0
"DINESH",29,0,1,0,29,1,0,1,0
"EBONI",0,18,0,1,18,0,1,0,1
"ENZA",0,19,0,1,19,0,1,0,1
"FLO",5,16,.2380952,.7619048,21,0,1,0,0
"GAETANO",26,0,1,0,26,1,0,1,0
"GAUTAM",21,0,1,0,21,1,0,1,0
"GUADALUPE",5,13,.2777778,.7222222,18,0,0,0,0
"HABIB",19,0,1,0,19,1,0,1,0
"HAKEEM",29,0,1,0,29,1,0,1,0
"HOLLIS",6,7,.4615385,.5384616,13,0,0,0,0
"JENINE",0,13,0,1,13,0,1,0,1
"JESSIKA",0,17,0,1,17,0,1,0,1
"JOHANNY",3,21,.125,.875,24,0,1,0,0
"KENAN",24,0,1,0,24,1,0,1,0
"LEIGHTON",19,4,.8260869,.173913,23,1,0,0,0
"LEVAR",24,0,1,0,24,1,0,1,0
"LIANE",0,19,0,1,19,0,1,0,1
"LYNDSAY",0,12,0,1,12,0,1,0,1
"MADHU",9,7,.5625,.4375,16,0,0,0,0
"MAHA",1,14,.0666667,.9333333,15,0,1,0,0
"MALA",2,19,.0952381,.9047619,21,0,1,0,0
"MALKA",0,13,0,1,13,0,1,0,1
"MARGAUX",0,15,0,1,15,0,1,0,1
"MARINO",23,1,.9583333,.0416667,24,1,0,1,0
"MARLO",4,15,.2105263,.7894737,19,0,1,0,0
"MECCA",4,19,.173913,.8260869,23,0,1,0,0
"MONTY",16,0,1,0,16,1,0,1,0
"MUHAMMED",22,0,1,0,22,1,0,1,0
"NADIRA",0,23,0,1,23,0,1,0,1
"NIALL",18,0,1,0,18,1,0,1,0
"PATTIE",0,23,0,1,23,0,1,0,1
"PINKY",4,18,.1818182,.8181818,22,0,1,0,0
"PUJA",0,13,0,1,13,0,1,0,1
"RICKEY",18,0,1,0,18,1,0,1,0
"RO",10,11,.4761905,.5238096,21,0,0,0,0
"SANDRINE",1,16,.0588235,.9411765,17,0,1,0,0
"SASKIA",0,17,0,1,17,0,1,0,1
"SHEREEN",1,18,.0526316,.9473684,19,0,1,0,0
"SINCERE",24,3,.8888889,.1111111,27,1,0,0,0
"SONG",11,6,.6470588,.3529412,17,0,0,0,0
"TUCKER",17,0,1,0,17,1,0,1,0
"URBAN",9,9,.5,.5,18,0,0,0,0
"VANCE",28,0,1,0,28,1,0,1,0
"VON",18,6,.75,.25,24,0,0,0,0
"WALT",19,0,1,0,19,1,0,1,0
"WARD",15,2,.8823529,.1176471,17,1,0,0,0
"WELLINGTON",28,1,.9655172,.0344828,29,1,0,1,0
"WU",20,4,.8333333,.1666667,24,1,0,0,0
"XENIA",0,24,0,1,24,0,1,0,1
"YENNY",0,22,0,1,22,0,1,0,1
"YOON",4,12,.25,.75,16,0,0,0,0
"ARNIE",26,1,.962963,.037037,27,1,0,1,0
"ATUL",23,0,1,0,23,1,0,1,0
"AYSHA",0,16,0,1,16,0,1,0,1
"BARIS",21,0,1,0,21,1,0,1,0
"BARRETT",19,3,.8636364,.1363636,22,1,0,0,0
"BOGDAN",17,0,1,0,17,1,0,1,0
"BRYN",4,6,.4,.6,10,0,0,0,0
"BURT",28,0,1,0,28,1,0,1,0
"CASSIDY",4,13,.2352941,.7647059,17,0,1,0,0
"CHINA",1,23,.0416667,.9583333,24,0,1,0,1
"DEMI",0,15,0,1,15,0,1,0,1
"DENICE",1,25,.0384615,.9615384,26,0,1,0,1
"DENZEL",24,1,.96,.04,25,1,0,1,0
"EMMANUELLE",2,16,.1111111,.8888889,18,0,1,0,0
"FABRICE",15,0,1,0,15,1,0,1,0
"FENG",14,7,.6666667,.3333333,21,0,0,0,0
"FRANKY",25,0,1,0,25,1,0,1,0
"GABRIELE",11,8,.5789474,.4210526,19,0,0,0,0
"GIANLUCA",18,0,1,0,18,1,0,1,0
"GILA",0,14,0,1,14,0,1,0,1
"HUSSEIN",21,0,1,0,21,1,0,1,0
"IESHA",0,22,0,1,22,0,1,0,1
"INESSA",0,18,0,1,18,0,1,0,1
"ISHMAEL",24,1,.96,.04,25,1,0,1,0
"JAZZ",11,7,.6111111,.3888889,18,0,0,0,0
"JIMMIE",17,1,.9444444,.0555556,18,1,0,0,0
"JINA",0,19,0,1,19,0,1,0,1
"KATHI",0,21,0,1,21,0,1,0,1
"KAYE",0,21,0,1,21,0,1,0,1
"KYOKO",0,16,0,1,16,0,1,0,1
"LANDON",16,1,.9411765,.0588235,17,1,0,0,0
"LAURE",0,16,0,1,16,0,1,0,1
"LEONORA",0,20,0,1,20,0,1,0,1
"LETTY",0,23,0,1,23,0,1,0,1
"LIZZ",0,16,0,1,16,0,1,0,1
"LONDON",11,9,.55,.45,20,0,0,0,0
"LORAINE",0,19,0,1,19,0,1,0,1
"MARIKA",0,14,0,1,14,0,1,0,1
"MARLYN",0,20,0,1,20,0,1,0,1
"MERRILL",8,11,.4210526,.5789474,19,0,0,0,0
"NADER",17,0,1,0,17,1,0,1,0
"NASIR",20,0,1,0,20,1,0,1,0
"NATAN",15,0,1,0,15,1,0,1,0
"NICOLLE",0,17,0,1,17,0,1,0,1
"NIDHI",0,19,0,1,19,0,1,0,1
"NIDIA",0,23,0,1,23,0,1,0,1
"ODETTE",0,22,0,1,22,0,1,0,1
"PAPA",22,2,.9166667,.0833333,24,1,0,0,0
"RAMEL",24,0,1,0,24,1,0,1,0
"RIMA",0,18,0,1,18,0,1,0,1
"SANFORD",23,1,.9583333,.0416667,24,1,0,1,0
"SHAMEL",25,2,.9259259,.0740741,27,1,0,0,0
"SHAVONNE",0,24,0,1,24,0,1,0,1
"STANISLAV",19,1,.95,.05,20,1,0,0,0
"SUNSHINE",3,19,.1363636,.8636364,22,0,1,0,0
"SYEDA",0,14,0,1,14,0,1,0,1
"TAWANNA",0,22,0,1,22,0,1,0,1
"ULISES",24,0,1,0,24,1,0,1,0
"VALARIE",0,20,0,1,20,0,1,0,1
"WYATT",17,0,1,0,17,1,0,1,0
"YASEMIN",0,10,0,1,10,0,1,0,1
"ZANE",17,4,.8095238,.1904762,21,1,0,0,0
"ZOILA",0,22,0,1,22,0,1,0,1
"ÃÅSA",13,8,.6190476,.3809524,21,0,0,0,0
"ABU",23,1,.9583333,.0416667,24,1,0,1,0
"ADELINA",0,21,0,1,21,0,1,0,1
"ALESSIA",0,11,0,1,11,0,1,0,1
"ALPER",13,0,1,0,13,1,0,1,0
"AMINE",22,0,1,0,22,1,0,1,0
"ANETA",0,16,0,1,16,0,1,0,1
"ARMAN",23,0,1,0,23,1,0,1,0
"AYAKO",0,16,0,1,16,0,1,0,1
"AYMAN",17,0,1,0,17,1,0,1,0
"BARON",20,1,.952381,.047619,21,1,0,1,0
"BLAISE",18,0,1,0,18,1,0,1,0
"BONITA",0,21,0,1,21,0,1,0,1
"CAIT",0,11,0,1,11,0,1,0,1
"CATRINA",0,17,0,1,17,0,1,0,1
"CHANTE",0,19,0,1,19,0,1,0,1
"COLLETTE",0,13,0,1,13,0,1,0,1
"DEVI",0,18,0,1,18,0,1,0,1
"DEVIKA",0,17,0,1,17,0,1,0,1
"DOROTHEA",0,21,0,1,21,0,1,0,1
"EREZ",17,1,.9444444,.0555556,18,1,0,0,0
"ESTEFANIA",0,18,0,1,18,0,1,0,1
"EWELINA",0,19,0,1,19,0,1,0,1
"FARA",3,14,.1764706,.8235294,17,0,1,0,0
"GALIT",0,17,0,1,17,0,1,0,1
"GANESH",25,0,1,0,25,1,0,1,0
"GENNARO",15,0,1,0,15,1,0,1,0
"GISELE",0,26,0,1,26,0,1,0,1
"HAMILTON",17,1,.9444444,.0555556,18,1,0,0,0
"IWONA",0,15,0,1,15,0,1,0,1
"JAKUB",14,0,1,0,14,1,0,1,0
"JIMI",14,1,.9333333,.0666667,15,1,0,0,0
"JUSTICE",21,4,.84,.16,25,1,0,0,0
"KERON",19,3,.8636364,.1363636,22,1,0,0,0
"LAUREEN",0,17,0,1,17,0,1,0,1
"MERI",0,19,0,1,19,0,1,0,1
"MIKAELA",0,12,0,1,12,0,1,0,1
"MORDECHAI",17,0,1,0,17,1,0,1,0
"MY",9,8,.5294118,.4705882,17,0,0,0,0
"NATHALY",0,24,0,1,24,0,1,0,1
"NNEKA",0,20,0,1,20,0,1,0,1
"OFER",19,1,.95,.05,20,1,0,0,0
"ORVILLE",24,0,1,0,24,1,0,1,0
"RAYNA",0,19,0,1,19,0,1,0,1
"ROSALBA",0,22,0,1,22,0,1,0,1
"ROSITA",0,18,0,1,18,0,1,0,1
"RUCHI",0,12,0,1,12,0,1,0,1
"SHILPA",0,14,0,1,14,0,1,0,1
"SIMRAN",1,18,.0526316,.9473684,19,0,1,0,0
"SUZI",0,13,0,1,13,0,1,0,1
"TABATHA",0,21,0,1,21,0,1,0,1
"TAJ",9,3,.75,.25,12,0,0,0,0
"TAMMI",0,22,0,1,22,0,1,0,1
"THIAGO",21,0,1,0,21,1,0,1,0
"TOBI",10,11,.4761905,.5238096,21,0,0,0,0
"VEE",8,17,.32,.68,25,0,0,0,0
"VOLKAN",17,0,1,0,17,1,0,1,0
"YAZMIN",0,24,0,1,24,0,1,0,1
"YEN",3,14,.1764706,.8235294,17,0,1,0,0
"ZAIN",17,1,.9444444,.0555556,18,1,0,0,0
"AALIYAH",0,22,0,1,22,0,1,0,1
"ADRIANO",22,0,1,0,22,1,0,1,0
"AGATHA",0,11,0,1,11,0,1,0,1
"ALYSHA",0,17,0,1,17,0,1,0,1
"ANDRIA",0,15,0,1,15,0,1,0,1
"ARNALDO",21,0,1,0,21,1,0,1,0
"AVRAHAM",23,0,1,0,23,1,0,1,0
"BIN",16,1,.9411765,.0588235,17,1,0,0,0
"CATIE",0,17,0,1,17,0,1,0,1
"CRISTY",1,14,.0666667,.9333333,15,0,1,0,0
"DECLAN",18,0,1,0,18,1,0,1,0
"DEEP",15,3,.8333333,.1666667,18,1,0,0,0
"DORON",14,0,1,0,14,1,0,1,0
"ELKE",0,17,0,1,17,0,1,0,1
"ELMER",20,0,1,0,20,1,0,1,0
"ELODIE",0,13,0,1,13,0,1,0,1
"EM",5,11,.3125,.6875,16,0,0,0,0
"EMAD",16,0,1,0,16,1,0,1,0
"EMERSON",24,0,1,0,24,1,0,1,0
"EMIR",22,0,1,0,22,1,0,1,0
"GIULIO",21,0,1,0,21,1,0,1,0
"GODFREY",23,0,1,0,23,1,0,1,0
"HADLEY",0,13,0,1,13,0,1,0,1
"HAMZA",19,0,1,0,19,1,0,1,0
"HILA",0,11,0,1,11,0,1,0,1
"ISHA",0,17,0,1,17,0,1,0,1
"ISIAH",23,0,1,0,23,1,0,1,0
"JAIMEE",0,12,0,1,12,0,1,0,1
"JASMINA",0,21,0,1,21,0,1,0,1
"JUDD",14,0,1,0,14,1,0,1,0
"KARTHIK",20,0,1,0,20,1,0,1,0
"KAYA",3,10,.2307692,.7692308,13,0,1,0,0
"KOREY",18,3,.8571429,.1428571,21,1,0,0,0
"KWASI",22,0,1,0,22,1,0,1,0
"LIANNE",0,14,0,1,14,0,1,0,1
"LIU",12,10,.5454546,.4545455,22,0,0,0,0
"LIV",0,16,0,1,16,0,1,0,1
"LUIZ",21,0,1,0,21,1,0,1,0
"MALAIKA",0,20,0,1,20,0,1,0,1
"MARIN",8,12,.4,.6,20,0,0,0,0
"MARTI",2,11,.1538462,.8461539,13,0,1,0,0
"MATÃçAS",16,0,1,0,16,1,0,1,0
"MI",4,13,.2352941,.7647059,17,0,1,0,0
"MOHAMAD",17,0,1,0,17,1,0,1,0
"NIDA",0,17,0,1,17,0,1,0,1
"PEPE",21,1,.9545454,.0454545,22,1,0,1,0
"PEYTON",11,10,.5238096,.4761905,21,0,0,0,0
"RAFAELA",0,26,0,1,26,0,1,0,1
"REESE",11,8,.5789474,.4210526,19,0,0,0,0
"RENZO",23,0,1,0,23,1,0,1,0
"RUSLAN",21,0,1,0,21,1,0,1,0
"SANTA",3,20,.1304348,.8695652,23,0,1,0,0
"SELIN",0,19,0,1,19,0,1,0,1
"SHANIKA",0,20,0,1,20,0,1,0,1
"VIDA",1,11,.0833333,.9166667,12,0,1,0,0
"WILFRED",23,0,1,0,23,1,0,1,0
"YASIN",17,2,.8947368,.1052632,19,1,0,0,0
"YASMEEN",0,16,0,1,16,0,1,0,1
"YOSHI",16,3,.8421053,.1578947,19,1,0,0,0
"ZEKE",16,0,1,0,16,1,0,1,0
"ADRIANE",0,21,0,1,21,0,1,0,1
"AKIN",21,0,1,0,21,1,0,1,0
"AMELIE",0,17,0,1,17,0,1,0,1
"ARLETTE",0,16,0,1,16,0,1,0,1
"ASHOK",24,0,1,0,24,1,0,1,0
"BINA",0,16,0,1,16,0,1,0,1
"CARLINE",0,24,0,1,24,0,1,0,1
"CHUNG",15,1,.9375,.0625,16,1,0,0,0
"DARREL",21,0,1,0,21,1,0,1,0
"DASHAWN",19,2,.9047619,.0952381,21,1,0,0,0
"DEBBI",0,21,0,1,21,0,1,0,1
"DIAN",3,19,.1363636,.8636364,22,0,1,0,0
"DOMINIK",19,0,1,0,19,1,0,1,0
"DONTE",22,0,1,0,22,1,0,1,0
"EPHRAIM",18,0,1,0,18,1,0,1,0
"FABIEN",14,0,1,0,14,1,0,1,0
"FARZANA",0,14,0,1,14,0,1,0,1
"FRIEDA",0,14,0,1,14,0,1,0,1
"GERSON",20,0,1,0,20,1,0,1,0
"HARLEM",9,4,.6923077,.3076923,13,0,0,0,0
"HARMONY",0,15,0,1,15,0,1,0,1
"HILLEL",19,0,1,0,19,1,0,1,0
"HIRAM",21,0,1,0,21,1,0,1,0
"HONEY",1,19,.05,.95,20,0,1,0,0
"HUSEYIN",14,0,1,0,14,1,0,1,0
"JACKELINE",0,21,0,1,21,0,1,0,1
"JAH",15,5,.75,.25,20,0,0,0,0
"JOHANNE",0,17,0,1,17,0,1,0,1
"KEIRA",0,9,0,1,9,0,1,0,1
"KENDELL",18,2,.9,.1,20,1,0,0,0
"KINGA",1,16,.0588235,.9411765,17,0,1,0,0
"LAN",2,10,.1666667,.8333333,12,0,1,0,0
"LORIN",6,9,.4,.6,15,0,0,0,0
"LUCIEN",20,0,1,0,20,1,0,1,0
"MAGALI",0,20,0,1,20,0,1,0,1
"MALISSA",0,20,0,1,20,0,1,0,1
"MARIANN",0,24,0,1,24,0,1,0,1
"MARIUSZ",13,0,1,0,13,1,0,1,0
"MATHIAS",16,0,1,0,16,1,0,1,0
"MELODIE",0,19,0,1,19,0,1,0,1
"MILLER",15,4,.7894737,.2105263,19,1,0,0,0
"MISS",0,15,0,1,15,0,1,0,1
"MOON",4,15,.2105263,.7894737,19,0,1,0,0
"ONEIL",25,0,1,0,25,1,0,1,0
"PAGE",7,9,.4375,.5625,16,0,0,0,0
"POONAM",0,18,0,1,18,0,1,0,1
"PUNEET",16,2,.8888889,.1111111,18,1,0,0,0
"RIKI",1,17,.0555556,.9444444,18,0,1,0,0
"RIO",11,9,.55,.45,20,0,0,0,0
"ROSANA",1,15,.0625,.9375,16,0,1,0,0
"SANDHYA",0,15,0,1,15,0,1,0,1
"SAUNDRA",0,25,0,1,25,0,1,0,1
"SHANTELL",0,20,0,1,20,0,1,0,1
"SHWETA",0,12,0,1,12,0,1,0,1
"SONAL",0,11,0,1,11,0,1,0,1
"STEPHON",25,0,1,0,25,1,0,1,0
"SUGAR",3,13,.1875,.8125,16,0,1,0,0
"SURESH",19,0,1,0,19,1,0,1,0
"SYLWIA",0,19,0,1,19,0,1,0,1
"TAMISHA",0,21,0,1,21,0,1,0,1
"TAMMIE",0,14,0,1,14,0,1,0,1
"TENISHA",0,20,0,1,20,0,1,0,1
"TIANNA",0,16,0,1,16,0,1,0,1
"WALEED",20,0,1,0,20,1,0,1,0
"WALID",17,0,1,0,17,1,0,1,0
"WILLIS",22,0,1,0,22,1,0,1,0
"WILMER",19,0,1,0,19,1,0,1,0
"YOUSSEF",21,0,1,0,21,1,0,1,0
"ABBE",0,14,0,1,14,0,1,0,1
"ADDY",6,14,.3,.7,20,0,0,0,0
"AHSAN",17,0,1,0,17,1,0,1,0
"ALEXI",10,3,.7692308,.2307692,13,1,0,0,0
"ARVIND",20,0,1,0,20,1,0,1,0
"AVITAL",1,7,.125,.875,8,0,1,0,0
"BETTE",1,24,.04,.96,25,0,1,0,1
"CAESAR",22,0,1,0,22,1,0,1,0
"CHRISSIE",0,9,0,1,9,0,1,0,1
"CRISSY",0,17,0,1,17,0,1,0,1
"DEL",9,5,.6428571,.3571429,14,0,0,0,0
"DIMITRIS",15,0,1,0,15,1,0,1,0
"DOMINIKA",0,13,0,1,13,0,1,0,1
"EDWINA",0,17,0,1,17,0,1,0,1
"ELIF",0,15,0,1,15,0,1,0,1
"ELOISE",0,16,0,1,16,0,1,0,1
"EVELINA",0,19,0,1,19,0,1,0,1
"FEI",12,9,.5714286,.4285714,21,0,0,0,0
"FLAVIO",16,0,1,0,16,1,0,1,0
"GRAY",16,2,.8888889,.1111111,18,1,0,0,0
"HARIS",20,0,1,0,20,1,0,1,0
"HEMA",1,16,.0588235,.9411765,17,0,1,0,0
"IVA",0,14,0,1,14,0,1,0,1
"JALEESA",0,19,0,1,19,0,1,0,1
"JAMESON",12,3,.8,.2,15,1,0,0,0
"JANESSA",0,14,0,1,14,0,1,0,1
"JARRED",19,0,1,0,19,1,0,1,0
"JEAN-PAUL",20,0,1,0,20,1,0,1,0
"JEAN-PIERRE",12,0,1,0,12,1,0,1,0
"KARISSA",0,16,0,1,16,0,1,0,1
"KENRICK",24,0,1,0,24,1,0,1,0
"KERSTIN",0,13,0,1,13,0,1,0,1
"KIESHA",0,16,0,1,16,0,1,0,1
"KIZZY",0,15,0,1,15,0,1,0,1
"KUMAR",24,0,1,0,24,1,0,1,0
"LEVENT",17,0,1,0,17,1,0,1,0
"LEW",19,0,1,0,19,1,0,1,0
"LEXIE",0,14,0,1,14,0,1,0,1
"LIGIA",0,20,0,1,20,0,1,0,1
"LIRON",8,10,.4444444,.5555556,18,0,0,0,0
"LISE",0,16,0,1,16,0,1,0,1
"LUANN",0,24,0,1,24,0,1,0,1
"MAN",17,2,.8947368,.1052632,19,1,0,0,0
"MARIELLA",0,14,0,1,14,0,1,0,1
"MARIUS",27,0,1,0,27,1,0,1,0
"MAXIMILIAN",18,0,1,0,18,1,0,1,0
"MAXIMO",22,0,1,0,22,1,0,1,0
"MERY",0,22,0,1,22,0,1,0,1
"MICKY",15,3,.8333333,.1666667,18,1,0,0,0
"MOR",10,7,.5882353,.4117647,17,0,0,0,0
"NIKOLA",18,3,.8571429,.1428571,21,1,0,0,0
"PHYLICIA",0,15,0,1,15,0,1,0,1
"QUEENIE",0,15,0,1,15,0,1,0,1
"RAIN",6,11,.3529412,.6470588,17,0,0,0,0
"RAMSEY",15,3,.8333333,.1666667,18,1,0,0,0
"RICHELLE",0,17,0,1,17,0,1,0,1
"ROSHNI",0,14,0,1,14,0,1,0,1
"RUFUS",22,0,1,0,22,1,0,1,0
"RUSSEL",20,1,.952381,.047619,21,1,0,1,0
"SAIRA",0,12,0,1,12,0,1,0,1
"SEJAL",0,15,0,1,15,0,1,0,1
"SHANIQUE",0,17,0,1,17,0,1,0,1
"SILVIO",23,0,1,0,23,1,0,1,0
"SKYLAR",6,5,.5454546,.4545455,11,0,0,0,0
"STEFANY",0,11,0,1,11,0,1,0,1
"SURAJ",20,0,1,0,20,1,0,1,0
"SURI",0,16,0,1,16,0,1,0,1
"TONE",22,2,.9166667,.0833333,24,1,0,0,0
"UMAIR",17,0,1,0,17,1,0,1,0
"WHITE",9,4,.6923077,.3076923,13,0,0,0,0
"ZHANG",7,8,.4666667,.5333334,15,0,0,0,0
"ZHENG",12,9,.5714286,.4285714,21,0,0,0,0
"ZHI",17,1,.9444444,.0555556,18,1,0,0,0
"ZIA",9,6,.6,.4,15,0,0,0,0
"AARTI",0,10,0,1,10,0,1,0,1
"ADRIA",0,7,0,1,7,0,1,0,1
"AIDEN",18,2,.9,.1,20,1,0,0,0
"ALDEN",18,0,1,0,18,1,0,1,0
"ANILA",0,15,0,1,15,0,1,0,1
"APPLE",4,16,.2,.8,20,0,1,0,0
"ARIA",3,10,.2307692,.7692308,13,0,1,0,0
"AURELIA",1,15,.0625,.9375,16,0,1,0,0
"AYELET",0,15,0,1,15,0,1,0,1
"AYÅ_E",0,13,0,1,13,0,1,0,1
"AZIZA",0,13,0,1,13,0,1,0,1
"BARAK",16,0,1,0,16,1,0,1,0
"CAL",15,2,.8823529,.1176471,17,1,0,0,0
"CAMPBELL",8,4,.6666667,.3333333,12,0,0,0,0
"CATHIE",0,22,0,1,22,0,1,0,1
"CHANDLER",16,4,.8,.2,20,1,0,0,0
"CHING",6,7,.4615385,.5384616,13,0,0,0,0
"CHINO",17,2,.8947368,.1052632,19,1,0,0,0
"CLARICE",0,14,0,1,14,0,1,0,1
"DEMETRA",0,18,0,1,18,0,1,0,1
"DIDI",4,12,.25,.75,16,0,0,0,0
"DIMITRY",20,0,1,0,20,1,0,1,0
"DOROTA",0,17,0,1,17,0,1,0,1
"DRU",18,7,.72,.28,25,0,0,0,0
"ENA",0,14,0,1,14,0,1,0,1
"FADI",17,0,1,0,17,1,0,1,0
"FEDERICA",0,14,0,1,14,0,1,0,1
"FRANCA",0,17,0,1,17,0,1,0,1
"GAL",14,6,.7,.3,20,0,0,0,0
"GEORGIE",11,8,.5789474,.4210526,19,0,0,0,0
"GIOVANNY",20,0,1,0,20,1,0,1,0
"GRISEL",0,17,0,1,17,0,1,0,1
"HAROON",17,0,1,0,17,1,0,1,0
"HARSH",11,1,.9166667,.0833333,12,1,0,0,0
"JEANA",0,13,0,1,13,0,1,0,1
"JEANNA",0,18,0,1,18,0,1,0,1
"JUNKO",0,19,0,1,19,0,1,0,1
"JYOTI",3,12,.2,.8,15,0,1,0,0
"KABIR",16,0,1,0,16,1,0,1,0
"KAMI",2,12,.1428571,.8571429,14,0,1,0,0
"KAMILAH",0,13,0,1,13,0,1,0,1
"KELLYANN",0,19,0,1,19,0,1,0,1
"KEMAR",18,0,1,0,18,1,0,1,0
"KEMI",0,20,0,1,20,0,1,0,1
"KEYLA",0,21,0,1,21,0,1,0,1
"KHALILAH",0,21,0,1,21,0,1,0,1
"KIKO",19,2,.9047619,.0952381,21,1,0,0,0
"KIMANI",17,1,.9444444,.0555556,18,1,0,0,0
"KORY",14,3,.8235294,.1764706,17,1,0,0,0
"LAINIE",0,11,0,1,11,0,1,0,1
"LENIN",16,0,1,0,16,1,0,1,0
"LIANNA",0,16,0,1,16,0,1,0,1
"MARQUES",21,0,1,0,21,1,0,1,0
"MELBA",0,17,0,1,17,0,1,0,1
"MILLICENT",0,19,0,1,19,0,1,0,1
"MOISHE",7,0,1,0,7,1,0,1,0
"NA",3,11,.2142857,.7857143,14,0,1,0,0
"NADA",0,14,0,1,14,0,1,0,1
"NATHALIA",0,17,0,1,17,0,1,0,1
"NERISSA",0,13,0,1,13,0,1,0,1
"NORBERTO",22,0,1,0,22,1,0,1,0
"OLIVE",1,16,.0588235,.9411765,17,0,1,0,0
"OLYA",0,10,0,1,10,0,1,0,1
"PACO",19,1,.95,.05,20,1,0,0,0
"PATRYCJA",0,17,0,1,17,0,1,0,1
"PHILL",16,0,1,0,16,1,0,1,0
"PIPER",0,16,0,1,16,0,1,0,1
"PRUDENCE",0,13,0,1,13,0,1,0,1
"QUIANA",0,16,0,1,16,0,1,0,1
"RAFFI",14,1,.9333333,.0666667,15,1,0,0,0
"RAJU",21,0,1,0,21,1,0,1,0
"RAMIRO",19,0,1,0,19,1,0,1,0
"REI",7,8,.4666667,.5333334,15,0,0,0,0
"ROSARIA",0,22,0,1,22,0,1,0,1
"SAPNA",0,15,0,1,15,0,1,0,1
"SCHUYLER",7,4,.6363636,.3636364,11,0,0,0,0
"SHARONA",0,13,0,1,13,0,1,0,1
"SIDDHARTH",15,0,1,0,15,1,0,1,0
"SIMI",2,11,.1538462,.8461539,13,0,1,0,0
"SPARKLE",0,15,0,1,15,0,1,0,1
"STACIA",0,17,0,1,17,0,1,0,1
"TAMIR",19,0,1,0,19,1,0,1,0
"TIMUR",20,0,1,0,20,1,0,1,0
"VALENTINO",15,0,1,0,15,1,0,1,0
"VIOLETTA",0,19,0,1,19,0,1,0,1
"VIRGINIE",0,12,0,1,12,0,1,0,1
"WIN",14,5,.7368421,.2631579,19,0,0,0,0
"YAFFA",0,18,0,1,18,0,1,0,1
"YAO",13,7,.65,.35,20,0,0,0,0
"YONATAN",13,0,1,0,13,1,0,1,0
"YUSEF",18,1,.9473684,.0526316,19,1,0,0,0
"ZAINAB",0,12,0,1,12,0,1,0,1
"AKIVA",16,1,.9411765,.0588235,17,1,0,0,0
"ALEXEY",23,0,1,0,23,1,0,1,0
"ANGELLA",0,18,0,1,18,0,1,0,1
"ARCHANA",0,11,0,1,11,0,1,0,1
"ASSAF",15,0,1,0,15,1,0,1,0
"AURELIE",0,15,0,1,15,0,1,0,1
"BOAZ",17,0,1,0,17,1,0,1,0
"BRACHA",1,13,.0714286,.9285714,14,0,1,0,0
"BRICE",12,0,1,0,12,1,0,1,0
"BRIT",4,11,.2666667,.7333333,15,0,0,0,0
"CALI",5,10,.3333333,.6666667,15,0,0,0,0
"CARLI",2,13,.1333333,.8666667,15,0,1,0,0
"CHERISSE",0,19,0,1,19,0,1,0,1
"CIRO",18,0,1,0,18,1,0,1,0
"CRISTINE",0,14,0,1,14,0,1,0,1
"DIVINE",12,3,.8,.2,15,1,0,0,0
"DRAKE",20,1,.952381,.047619,21,1,0,1,0
"DREA",0,12,0,1,12,0,1,0,1
"ELAD",15,0,1,0,15,1,0,1,0
"ELIO",19,0,1,0,19,1,0,1,0
"EZEQUIEL",19,0,1,0,19,1,0,1,0
"FAN",10,8,.5555556,.4444444,18,0,0,0,0
"FANNIE",0,12,0,1,12,0,1,0,1
"FARID",16,0,1,0,16,1,0,1,0
"FERDINAND",17,0,1,0,17,1,0,1,0
"GAELLE",0,15,0,1,15,0,1,0,1
"GRAEME",13,0,1,0,13,1,0,1,0
"HIRO",10,3,.7692308,.2307692,13,1,0,0,0
"HIROMI",3,11,.2142857,.7857143,14,0,1,0,0
"HOLLIE",1,15,.0625,.9375,16,0,1,0,0
"JANAY",0,23,0,1,23,0,1,0,1
"JANETH",0,18,0,1,18,0,1,0,1
"JEE",2,10,.1666667,.8333333,12,0,1,0,0
"JHONNY",19,0,1,0,19,1,0,1,0
"JIEUN",0,19,0,1,19,0,1,0,1
"JOHANNES",14,0,1,0,14,1,0,1,0
"JOHNY",20,0,1,0,20,1,0,1,0
"JUANCARLOS",19,0,1,0,19,1,0,1,0
"KAITY",0,12,0,1,12,0,1,0,1
"KARIMA",1,12,.0769231,.9230769,13,0,1,0,0
"KAZI",12,3,.8,.2,15,1,0,0,0
"KIP",18,0,1,0,18,1,0,1,0
"KYUNG",12,6,.6666667,.3333333,18,0,0,0,0
"LATESHA",0,23,0,1,23,0,1,0,1
"LAVINIA",0,16,0,1,16,0,1,0,1
"LEILANI",0,16,0,1,16,0,1,0,1
"LORIANN",0,18,0,1,18,0,1,0,1
"MAEVE",0,13,0,1,13,0,1,0,1
"MALGORZATA",0,20,0,1,20,0,1,0,1
"MANISHA",0,12,0,1,12,0,1,0,1
"MAR",7,11,.3888889,.6111111,18,0,0,0,0
"MAREK",20,0,1,0,20,1,0,1,0
"MAREN",0,14,0,1,14,0,1,0,1
"MARIBETH",0,20,0,1,20,0,1,0,1
"MENA",7,9,.4375,.5625,16,0,0,0,0
"MENG",11,5,.6875,.3125,16,0,0,0,0
"MIGUELINA",0,21,0,1,21,0,1,0,1
"MIHO",0,18,0,1,18,0,1,0,1
"MORAN",2,12,.1428571,.8571429,14,0,1,0,0
"NIKOLE",1,15,.0625,.9375,16,0,1,0,0
"NISHANT",16,0,1,0,16,1,0,1,0
"NOOR",9,7,.5625,.4375,16,0,0,0,0
"NORAH",0,16,0,1,16,0,1,0,1
"OMRI",12,0,1,0,12,1,0,1,0
"OPAL",0,10,0,1,10,0,1,0,1
"OPHELIA",0,15,0,1,15,0,1,0,1
"OSIRIS",12,4,.75,.25,16,0,0,0,0
"PENG",15,4,.7894737,.2105263,19,1,0,0,0
"PRITI",0,11,0,1,11,0,1,0,1
"QIAN",5,10,.3333333,.6666667,15,0,0,0,0
"QIANA",0,18,0,1,18,0,1,0,1
"ROMEL",20,0,1,0,20,1,0,1,0
"SCARLET",0,13,0,1,13,0,1,0,1
"SHARMIN",0,6,0,1,6,0,1,0,1
"SHI",9,5,.6428571,.3571429,14,0,0,0,0
"SIU",9,7,.5625,.4375,16,0,0,0,0
"STAR",1,18,.0526316,.9473684,19,0,1,0,0
"TASIA",0,18,0,1,18,0,1,0,1
"THADDEUS",13,0,1,0,13,1,0,1,0
"VIDYA",0,15,0,1,15,0,1,0,1
"VIK",13,2,.8666667,.1333333,15,1,0,0,0
"VINOD",15,0,1,0,15,1,0,1,0
"VIRGIL",19,0,1,0,19,1,0,1,0
"VIVI",1,13,.0714286,.9285714,14,0,1,0,0
"WON",14,4,.7777778,.2222222,18,1,0,0,0
"XU",14,5,.7368421,.2631579,19,0,0,0,0
"YANI",2,16,.1111111,.8888889,18,0,1,0,0
"YE",7,9,.4375,.5625,16,0,0,0,0
"ADEEL",17,0,1,0,17,1,0,1,0
"AGGIE",0,14,0,1,14,0,1,0,1
"AKUA",0,15,0,1,15,0,1,0,1
"ALESIA",0,16,0,1,16,0,1,0,1
"AMA",3,12,.2,.8,15,0,1,0,0
"AMANDEEP",12,5,.7058824,.2941177,17,0,0,0,0
"AMMAR",17,0,1,0,17,1,0,1,0
"ANTWAN",23,0,1,0,23,1,0,1,0
"ARIANNE",0,13,0,1,13,0,1,0,1
"ARIK",13,0,1,0,13,1,0,1,0
"AYO",13,4,.7647059,.2352941,17,1,0,0,0
"AYUMI",1,9,.1,.9,10,0,1,0,0
"BEBE",2,14,.125,.875,16,0,1,0,0
"BESSIE",0,13,0,1,13,0,1,0,1
"BLYTHE",0,13,0,1,13,0,1,0,1
"BRAULIO",19,0,1,0,19,1,0,1,0
"BRENDEN",13,0,1,0,13,1,0,1,0
"BRONWYN",0,11,0,1,11,0,1,0,1
"BRUNILDA",0,24,0,1,24,0,1,0,1
"CANDIDA",0,20,0,1,20,0,1,0,1
"CARINE",0,14,0,1,14,0,1,0,1
"CHARISMA",0,18,0,1,18,0,1,0,1
"CHRISTELLE",0,11,0,1,11,0,1,0,1
"DALILA",0,9,0,1,9,0,1,0,1
"DAVIN",15,0,1,0,15,1,0,1,0
"ELLYN",0,16,0,1,16,0,1,0,1
"ERINN",0,9,0,1,9,0,1,0,1
"ESTRELLA",0,19,0,1,19,0,1,0,1
"ETIENNE",11,1,.9166667,.0833333,12,1,0,0,0
"EVANGELINE",1,18,.0526316,.9473684,19,0,1,0,0
"FANG",4,11,.2666667,.7333333,15,0,0,0,0
"FIDEL",18,0,1,0,18,1,0,1,0
"FIORELLA",0,19,0,1,19,0,1,0,1
"FRIDA",0,21,0,1,21,0,1,0,1
"GEORGES",17,0,1,0,17,1,0,1,0
"GORAN",14,0,1,0,14,1,0,1,0
"GURPREET",12,4,.75,.25,16,0,0,0,0
"HAI",18,4,.8181818,.1818182,22,1,0,0,0
"HAIM",15,0,1,0,15,1,0,1,0
"HANI",6,4,.6,.4,10,0,0,0,0
"HENNY",3,12,.2,.8,15,0,1,0,0
"HYE",3,17,.15,.85,20,0,1,0,0
"IZABELLA",0,15,0,1,15,0,1,0,1
"JARON",15,0,1,0,15,1,0,1,0
"JENS",17,0,1,0,17,1,0,1,0
"JINNY",0,13,0,1,13,0,1,0,1
"JOHN-PAUL",19,0,1,0,19,1,0,1,0
"KARMA",9,8,.5294118,.4705882,17,0,0,0,0
"KIERSTEN",0,5,0,1,5,0,1,0,1
"KLARA",0,18,0,1,18,0,1,0,1
"KONRAD",16,0,1,0,16,1,0,1,0
"KRYSTA",0,9,0,1,9,0,1,0,1
"LEANDRA",0,12,0,1,12,0,1,0,1
"LEIF",11,0,1,0,11,1,0,1,0
"LOREDANA",0,16,0,1,16,0,1,0,1
"MALIA",0,13,0,1,13,0,1,0,1
"MARGHERITA",1,14,.0666667,.9333333,15,0,1,0,0
"MARIAMA",0,14,0,1,14,0,1,0,1
"MARLENY",1,17,.0555556,.9444444,18,0,1,0,0
"MEGHANN",0,9,0,1,9,0,1,0,1
"NEERAJ",13,0,1,0,13,1,0,1,0
"NGUYEN",10,12,.4545455,.5454546,22,0,0,0,0
"NO",14,5,.7368421,.2631579,19,0,0,0,0
"OSWALDO",18,0,1,0,18,1,0,1,0
"PRADEEP",15,0,1,0,15,1,0,1,0
"RABIA",0,18,0,1,18,0,1,0,1
"RAMA",8,8,.5,.5,16,0,0,0,0
"REEMA",0,13,0,1,13,0,1,0,1
"RIE",0,12,0,1,12,0,1,0,1
"SAMY",12,2,.8571429,.1428571,14,1,0,0,0
"SASCHA",11,5,.6875,.3125,16,0,0,0,0
"SEON",11,0,1,0,11,1,0,1,0
"SHANAY",0,17,0,1,17,0,1,0,1
"SHIREEN",0,10,0,1,10,0,1,0,1
"STEF",1,11,.0833333,.9166667,12,0,1,0,0
"SWEET",3,15,.1666667,.8333333,18,0,1,0,0
"SYBIL",0,15,0,1,15,0,1,0,1
"TIESHA",0,17,0,1,17,0,1,0,1
"TOLGA",17,0,1,0,17,1,0,1,0
"TOYIN",1,16,.0588235,.9411765,17,0,1,0,0
"TRE",10,2,.8333333,.1666667,12,1,0,0,0
"TYE",13,2,.8666667,.1333333,15,1,0,0,0
"UNA",0,14,0,1,14,0,1,0,1
"VANIA",0,13,0,1,13,0,1,0,1
"VENESSA",0,17,0,1,17,0,1,0,1
"WAQAS",12,0,1,0,12,1,0,1,0
"YANN",14,1,.9333333,.0666667,15,1,0,0,0
"YARA",0,13,0,1,13,0,1,0,1
"ZEESHAN",15,1,.9375,.0625,16,1,0,0,0
"ZOEY",0,12,0,1,12,0,1,0,1
"Ã‡OOKIÃ_",2,10,.1666667,.8333333,12,0,1,0,0
"ALPHONSO",16,0,1,0,16,1,0,1,0
"APARNA",0,9,0,1,9,0,1,0,1
"ARA",10,6,.625,.375,16,0,0,0,0
"ARIE",13,2,.8666667,.1333333,15,1,0,0,0
"AUGUSTINE",20,0,1,0,20,1,0,1,0
"AVRIL",0,18,0,1,18,0,1,0,1
"BARB",1,12,.0769231,.9230769,13,0,1,0,0
"BARRINGTON",18,0,1,0,18,1,0,1,0
"BHARAT",17,0,1,0,17,1,0,1,0
"BUD",15,1,.9375,.0625,16,1,0,0,0
"CARMELLA",0,17,0,1,17,0,1,0,1
"CARYL",1,10,.0909091,.9090909,11,0,1,0,0
"CHETAN",14,0,1,0,14,1,0,1,0
"CHRISTEL",1,15,.0625,.9375,16,0,1,0,0
"CLEVELAND",19,0,1,0,19,1,0,1,0
"CONSUELO",0,19,0,1,19,0,1,0,1
"COSMO",17,0,1,0,17,1,0,1,0
"DAQUAN",24,0,1,0,24,1,0,1,0
"DEDE",2,14,.125,.875,16,0,1,0,0
"DOTTIE",0,20,0,1,20,0,1,0,1
"EROL",16,0,1,0,16,1,0,1,0
"ESSENCE",1,16,.0588235,.9411765,17,0,1,0,0
"EUGENIO",20,0,1,0,20,1,0,1,0
"FATIMAH",0,21,0,1,21,0,1,0,1
"FRANCHESKA",0,18,0,1,18,0,1,0,1
"FRANCOISE",1,13,.0714286,.9285714,14,0,1,0,0
"FRANZISKA",0,19,0,1,19,0,1,0,1
"GEOVANNY",18,0,1,0,18,1,0,1,0
"GINETTE",0,16,0,1,16,0,1,0,1
"GREGORIO",20,0,1,0,20,1,0,1,0
"IMELDA",0,15,0,1,15,0,1,0,1
"IVANNA",0,16,0,1,16,0,1,0,1
"JAYA",4,11,.2666667,.7333333,15,0,0,0,0
"JES",1,10,.0909091,.9090909,11,0,1,0,0
"JEVON",18,0,1,0,18,1,0,1,0
"KADIAN",2,17,.1052632,.8947368,19,0,1,0,0
"KENISHA",0,15,0,1,15,0,1,0,1
"KIMI",4,7,.3636364,.6363636,11,0,0,0,0
"KOBI",12,1,.9230769,.0769231,13,1,0,0,0
"KOJO",16,0,1,0,16,1,0,1,0
"KRYSTYNA",0,12,0,1,12,0,1,0,1
"KWAKU",18,0,1,0,18,1,0,1,0
"LILLIE",0,14,0,1,14,0,1,0,1
"LUTHER",21,0,1,0,21,1,0,1,0
"MEGHA",0,8,0,1,8,0,1,0,1
"MERLE",0,17,0,1,17,0,1,0,1
"MIKKI",1,17,.0555556,.9444444,18,0,1,0,0
"MINNA",0,13,0,1,13,0,1,0,1
"MONET",0,10,0,1,10,0,1,0,1
"NADEEM",17,0,1,0,17,1,0,1,0
"NAILAH",0,15,0,1,15,0,1,0,1
"NATALI",0,13,0,1,13,0,1,0,1
"NONA",0,15,0,1,15,0,1,0,1
"OZZY",20,2,.9090909,.0909091,22,1,0,0,0
"PEG",0,16,0,1,16,0,1,0,1
"PIERO",14,0,1,0,14,1,0,1,0
"POP",14,3,.8235294,.1764706,17,1,0,0,0
"PRANAV",17,0,1,0,17,1,0,1,0
"RAHSAAN",18,0,1,0,18,1,0,1,0
"RAOUL",19,0,1,0,19,1,0,1,0
"REUVEN",14,0,1,0,14,1,0,1,0
"RIVA",0,8,0,1,8,0,1,0,1
"ROSELYN",0,18,0,1,18,0,1,0,1
"RUDOLPH",18,0,1,0,18,1,0,1,0
"RUPERT",15,0,1,0,15,1,0,1,0
"SAIDA",1,13,.0714286,.9285714,14,0,1,0,0
"SANTANA",8,13,.3809524,.6190476,21,0,0,0,0
"SHAHID",20,0,1,0,20,1,0,1,0
"SHANAE",0,14,0,1,14,0,1,0,1
"SHARRON",1,16,.0588235,.9411765,17,0,1,0,0
"SHON",14,1,.9333333,.0666667,15,1,0,0,0
"SIGRID",0,18,0,1,18,0,1,0,1
"SIMCHA",7,0,1,0,7,1,0,1,0
"SNEHA",0,17,0,1,17,0,1,0,1
"SUMAN",9,3,.75,.25,12,0,0,0,0
"TANEISHA",0,19,0,1,19,0,1,0,1
"TAO",10,2,.8333333,.1666667,12,1,0,0,0
"TERESE",0,13,0,1,13,0,1,0,1
"TIN",11,7,.6111111,.3888889,18,0,0,0,0
"TITUS",14,0,1,0,14,1,0,1,0
"TOMMASO",13,0,1,0,13,1,0,1,0
"TRACEE",0,13,0,1,13,0,1,0,1
"TYRON",25,0,1,0,25,1,0,1,0
"ULYSSES",17,0,1,0,17,1,0,1,0
"VICK",17,0,1,0,17,1,0,1,0
"XIANG",10,6,.625,.375,16,0,0,0,0
"YANIQUE",0,10,0,1,10,0,1,0,1
"ZAHRA",0,15,0,1,15,0,1,0,1
"AGRON",18,0,1,0,18,1,0,1,0
"ALBERTA",0,14,0,1,14,0,1,0,1
"ALONA",0,16,0,1,16,0,1,0,1
"AMEER",16,0,1,0,16,1,0,1,0
"ANDREEA",0,13,0,1,13,0,1,0,1
"ANJU",3,8,.2727273,.7272727,11,0,0,0,0
"ANSON",15,0,1,0,15,1,0,1,0
"ANTHEA",0,15,0,1,15,0,1,0,1
"ANTONIETTA",0,14,0,1,14,0,1,0,1
"ARAM",13,2,.8666667,.1333333,15,1,0,0,0
"ARVIN",16,0,1,0,16,1,0,1,0
"BENITO",19,0,1,0,19,1,0,1,0
"BIANA",0,14,0,1,14,0,1,0,1
"BOBBLE",12,11,.5217391,.4782609,23,0,0,0,0
"BREANNA",0,8,0,1,8,0,1,0,1
"BRIA",0,12,0,1,12,0,1,0,1
"BRONX",11,4,.7333333,.2666667,15,0,0,0,0
"CARLOTTA",0,15,0,1,15,0,1,0,1
"CAROLIN",0,14,0,1,14,0,1,0,1
"CATHARINE",0,10,0,1,10,0,1,0,1
"CHAUNCEY",15,2,.8823529,.1176471,17,1,0,0,0
"DALTON",14,1,.9333333,.0666667,15,1,0,0,0
"DAMALI",2,11,.1538462,.8461539,13,0,1,0,0
"DEJA",0,11,0,1,11,0,1,0,1
"DELLA",0,17,0,1,17,0,1,0,1
"DORIT",0,14,0,1,14,0,1,0,1
"DUDLEY",16,2,.8888889,.1111111,18,1,0,0,0
"EMRAH",11,0,1,0,11,1,0,1,0
"FARHAD",15,0,1,0,15,1,0,1,0
"FARIDA",0,17,0,1,17,0,1,0,1
"FRANCIA",0,18,0,1,18,0,1,0,1
"GENIE",0,11,0,1,11,0,1,0,1
"GILL",9,4,.6923077,.3076923,13,0,0,0,0
"GRAYSON",11,4,.7333333,.2666667,15,0,0,0,0
"GREER",3,10,.2307692,.7692308,13,0,1,0,0
"HAMID",16,0,1,0,16,1,0,1,0
"HANY",14,1,.9333333,.0666667,15,1,0,0,0
"HENRIETTA",0,16,0,1,16,0,1,0,1
"HERNANDO",16,0,1,0,16,1,0,1,0
"JENIFFER",0,15,0,1,15,0,1,0,1
"JEONG",5,9,.3571429,.6428571,14,0,0,0,0
"JONG",18,2,.9,.1,20,1,0,0,0
"JOURDAN",10,4,.7142857,.2857143,14,0,0,0,0
"KAPIL",20,0,1,0,20,1,0,1,0
"KEELY",0,14,0,1,14,0,1,0,1
"KEMAL",14,1,.9333333,.0666667,15,1,0,0,0
"KEVEN",12,0,1,0,12,1,0,1,0
"KORI",4,9,.3076923,.6923077,13,0,0,0,0
"KRISTOFER",16,0,1,0,16,1,0,1,0
"KRZYSZTOF",17,0,1,0,17,1,0,1,0
"LAVERN",0,16,0,1,16,0,1,0,1
"LEANN",0,13,0,1,13,0,1,0,1
"LELA",0,18,0,1,18,0,1,0,1
"LIANG",13,2,.8666667,.1333333,15,1,0,0,0
"LOWELL",17,0,1,0,17,1,0,1,0
"MAKIKO",0,11,0,1,11,0,1,0,1
"MALINDA",1,10,.0909091,.9090909,11,0,1,0,0
"MANON",0,12,0,1,12,0,1,0,1
"MARGERY",0,13,0,1,13,0,1,0,1
"MARISELA",0,12,0,1,12,0,1,0,1
"MARITA",0,12,0,1,12,0,1,0,1
"MARQUITA",0,18,0,1,18,0,1,0,1
"MASSIMILIANO",15,0,1,0,15,1,0,1,0
"MEHUL",11,0,1,0,11,1,0,1,0
"MERIDITH",0,11,0,1,11,0,1,0,1
"MERVE",0,15,0,1,15,0,1,0,1
"MICA",3,11,.2142857,.7857143,14,0,1,0,0
"MINJI",2,12,.1428571,.8571429,14,0,1,0,0
"NAIM",15,0,1,0,15,1,0,1,0
"NATHANAEL",15,0,1,0,15,1,0,1,0
"NICKIE",2,15,.1176471,.8823529,17,0,1,0,0
"NOVA",5,9,.3571429,.6428571,14,0,0,0,0
"ORIANA",0,8,0,1,8,0,1,0,1
"PERRI",2,7,.2222222,.7777778,9,0,1,0,0
"PETAR",17,0,1,0,17,1,0,1,0
"PRAVEEN",22,0,1,0,22,1,0,1,0
"ROBBIN",5,4,.5555556,.4444444,9,0,0,0,0
"RODRIGUEZ",8,7,.5333334,.4666667,15,0,0,0,0
"ROOSEVELT",20,0,1,0,20,1,0,1,0
"SAIMA",0,10,0,1,10,0,1,0,1
"SALLIE",0,13,0,1,13,0,1,0,1
"SAN",10,4,.7142857,.2857143,14,0,0,0,0
"SANJA",0,14,0,1,14,0,1,0,1
"SHADY",15,2,.8823529,.1176471,17,1,0,0,0
"SHAQUILLE",12,1,.9230769,.0769231,13,1,0,0,0
"SHARDA",0,17,0,1,17,0,1,0,1
"SULLY",6,9,.4,.6,15,0,0,0,0
"SYREETA",0,16,0,1,16,0,1,0,1
"TAKASHI",16,1,.9411765,.0588235,17,1,0,0,0
"TARSHA",0,14,0,1,14,0,1,0,1
"TEENA",1,12,.0769231,.9230769,13,0,1,0,0
"TENNILLE",0,15,0,1,15,0,1,0,1
"TSERING",9,4,.6923077,.3076923,13,0,0,0,0
"TUNDE",14,0,1,0,14,1,0,1,0
"TYISHA",0,14,0,1,14,0,1,0,1
"TYREE",15,1,.9375,.0625,16,1,0,0,0
"UÄ_UR",17,0,1,0,17,1,0,1,0
"VIRGILIO",16,0,1,0,16,1,0,1,0
"WAEL",18,0,1,0,18,1,0,1,0
"YANKY",12,0,1,0,12,1,0,1,0
"YANNICK",13,1,.9285714,.0714286,14,1,0,0,0
"YOELI",4,2,.6666667,.3333333,6,0,0,0,0
"ZENOBIA",0,19,0,1,19,0,1,0,1
"ZOYA",0,13,0,1,13,0,1,0,1
"ZULEIKA",0,13,0,1,13,0,1,0,1
"Ã–ZLEM",0,8,0,1,8,0,1,0,1
"ADDISON",11,2,.8461539,.1538462,13,1,0,0,0
"ALIYAH",0,15,0,1,15,0,1,0,1
"ANANDA",5,11,.3125,.6875,16,0,0,0,0
"ANH",3,5,.375,.625,8,0,0,0,0
"ANISH",7,0,1,0,7,1,0,1,0
"ARBEN",17,0,1,0,17,1,0,1,0
"BERTA",1,15,.0625,.9375,16,0,1,0,0
"BLANCHE",0,18,0,1,18,0,1,0,1
"BURTON",17,0,1,0,17,1,0,1,0
"CAROLANN",0,17,0,1,17,0,1,0,1
"CATHRYN",0,11,0,1,11,0,1,0,1
"CHARISE",0,16,0,1,16,0,1,0,1
"CHINTAN",17,0,1,0,17,1,0,1,0
"CHIOMA",0,13,0,1,13,0,1,0,1
"DARYA",0,9,0,1,9,0,1,0,1
"DEVAN",5,11,.3125,.6875,16,0,0,0,0
"ELDA",0,17,0,1,17,0,1,0,1
"EMANUELE",18,0,1,0,18,1,0,1,0
"ESRA",0,13,0,1,13,0,1,0,1
"FABRICIO",15,0,1,0,15,1,0,1,0
"FITZ",13,0,1,0,13,1,0,1,0
"FORD",17,1,.9444444,.0555556,18,1,0,0,0
"GISELLA",0,18,0,1,18,0,1,0,1
"HUDSON",14,1,.9333333,.0666667,15,1,0,0,0
"HUSSAIN",16,0,1,0,16,1,0,1,0
"IDO",11,0,1,0,11,1,0,1,0
"ILIR",18,0,1,0,18,1,0,1,0
"INBAL",0,8,0,1,8,0,1,0,1
"IOANNIS",15,0,1,0,15,1,0,1,0
"JA",13,2,.8666667,.1333333,15,1,0,0,0
"JAKOB",15,0,1,0,15,1,0,1,0
"JAQUAN",13,0,1,0,13,1,0,1,0
"JAYE",3,7,.3,.7,10,0,0,0,0
"JESSA",1,13,.0714286,.9285714,14,0,1,0,0
"JIWON",0,10,0,1,10,0,1,0,1
"JIYOUNG",1,10,.0909091,.9090909,11,0,1,0,0
"JUDIE",0,21,0,1,21,0,1,0,1
"JUJU",2,11,.1538462,.8461539,13,0,1,0,0
"KEEGAN",13,2,.8666667,.1333333,15,1,0,0,0
"KERRYANN",0,14,0,1,14,0,1,0,1
"KHAN",14,2,.875,.125,16,1,0,0,0
"LEIA",0,11,0,1,11,0,1,0,1
"LELAND",8,0,1,0,8,1,0,1,0
"LERON",13,1,.9285714,.0714286,14,1,0,0,0
"LETISHA",0,14,0,1,14,0,1,0,1
"LETITIA",0,18,0,1,18,0,1,0,1
"LILIYA",0,16,0,1,16,0,1,0,1
"LINDY",2,16,.1111111,.8888889,18,0,1,0,0
"LITA",0,14,0,1,14,0,1,0,1
"MACIEJ",7,0,1,0,7,1,0,1,0
"MARICELA",0,19,0,1,19,0,1,0,1
"MAYER",10,0,1,0,10,1,0,1,0
"MEDINA",2,7,.2222222,.7777778,9,0,1,0,0
"MERAV",0,13,0,1,13,0,1,0,1
"MIKEL",8,1,.8888889,.1111111,9,1,0,0,0
"MINH",8,4,.6666667,.3333333,12,0,0,0,0
"MIRYAM",0,13,0,1,13,0,1,0,1
"MURPHY",9,7,.5625,.4375,16,0,0,0,0
"NATALEE",0,14,0,1,14,0,1,0,1
"NESSA",0,10,0,1,10,0,1,0,1
"NIKKO",18,2,.9,.1,20,1,0,0,0
"NING",6,7,.4615385,.5384616,13,0,0,0,0
"NINI",0,10,0,1,10,0,1,0,1
"ODESSA",0,18,0,1,18,0,1,0,1
"OLENA",0,7,0,1,7,0,1,0,1
"ONIKA",0,9,0,1,9,0,1,0,1
"PASHA",9,2,.8181818,.1818182,11,1,0,0,0
"PATRIZIA",0,13,0,1,13,0,1,0,1
"PETEY",14,0,1,0,14,1,0,1,0
"PHUONG",1,11,.0833333,.9166667,12,0,1,0,0
"PINK",3,14,.1764706,.8235294,17,0,1,0,0
"PRAKASH",15,0,1,0,15,1,0,1,0
"QUAN",10,0,1,0,10,1,0,1,0
"RANDEE",1,10,.0909091,.9090909,11,0,1,0,0
"RASHEEDA",0,14,0,1,14,0,1,0,1
"RODGER",19,0,1,0,19,1,0,1,0
"RONDELL",13,2,.8666667,.1333333,15,1,0,0,0
"RUBIN",16,1,.9411765,.0588235,17,1,0,0,0
"RUTHY",0,12,0,1,12,0,1,0,1
"SATISH",14,0,1,0,14,1,0,1,0
"SHABANA",0,17,0,1,17,0,1,0,1
"SHAKIMA",0,18,0,1,18,0,1,0,1
"SHANIECE",0,14,0,1,14,0,1,0,1
"SHARIFA",0,9,0,1,9,0,1,0,1
"SHEBA",0,10,0,1,10,0,1,0,1
"SIBEL",0,16,0,1,16,0,1,0,1
"SINAN",16,0,1,0,16,1,0,1,0
"SRULY",13,0,1,0,13,1,0,1,0
"TAD",12,0,1,0,12,1,0,1,0
"TAHIR",17,0,1,0,17,1,0,1,0
"TANNER",15,0,1,0,15,1,0,1,0
"TERRA",1,13,.0714286,.9285714,14,0,1,0,0
"URIEL",15,1,.9375,.0625,16,1,0,0,0
"VASILIOS",14,0,1,0,14,1,0,1,0
"VIDAL",12,1,.9230769,.0769231,13,1,0,0,0
"WILLA",0,14,0,1,14,0,1,0,1
"WINIFRED",0,19,0,1,19,0,1,0,1
"YAMIL",10,2,.8333333,.1666667,12,1,0,0,0
"YITZY",14,0,1,0,14,1,0,1,0
"YOU",7,1,.875,.125,8,1,0,0,0
"ZENAIDA",0,13,0,1,13,0,1,0,1
"ZVI",8,0,1,0,8,1,0,1,0
"Ã–ZGÃœR",10,0,1,0,10,1,0,1,0
"ADEOLA",4,8,.3333333,.6666667,12,0,0,0,0
"ALEXEI",14,1,.9333333,.0666667,15,1,0,0,0
"ALYCE",0,18,0,1,18,0,1,0,1
"ALYCIA",0,8,0,1,8,0,1,0,1
"AMBAR",0,12,0,1,12,0,1,0,1
"AMBIKA",0,11,0,1,11,0,1,0,1
"AN",5,6,.4545455,.5454546,11,0,0,0,0
"ANCA",0,9,0,1,9,0,1,0,1
"ANDRA",1,9,.1,.9,10,0,1,0,0
"ANTONETTE",0,20,0,1,20,0,1,0,1
"ASLI",0,8,0,1,8,0,1,0,1
"ATIF",14,0,1,0,14,1,0,1,0
"BARUCH",8,0,1,0,8,1,0,1,0
"BENEDICT",15,0,1,0,15,1,0,1,0
"BENOIT",14,0,1,0,14,1,0,1,0
"BERYL",1,16,.0588235,.9411765,17,0,1,0,0
"BETSEY",0,12,0,1,12,0,1,0,1
"BOLA",8,9,.4705882,.5294118,17,0,0,0,0
"BONNY",6,6,.5,.5,12,0,0,0,0
"BORA",10,5,.6666667,.3333333,15,0,0,0,0
"BRIGETTE",0,13,0,1,13,0,1,0,1
"BRYNN",1,8,.1111111,.8888889,9,0,1,0,0
"BUSHRA",0,8,0,1,8,0,1,0,1
"CANDI",0,13,0,1,13,0,1,0,1
"CASH",14,4,.7777778,.2222222,18,1,0,0,0
"CHARLY",14,2,.875,.125,16,1,0,0,0
"CHASITY",0,17,0,1,17,0,1,0,1
"CHAVA",0,11,0,1,11,0,1,0,1
"CHER",0,16,0,1,16,0,1,0,1
"CINTHYA",0,16,0,1,16,0,1,0,1
"DARSHAN",9,1,.9,.1,10,1,0,0,0
"DAVEY",12,0,1,0,12,1,0,1,0
"DEEDEE",0,9,0,1,9,0,1,0,1
"DESPINA",0,13,0,1,13,0,1,0,1
"DUSTY",11,2,.8461539,.1538462,13,1,0,0,0
"ERNESTINE",0,17,0,1,17,0,1,0,1
"ESTELA",0,15,0,1,15,0,1,0,1
"ESTY",0,9,0,1,9,0,1,0,1
"EVELIN",0,14,0,1,14,0,1,0,1
"FARAZ",14,0,1,0,14,1,0,1,0
"FRANNY",0,9,0,1,9,0,1,0,1
"GEN",8,4,.6666667,.3333333,12,0,0,0,0
"GILAD",14,0,1,0,14,1,0,1,0
"GILLES",11,2,.8461539,.1538462,13,1,0,0,0
"GITA",0,10,0,1,10,0,1,0,1
"HENRIK",14,0,1,0,14,1,0,1,0
"HERIBERTO",17,0,1,0,17,1,0,1,0
"HO",10,3,.7692308,.2307692,13,1,0,0,0
"HUNG",10,3,.7692308,.2307692,13,1,0,0,0
"IDAN",14,1,.9333333,.0666667,15,1,0,0,0
"IRYNA",0,14,0,1,14,0,1,0,1
"JACEK",10,0,1,0,10,1,0,1,0
"JAISON",16,0,1,0,16,1,0,1,0
"JARVIS",16,1,.9411765,.0588235,17,1,0,0,0
"JAWAD",13,0,1,0,13,1,0,1,0
"JET",11,2,.8461539,.1538462,13,1,0,0,0
"JU",5,6,.4545455,.5454546,11,0,0,0,0
"JULIEANN",0,16,0,1,16,0,1,0,1
"JULIETA",0,9,0,1,9,0,1,0,1
"KANA",2,14,.125,.875,16,0,1,0,0
"KANIKA",0,12,0,1,12,0,1,0,1
"KAORI",0,11,0,1,11,0,1,0,1
"KARISHMA",0,12,0,1,12,0,1,0,1
"KARTIK",14,0,1,0,14,1,0,1,0
"KENYATTA",10,5,.6666667,.3333333,15,0,0,0,0
"KENYETTA",0,14,0,1,14,0,1,0,1
"KEON",11,0,1,0,11,1,0,1,0
"KERN",13,2,.8666667,.1333333,15,1,0,0,0
"KERWIN",17,0,1,0,17,1,0,1,0
"KI",7,4,.6363636,.3636364,11,0,0,0,0
"KOSTA",14,0,1,0,14,1,0,1,0
"KRISTEL",0,9,0,1,9,0,1,0,1
"LATRICE",0,10,0,1,10,0,1,0,1
"LAURYN",0,13,0,1,13,0,1,0,1
"LESA",0,18,0,1,18,0,1,0,1
"LINNEA",0,11,0,1,11,0,1,0,1
"LO",4,7,.3636364,.6363636,11,0,0,0,0
"LORRIE",0,14,0,1,14,0,1,0,1
"MAD",12,4,.75,.25,16,0,0,0,0
"MAKSIM",14,0,1,0,14,1,0,1,0
"MARLIN",4,8,.3333333,.6666667,12,0,0,0,0
"MARYKATE",0,5,0,1,5,0,1,0,1
"MAYUMI",0,10,0,1,10,0,1,0,1
"MEGUMI",0,12,0,1,12,0,1,0,1
"MELLY",4,8,.3333333,.6666667,12,0,0,0,0
"MICHELA",0,7,0,1,7,0,1,0,1
"MICKI",2,11,.1538462,.8461539,13,0,1,0,0
"MIDORI",0,11,0,1,11,0,1,0,1
"MIR",15,0,1,0,15,1,0,1,0
"MONTANA",4,5,.4444444,.5555556,9,0,0,0,0
"MORDY",14,0,1,0,14,1,0,1,0
"MOUSSA",21,0,1,0,21,1,0,1,0
"NADAV",14,0,1,0,14,1,0,1,0
"NARESH",12,0,1,0,12,1,0,1,0
"NAZ",1,7,.125,.875,8,0,1,0,0
"NIKOLAS",9,0,1,0,9,1,0,1,0
"NIMA",7,4,.6363636,.3636364,11,0,0,0,0
"NISA",0,7,0,1,7,0,1,0,1
"NOE",13,4,.7647059,.2352941,17,1,0,0,0
"NORIKO",0,13,0,1,13,0,1,0,1
"NORRIS",16,0,1,0,16,1,0,1,0
"ORIN",13,1,.9285714,.0714286,14,1,0,0,0
"OZ",11,0,1,0,11,1,0,1,0
"PANKAJ",17,0,1,0,17,1,0,1,0
"PETAL",0,14,0,1,14,0,1,0,1
"PRATIK",13,0,1,0,13,1,0,1,0
"RAHIM",19,0,1,0,19,1,0,1,0
"RENAE",0,12,0,1,12,0,1,0,1
"RENITA",0,14,0,1,14,0,1,0,1
"RITCHIE",20,2,.9090909,.0909091,22,1,0,0,0
"RONALDO",17,0,1,0,17,1,0,1,0
"ROSETTA",0,18,0,1,18,0,1,0,1
"ROYAL",8,4,.6666667,.3333333,12,0,0,0,0
"SAID",18,0,1,0,18,1,0,1,0
"SAMER",10,0,1,0,10,1,0,1,0
"SHERLEY",0,17,0,1,17,0,1,0,1
"SHIV",9,2,.8181818,.1818182,11,1,0,0,0
"SHIVA",5,3,.625,.375,8,0,0,0,0
"SHO",12,3,.8,.2,15,1,0,0,0
"SI",11,5,.6875,.3125,16,0,0,0,0
"SILVER",13,7,.65,.35,20,0,0,0,0
"SOLEDAD",0,15,0,1,15,0,1,0,1
"TAMEEKA",0,16,0,1,16,0,1,0,1
"TAMIKO",0,18,0,1,18,0,1,0,1
"TAN",10,5,.6666667,.3333333,15,0,0,0,0
"TANA",0,14,0,1,14,0,1,0,1
"TANI",6,7,.4615385,.5384616,13,0,0,0,0
"TANVIR",13,0,1,0,13,1,0,1,0
"TARUN",13,0,1,0,13,1,0,1,0
"TAY",7,6,.5384616,.4615385,13,0,0,0,0
"THOR",14,0,1,0,14,1,0,1,0
"TRINITY",2,11,.1538462,.8461539,13,0,1,0,0
"TZIPPY",0,6,0,1,6,0,1,0,1
"VANESA",0,14,0,1,14,0,1,0,1
"VENICE",0,21,0,1,21,0,1,0,1
"VISHNU",14,0,1,0,14,1,0,1,0
"VIVIANE",0,14,0,1,14,0,1,0,1
"WONG",7,3,.7,.3,10,0,0,0,0
"XANDER",15,0,1,0,15,1,0,1,0
"YASSER",14,0,1,0,14,1,0,1,0
"YESSICA",0,17,0,1,17,0,1,0,1
"YISROEL",8,0,1,0,8,1,0,1,0
"ZELDA",1,19,.05,.95,20,0,1,0,0
"ZOLTÃÅN",15,0,1,0,15,1,0,1,0
"ABDEL",18,0,1,0,18,1,0,1,0
"ABHI",14,0,1,0,14,1,0,1,0
"ABIOLA",0,10,0,1,10,0,1,0,1
"ADENA",0,11,0,1,11,0,1,0,1
"AISLING",0,8,0,1,8,0,1,0,1
"AJIT",11,0,1,0,11,1,0,1,0
"ALL",7,6,.5384616,.4615385,13,0,0,0,0
"ALOK",13,0,1,0,13,1,0,1,0
"ALTAGRACIA",0,18,0,1,18,0,1,0,1
"ANAMARIA",0,10,0,1,10,0,1,0,1
"ANNI",0,10,0,1,10,0,1,0,1
"ARACELI",0,10,0,1,10,0,1,0,1
"ATIYA",0,12,0,1,12,0,1,0,1
"AYLIN",0,9,0,1,9,0,1,0,1
"BATYA",0,8,0,1,8,0,1,0,1
"BOSS",13,2,.8666667,.1333333,15,1,0,0,0
"BREANNE",0,12,0,1,12,0,1,0,1
"BRENTON",12,0,1,0,12,1,0,1,0
"BRITTANI",0,10,0,1,10,0,1,0,1
"BRUNA",0,16,0,1,16,0,1,0,1
"CAM",8,3,.7272727,.2727273,11,0,0,0,0
"CARLITO",17,0,1,0,17,1,0,1,0
"CAROLA",0,16,0,1,16,0,1,0,1
"CASSANDRE",0,14,0,1,14,0,1,0,1
"CHIKA",1,13,.0714286,.9285714,14,0,1,0,0
"CHIN",10,4,.7142857,.2857143,14,0,0,0,0
"CORAL",0,10,0,1,10,0,1,0,1
"DANAE",0,9,0,1,9,0,1,0,1
"DARK",11,5,.6875,.3125,16,0,0,0,0
"DAVY",12,2,.8571429,.1428571,14,1,0,0,0
"DEANDRA",0,11,0,1,11,0,1,0,1
"DEJAN",12,0,1,0,12,1,0,1,0
"DEMETRIA",0,13,0,1,13,0,1,0,1
"DERECK",14,0,1,0,14,1,0,1,0
"DEWAYNE",17,0,1,0,17,1,0,1,0
"DIDIER",14,0,1,0,14,1,0,1,0
"DORIE",0,10,0,1,10,0,1,0,1
"DRAGAN",12,0,1,0,12,1,0,1,0
"ELAYNE",0,10,0,1,10,0,1,0,1
"ELIA",7,4,.6363636,.3636364,11,0,0,0,0
"ELLI",1,5,.1666667,.8333333,6,0,1,0,0
"ESTEFANY",0,9,0,1,9,0,1,0,1
"FREE",11,3,.7857143,.2142857,14,1,0,0,0
"GALEN",14,1,.9333333,.0666667,15,1,0,0,0
"GARVIN",15,0,1,0,15,1,0,1,0
"GEORGIANA",0,12,0,1,12,0,1,0,1
"GLORY",2,12,.1428571,.8571429,14,0,1,0,0
"GRISELDA",0,16,0,1,16,0,1,0,1
"HANAN",3,8,.2727273,.7272727,11,0,0,0,0
"HARPER",3,5,.375,.625,8,0,0,0,0
"HINA",0,10,0,1,10,0,1,0,1
"HOLDEN",16,0,1,0,16,1,0,1,0
"IAIN",11,0,1,0,11,1,0,1,0
"IDRIS",15,1,.9375,.0625,16,1,0,0,0
"ISADORA",0,8,0,1,8,0,1,0,1
"ISSA",9,5,.6428571,.3571429,14,0,0,0,0
"JAMEY",9,2,.8181818,.1818182,11,1,0,0,0
"JARRET",10,0,1,0,10,1,0,1,0
"JAVED",10,0,1,0,10,1,0,1,0
"JENISE",0,14,0,1,14,0,1,0,1
"JOIE",3,13,.1875,.8125,16,0,1,0,0
"JOVANNA",0,9,0,1,9,0,1,0,1
"JÃ‰RÃ‰MIE",12,1,.9230769,.0769231,13,1,0,0,0
"KAILA",0,7,0,1,7,0,1,0,1
"KAIT",0,9,0,1,9,0,1,0,1
"KATHRIN",0,11,0,1,11,0,1,0,1
"KLAUDIA",0,8,0,1,8,0,1,0,1
"KUMIKO",0,12,0,1,12,0,1,0,1
"LAETITIA",0,10,0,1,10,0,1,0,1
"LEONIE",2,11,.1538462,.8461539,13,0,1,0,0
"LEVON",14,0,1,0,14,1,0,1,0
"LILLIANA",0,11,0,1,11,0,1,0,1
"LINO",14,0,1,0,14,1,0,1,0
"LUPE",5,5,.5,.5,10,0,0,0,0
"MAAME",0,12,0,1,12,0,1,0,1
"MAEGAN",0,9,0,1,9,0,1,0,1
"MARICEL",0,12,0,1,12,0,1,0,1
"MARZENA",0,10,0,1,10,0,1,0,1
"MCKENZIE",3,6,.3333333,.6666667,9,0,0,0,0
"MERRY",0,8,0,1,8,0,1,0,1
"MILOS",7,0,1,0,7,1,0,1,0
"MIREYA",0,12,0,1,12,0,1,0,1
"MIRZA",11,4,.7333333,.2666667,15,0,0,0,0
"NEELAM",0,8,0,1,8,0,1,0,1
"NEFERTITI",0,16,0,1,16,0,1,0,1
"NICKOLAS",16,0,1,0,16,1,0,1,0
"NILS",18,0,1,0,18,1,0,1,0
"NIRAV",14,0,1,0,14,1,0,1,0
"NURIA",0,10,0,1,10,0,1,0,1
"NYREE",1,8,.1111111,.8888889,9,0,1,0,0
"OLLIE",7,5,.5833333,.4166667,12,0,0,0,0
"PATRYK",13,0,1,0,13,1,0,1,0
"PIERCE",11,0,1,0,11,1,0,1,0
"QUEENS",8,5,.6153846,.3846154,13,0,0,0,0
"RACHELE",0,13,0,1,13,0,1,0,1
"RAFAL",18,0,1,0,18,1,0,1,0
"RAFFAELE",15,0,1,0,15,1,0,1,0
"RASHA",2,8,.2,.8,10,0,1,0,0
"RASHAUN",16,1,.9411765,.0588235,17,1,0,0,0
"RITESH",5,0,1,0,5,1,0,1,0
"ROTEM",5,5,.5,.5,10,0,0,0,0
"SAKINA",0,10,0,1,10,0,1,0,1
"SHAKA",14,1,.9333333,.0666667,15,1,0,0,0
"SHARICE",0,14,0,1,14,0,1,0,1
"SHAZIA",0,13,0,1,13,0,1,0,1
"SHELLY-ANN",0,14,0,1,14,0,1,0,1
"SHELTON",16,1,.9411765,.0588235,17,1,0,0,0
"SHYAM",16,0,1,0,16,1,0,1,0
"SONY",7,4,.6363636,.3636364,11,0,0,0,0
"SPIROS",14,0,1,0,14,1,0,1,0
"STAVROS",12,0,1,0,12,1,0,1,0
"STEFFI",0,12,0,1,12,0,1,0,1
"TAKAKO",0,10,0,1,10,0,1,0,1
"TENZING",7,5,.5833333,.4166667,12,0,0,0,0
"THAIS",0,13,0,1,13,0,1,0,1
"TIAGO",11,0,1,0,11,1,0,1,0
"TIAN",4,6,.4,.6,10,0,0,0,0
"TIZIANA",0,11,0,1,11,0,1,0,1
"TOSIN",4,4,.5,.5,8,0,0,0,0
"VASHTI",0,14,0,1,14,0,1,0,1
"VERENA",0,9,0,1,9,0,1,0,1
"VITTORIO",12,0,1,0,12,1,0,1,0
"YANNI",8,4,.6666667,.3333333,12,0,0,0,0
"YOHAN",14,0,1,0,14,1,0,1,0
"ZAHID",16,0,1,0,16,1,0,1,0
"ALESHA",0,13,0,1,13,0,1,0,1
"ALICJA",0,12,0,1,12,0,1,0,1
"AMRIT",12,3,.8,.2,15,1,0,0,0
"ANURAG",16,0,1,0,16,1,0,1,0
"ARASH",8,0,1,0,8,1,0,1,0
"ARGENIS",16,1,.9411765,.0588235,17,1,0,0,0
"ARTEMIS",3,9,.25,.75,12,0,0,0,0
"ATTILA",12,1,.9230769,.0769231,13,1,0,0,0
"AUGIE",15,0,1,0,15,1,0,1,0
"BERENICE",0,13,0,1,13,0,1,0,1
"BEV",0,10,0,1,10,0,1,0,1
"BOO",16,3,.8421053,.1578947,19,1,0,0,0
"BRITTA",0,9,0,1,9,0,1,0,1
"BUNNY",2,13,.1333333,.8666667,15,0,1,0,0
"CAPRICE",2,9,.1818182,.8181818,11,0,1,0,0
"CHADWICK",13,0,1,0,13,1,0,1,0
"CHANDA",1,12,.0769231,.9230769,13,0,1,0,0
"CHARISSA",0,7,0,1,7,0,1,0,1
"CHYNA",1,13,.0714286,.9285714,14,0,1,0,0
"CIARAN",11,0,1,0,11,1,0,1,0
"COLLINS",11,2,.8461539,.1538462,13,1,0,0,0
"COLM",12,0,1,0,12,1,0,1,0
"DACIA",0,11,0,1,11,0,1,0,1
"DANIKA",0,12,0,1,12,0,1,0,1
"DANYA",0,11,0,1,11,0,1,0,1
"DARBY",4,4,.5,.5,8,0,0,0,0
"DASH",10,1,.9090909,.0909091,11,1,0,0,0
"DOMONIQUE",0,12,0,1,12,0,1,0,1
"EAMON",9,0,1,0,9,1,0,1,0
"EDYTA",0,10,0,1,10,0,1,0,1
"ELA",0,11,0,1,11,0,1,0,1
"ELIN",0,10,0,1,10,0,1,0,1
"ELISABETTA",0,11,0,1,11,0,1,0,1
"ELVA",0,12,0,1,12,0,1,0,1
"EMAN",2,11,.1538462,.8461539,13,0,1,0,0
"ERKAN",16,0,1,0,16,1,0,1,0
"ESTELLA",0,17,0,1,17,0,1,0,1
"FLORENCIA",0,9,0,1,9,0,1,0,1
"GARRICK",13,0,1,0,13,1,0,1,0
"GENNY",0,9,0,1,9,0,1,0,1
"GERALDO",9,0,1,0,9,1,0,1,0
"GINAMARIE",0,11,0,1,11,0,1,0,1
"GIULIANA",0,13,0,1,13,0,1,0,1
"GOSIA",0,10,0,1,10,0,1,0,1
"HALLEY",2,4,.3333333,.6666667,6,0,0,0,0
"HANSEL",13,1,.9285714,.0714286,14,1,0,0,0
"HEDY",1,11,.0833333,.9166667,12,0,1,0,0
"HESHAM",9,0,1,0,9,1,0,1,0
"IGGY",10,2,.8333333,.1666667,12,1,0,0,0
"IOANA",0,12,0,1,12,0,1,0,1
"ISABELA",0,15,0,1,15,0,1,0,1
"ISAURA",0,16,0,1,16,0,1,0,1
"IVO",10,0,1,0,10,1,0,1,0
"JOLANTA",0,10,0,1,10,0,1,0,1
"JULIANE",0,11,0,1,11,0,1,0,1
"KAL",8,0,1,0,8,1,0,1,0
"KANE",10,0,1,0,10,1,0,1,0
"KECIA",0,15,0,1,15,0,1,0,1
"KOMAL",1,9,.1,.9,10,0,1,0,0
"KSENIYA",0,15,0,1,15,0,1,0,1
"KWAN",10,2,.8333333,.1666667,12,1,0,0,0
"LACY",3,9,.25,.75,12,0,0,0,0
"LEOR",12,1,.9230769,.0769231,13,1,0,0,0
"LIDA",1,15,.0625,.9375,16,0,1,0,0
"LINH",3,10,.2307692,.7692308,13,0,1,0,0
"LYSSA",0,13,0,1,13,0,1,0,1
"LYUDMILA",0,12,0,1,12,0,1,0,1
"MALKY",0,10,0,1,10,0,1,0,1
"MARIANELA",0,11,0,1,11,0,1,0,1
"MAUDE",0,15,0,1,15,0,1,0,1
"MAYUR",12,0,1,0,12,1,0,1,0
"MIHIR",15,0,1,0,15,1,0,1,0
"MIRELA",0,10,0,1,10,0,1,0,1
"MITZI",0,12,0,1,12,0,1,0,1
"MORIAH",0,8,0,1,8,0,1,0,1
"NASSER",14,0,1,0,14,1,0,1,0
"NEDA",1,12,.0769231,.9230769,13,0,1,0,0
"NICOLETTA",0,9,0,1,9,0,1,0,1
"NIKIA",0,15,0,1,15,0,1,0,1
"NUBIA",0,15,0,1,15,0,1,0,1
"OGUZ",12,0,1,0,12,1,0,1,0
"OLESYA",0,13,0,1,13,0,1,0,1
"OSAMA",11,0,1,0,11,1,0,1,0
"PADDY",12,1,.9230769,.0769231,13,1,0,0,0
"PANOS",15,0,1,0,15,1,0,1,0
"PARK",6,6,.5,.5,12,0,0,0,0
"PATIENCE",0,13,0,1,13,0,1,0,1
"PEI",2,8,.2,.8,10,0,1,0,0
"PETRINA",0,14,0,1,14,0,1,0,1
"QING",5,10,.3333333,.6666667,15,0,0,0,0
"RAFFAELLA",0,14,0,1,14,0,1,0,1
"RAJAT",10,0,1,0,10,1,0,1,0
"RAMIN",12,0,1,0,12,1,0,1,0
"REEM",4,11,.2666667,.7333333,15,0,0,0,0
"REHANA",0,12,0,1,12,0,1,0,1
"ROSHAN",13,1,.9285714,.0714286,14,1,0,0,0
"ROXIE",1,11,.0833333,.9166667,12,0,1,0,0
"SAJID",12,0,1,0,12,1,0,1,0
"SALOMON",15,1,.9375,.0625,16,1,0,0,0
"SAMANTA",0,14,0,1,14,0,1,0,1
"SHAMAR",15,1,.9375,.0625,16,1,0,0,0
"SHAQUAN",8,6,.5714286,.4285714,14,0,0,0,0
"SHAWANA",0,14,0,1,14,0,1,0,1
"SHERICE",0,13,0,1,13,0,1,0,1
"SHERLY",0,8,0,1,8,0,1,0,1
"SHERON",2,14,.125,.875,16,0,1,0,0
"SHIRI",0,13,0,1,13,0,1,0,1
"SILAS",12,0,1,0,12,1,0,1,0
"SONA",0,9,0,1,9,0,1,0,1
"SONI",2,10,.1666667,.8333333,12,0,1,0,0
"SORA",2,6,.25,.75,8,0,0,0,0
"SPIKE",14,0,1,0,14,1,0,1,0
"TAM",6,8,.4285714,.5714286,14,0,0,0,0
"TAVIA",0,10,0,1,10,0,1,0,1
"TAWANDA",0,17,0,1,17,0,1,0,1
"TIFF",0,7,0,1,7,0,1,0,1
"TINO",15,0,1,0,15,1,0,1,0
"TISH",1,10,.0909091,.9090909,11,0,1,0,0
"TOMMIE",7,4,.6363636,.3636364,11,0,0,0,0
"TORREY",7,2,.7777778,.2222222,9,1,0,0,0
"TYEISHA",0,14,0,1,14,0,1,0,1
"UCHE",8,4,.6666667,.3333333,12,0,0,0,0
"UDI",8,1,.8888889,.1111111,9,1,0,0,0
"UZMA",0,13,0,1,13,0,1,0,1
"VANDANA",0,14,0,1,14,0,1,0,1
"VEENA",0,7,0,1,7,0,1,0,1
"WAN",7,6,.5384616,.4615385,13,0,0,0,0
"WASHINGTON",11,2,.8461539,.1538462,13,1,0,0,0
"XI",6,8,.4285714,.5714286,14,0,0,0,0
"YO",10,6,.625,.375,16,0,0,0,0
"YOLANDE",0,17,0,1,17,0,1,0,1
"YOUSEF",12,0,1,0,12,1,0,1,0
"ZHEN",7,6,.5384616,.4615385,13,0,0,0,0
"AC",8,3,.7272727,.2727273,11,0,0,0,0
"ADELAIDE",0,11,0,1,11,0,1,0,1
"AHUVA",0,12,0,1,12,0,1,0,1
"AINSLEY",8,5,.6153846,.3846154,13,0,0,0,0
"AIXA",0,12,0,1,12,0,1,0,1
"AKHIL",9,0,1,0,9,1,0,1,0
"ALEXANDRU",15,0,1,0,15,1,0,1,0
"ALPHA",7,4,.6363636,.3636364,11,0,0,0,0
"ALYSA",0,9,0,1,9,0,1,0,1
"ALYSIA",0,7,0,1,7,0,1,0,1
"AMARILIS",0,14,0,1,14,0,1,0,1
"ANAS",13,1,.9285714,.0714286,14,1,0,0,0
"ANATOLY",8,0,1,0,8,1,0,1,0
"ANTONINO",16,0,1,0,16,1,0,1,0
"ARDEN",4,4,.5,.5,8,0,0,0,0
"ARMIN",15,0,1,0,15,1,0,1,0
"ARSENIO",13,0,1,0,13,1,0,1,0
"AYISHA",0,13,0,1,13,0,1,0,1
"BJÃ–RN",14,0,1,0,14,1,0,1,0
"BUCK",12,1,.9230769,.0769231,13,1,0,0,0
"CAMELIA",0,10,0,1,10,0,1,0,1
"CAMI",0,10,0,1,10,0,1,0,1
"CARLYLE",11,0,1,0,11,1,0,1,0
"CARO",0,12,0,1,12,0,1,0,1
"CLAIR",1,8,.1111111,.8888889,9,0,1,0,0
"DAVIDA",0,15,0,1,15,0,1,0,1
"DEMETRI",12,0,1,0,12,1,0,1,0
"DENEEN",0,13,0,1,13,0,1,0,1
"DIMITRA",0,12,0,1,12,0,1,0,1
"DOMENICA",0,12,0,1,12,0,1,0,1
"EMEKA",15,0,1,0,15,1,0,1,0
"EMILIANO",14,0,1,0,14,1,0,1,0
"ETAN",10,0,1,0,10,1,0,1,0
"EVY",0,7,0,1,7,0,1,0,1
"EZEKIEL",11,0,1,0,11,1,0,1,0
"FAHIM",11,0,1,0,11,1,0,1,0
"FATOU",0,13,0,1,13,0,1,0,1
"FAWN",0,11,0,1,11,0,1,0,1
"FILOMENA",0,17,0,1,17,0,1,0,1
"FINN",9,1,.9,.1,10,1,0,0,0
"FREDRIK",11,0,1,0,11,1,0,1,0
"GABOR",12,0,1,0,12,1,0,1,0
"GASTON",10,0,1,0,10,1,0,1,0
"GERTRUDE",1,16,.0588235,.9411765,17,0,1,0,0
"GRAIG",11,0,1,0,11,1,0,1,0
"GRAZIELLA",0,7,0,1,7,0,1,0,1
"GREGOR",11,0,1,0,11,1,0,1,0
"GUO",15,3,.8333333,.1666667,18,1,0,0,0
"HEE",7,7,.5,.5,14,0,0,0,0
"HERVE",11,0,1,0,11,1,0,1,0
"IAM",9,3,.75,.25,12,0,0,0,0
"ITA",1,10,.0909091,.9090909,11,0,1,0,0
"JALISA",0,12,0,1,12,0,1,0,1
"JANEE",0,13,0,1,13,0,1,0,1
"JENNINE",0,12,0,1,12,0,1,0,1
"JULISA",0,13,0,1,13,0,1,0,1
"KAAN",15,0,1,0,15,1,0,1,0
"KARY",2,10,.1666667,.8333333,12,0,1,0,0
"KATEY",0,9,0,1,9,0,1,0,1
"KAYLEE",0,15,0,1,15,0,1,0,1
"KAYLEIGH",0,9,0,1,9,0,1,0,1
"KESTON",12,0,1,0,12,1,0,1,0
"KETTY",0,11,0,1,11,0,1,0,1
"LISHA",0,15,0,1,15,0,1,0,1
"LUDOVIC",8,0,1,0,8,1,0,1,0
"LUIZA",0,9,0,1,9,0,1,0,1
"MADONNA",0,11,0,1,11,0,1,0,1
"MAIKO",1,5,.1666667,.8333333,6,0,1,0,0
"MAISHA",0,8,0,1,8,0,1,0,1
"MANDA",0,7,0,1,7,0,1,0,1
"MARILOU",0,14,0,1,14,0,1,0,1
"MATILDE",0,15,0,1,15,0,1,0,1
"MICHELINE",0,10,0,1,10,0,1,0,1
"MILI",2,10,.1666667,.8333333,12,0,1,0,0
"MISCHA",3,9,.25,.75,12,0,0,0,0
"MISTA",11,0,1,0,11,1,0,1,0
"MITCHEL",16,1,.9411765,.0588235,17,1,0,0,0
"MONI",2,10,.1666667,.8333333,12,0,1,0,0
"MONIFA",0,9,0,1,9,0,1,0,1
"NABILA",0,10,0,1,10,0,1,0,1
"NAEEM",12,0,1,0,12,1,0,1,0
"NANDA",6,5,.5454546,.4545455,11,0,0,0,0
"NAY",3,7,.3,.7,10,0,0,0,0
"NETA",1,13,.0714286,.9285714,14,0,1,0,0
"NIKOLAOS",12,0,1,0,12,1,0,1,0
"NIRAJ",13,0,1,0,13,1,0,1,0
"NITZA",0,13,0,1,13,0,1,0,1
"OSKAR",11,0,1,0,11,1,0,1,0
"PREM",10,2,.8333333,.1666667,12,1,0,0,0
"RABBI",16,0,1,0,16,1,0,1,0
"RADHA",1,8,.1111111,.8888889,9,0,1,0,0
"RAH",13,2,.8666667,.1333333,15,1,0,0,0
"RAIZY",0,10,0,1,10,0,1,0,1
"RAWLE",17,0,1,0,17,1,0,1,0
"REIKO",0,11,0,1,11,0,1,0,1
"RHYS",10,0,1,0,10,1,0,1,0
"RIZWAN",15,0,1,0,15,1,0,1,0
"ROCHEL",0,10,0,1,10,0,1,0,1
"ROSALINDA",0,13,0,1,13,0,1,0,1
"ROSEANNA",0,11,0,1,11,0,1,0,1
"ROSSY",0,10,0,1,10,0,1,0,1
"ROWAN",7,2,.7777778,.2222222,9,1,0,0,0
"RYO",17,0,1,0,17,1,0,1,0
"SAEED",11,0,1,0,11,1,0,1,0
"SALOME",0,8,0,1,8,0,1,0,1
"SAMINA",0,7,0,1,7,0,1,0,1
"SANGEETA",0,10,0,1,10,0,1,0,1
"SAVITA",0,9,0,1,9,0,1,0,1
"SCOTTIE",9,1,.9,.1,10,1,0,0,0
"SERA",1,11,.0833333,.9166667,12,0,1,0,0
"SHAKIA",0,17,0,1,17,0,1,0,1
"SHAMA",1,7,.125,.875,8,0,1,0,0
"SHAREEN",0,13,0,1,13,0,1,0,1
"SHARONE",7,6,.5384616,.4615385,13,0,0,0,0
"SHASHI",7,6,.5384616,.4615385,13,0,0,0,0
"SHELLI",0,11,0,1,11,0,1,0,1
"STEPHY",0,7,0,1,7,0,1,0,1
"SVETA",0,12,0,1,12,0,1,0,1
"SY",12,4,.75,.25,16,0,0,0,0
"SYLVAIN",11,0,1,0,11,1,0,1,0
"TAIWO",7,7,.5,.5,14,0,0,0,0
"TAKESHI",14,0,1,0,14,1,0,1,0
"TERRIE",0,14,0,1,14,0,1,0,1
"TEVIN",12,0,1,0,12,1,0,1,0
"TOI",0,12,0,1,12,0,1,0,1
"TOMO",12,3,.8,.2,15,1,0,0,0
"TUSHAR",16,0,1,0,16,1,0,1,0
"TYNISHA",0,17,0,1,17,0,1,0,1
"VELMA",0,18,0,1,18,0,1,0,1
"VESNA",0,9,0,1,9,0,1,0,1
"VINEET",10,0,1,0,10,1,0,1,0
"YASHIRA",0,16,0,1,16,0,1,0,1
"YASIR",12,0,1,0,12,1,0,1,0
"YOGESH",12,0,1,0,12,1,0,1,0
"YUSUKE",13,0,1,0,13,1,0,1,0
"ZAID",15,0,1,0,15,1,0,1,0
"ZAKIYA",0,12,0,1,12,0,1,0,1
"ZORAN",12,0,1,0,12,1,0,1,0
"TRUE",9,5,.6428571,.3571429,14,0,0,0,0
"ABHINAV",14,0,1,0,14,1,0,1,0
"ADEM",17,0,1,0,17,1,0,1,0
"AIESHA",0,13,0,1,13,0,1,0,1
"ALBAN",9,0,1,0,9,1,0,1,0
"ALBINA",0,14,0,1,14,0,1,0,1
"ALEK",7,0,1,0,7,1,0,1,0
"ALISE",0,16,0,1,16,0,1,0,1
"AMANI",1,8,.1111111,.8888889,9,0,1,0,0
"AMARIS",0,8,0,1,8,0,1,0,1
"ANATOLIY",10,0,1,0,10,1,0,1,0
"ANETTE",0,12,0,1,12,0,1,0,1
"ANUP",10,0,1,0,10,1,0,1,0
"AOIFE",0,10,0,1,10,0,1,0,1
"ARIAN",5,2,.7142857,.2857143,7,0,0,0,0
"ARIC",9,0,1,0,9,1,0,1,0
"ARKADY",14,0,1,0,14,1,0,1,0
"ASYA",0,13,0,1,13,0,1,0,1
"AVANI",0,11,0,1,11,0,1,0,1
"AYHAN",10,0,1,0,10,1,0,1,0
"AZRA",0,12,0,1,12,0,1,0,1
"BABA",12,2,.8571429,.1428571,14,1,0,0,0
"BELEN",1,10,.0909091,.9090909,11,0,1,0,0
"BISHOP",14,0,1,0,14,1,0,1,0
"CARLINA",0,11,0,1,11,0,1,0,1
"CARON",1,10,.0909091,.9090909,11,0,1,0,0
"CASS",3,6,.3333333,.6666667,9,0,0,0,0
"CHANELL",0,8,0,1,8,0,1,0,1
"CHICO",13,0,1,0,13,1,0,1,0
"CICI",1,9,.1,.9,10,0,1,0,0
"CISCO",14,1,.9333333,.0666667,15,1,0,0,0
"COSTA",12,1,.9230769,.0769231,13,1,0,0,0
"CRISTOBAL",10,0,1,0,10,1,0,1,0
"DAPHNEY",0,7,0,1,7,0,1,0,1
"DAYNE",10,1,.9090909,.0909091,11,1,0,0,0
"DEEPTI",0,8,0,1,8,0,1,0,1
"DERWIN",15,0,1,0,15,1,0,1,0
"DONI",12,3,.8,.2,15,1,0,0,0
"DWAIN",12,0,1,0,12,1,0,1,0
"EBONIE",0,10,0,1,10,0,1,0,1
"EDSON",15,0,1,0,15,1,0,1,0
"EDY",6,5,.5454546,.4545455,11,0,0,0,0
"ELVIA",0,9,0,1,9,0,1,0,1
"ENEIDA",0,15,0,1,15,0,1,0,1
"EREN",12,1,.9230769,.0769231,13,1,0,0,0
"ERNST",14,0,1,0,14,1,0,1,0
"ERYN",1,9,.1,.9,10,0,1,0,0
"ETI",1,9,.1,.9,10,0,1,0,0
"EVANGELOS",8,0,1,0,8,1,0,1,0
"EVITA",0,10,0,1,10,0,1,0,1
"FARUK",14,0,1,0,14,1,0,1,0
"FAÃèZA",0,8,0,1,8,0,1,0,1
"FELECIA",0,14,0,1,14,0,1,0,1
"FELICITY",0,11,0,1,11,0,1,0,1
"FIFI",0,7,0,1,7,0,1,0,1
"FOSTER",10,1,.9090909,.0909091,11,1,0,0,0
"GENARO",16,0,1,0,16,1,0,1,0
"GO",9,2,.8181818,.1818182,11,1,0,0,0
"GUILHERME",14,0,1,0,14,1,0,1,0
"HALA",0,10,0,1,10,0,1,0,1
"HASANI",14,0,1,0,14,1,0,1,0
"HELLEN",1,11,.0833333,.9166667,12,0,1,0,0
"HICHAM",16,0,1,0,16,1,0,1,0
"HIMANSHU",12,0,1,0,12,1,0,1,0
"ILARIA",0,12,0,1,12,0,1,0,1
"ITAI",9,1,.9,.1,10,1,0,0,0
"JAIR",14,0,1,0,14,1,0,1,0
"JANI",4,3,.5714286,.4285714,7,0,0,0,0
"JONNA",0,9,0,1,9,0,1,0,1
"JOVANA",0,5,0,1,5,0,1,0,1
"KAMEL",14,1,.9333333,.0666667,15,1,0,0,0
"KANDICE",0,10,0,1,10,0,1,0,1
"KENDRICK",12,0,1,0,12,1,0,1,0
"KONSTANTINOS",9,0,1,0,9,1,0,1,0
"KOURTNEY",0,10,0,1,10,0,1,0,1
"KURTIS",15,0,1,0,15,1,0,1,0
"LAINE",0,10,0,1,10,0,1,0,1
"LAKSHMI",0,9,0,1,9,0,1,0,1
"LENKA",0,12,0,1,12,0,1,0,1
"LEVY",9,3,.75,.25,12,0,0,0,0
"LEXY",1,5,.1666667,.8333333,6,0,1,0,0
"LIRAN",9,0,1,0,9,1,0,1,0
"LIS",0,9,0,1,9,0,1,0,1
"LIVE",9,6,.6,.4,15,0,0,0,0
"MARIS",0,7,0,1,7,0,1,0,1
"MARLEN",5,8,.3846154,.6153846,13,0,0,0,0
"MARWAN",13,0,1,0,13,1,0,1,0
"MATAN",10,0,1,0,10,1,0,1,0
"MATTIA",10,4,.7142857,.2857143,14,0,0,0,0
"MERLIN",12,5,.7058824,.2941177,17,0,0,0,0
"MIREILLE",0,12,0,1,12,0,1,0,1
"MIRELLA",0,7,0,1,7,0,1,0,1
"MIZ",1,13,.0714286,.9285714,14,0,1,0,0
"MOHAN",12,0,1,0,12,1,0,1,0
"MOSTAFA",12,0,1,0,12,1,0,1,0
"MYLENE",0,12,0,1,12,0,1,0,1
"NAPOLEON",12,0,1,0,12,1,0,1,0
"NATASCHA",0,9,0,1,9,0,1,0,1
"NAZIA",0,12,0,1,12,0,1,0,1
"NEISHA",0,11,0,1,11,0,1,0,1
"ORA",0,9,0,1,9,0,1,0,1
"ORNA",0,11,0,1,11,0,1,0,1
"OZAN",11,1,.9166667,.0833333,12,1,0,0,0
"PANAGIOTIS",12,0,1,0,12,1,0,1,0
"PENINA",0,6,0,1,6,0,1,0,1
"QUINTON",11,0,1,0,11,1,0,1,0
"RAMAN",12,2,.8571429,.1428571,14,1,0,0,0
"RASHMI",0,9,0,1,9,0,1,0,1
"RAYAN",9,3,.75,.25,12,0,0,0,0
"RENNY",10,2,.8333333,.1666667,12,1,0,0,0
"REYES",10,5,.6666667,.3333333,15,0,0,0,0
"ROXANN",0,14,0,1,14,0,1,0,1
"RUPA",0,8,0,1,8,0,1,0,1
"SADAF",1,9,.1,.9,10,0,1,0,0
"SALEEM",11,0,1,0,11,1,0,1,0
"SANDEE",0,13,0,1,13,0,1,0,1
"SELWYN",13,0,1,0,13,1,0,1,0
"SEMIH",15,0,1,0,15,1,0,1,0
"SHAD",9,0,1,0,9,1,0,1,0
"SHADI",6,3,.6666667,.3333333,9,0,0,0,0
"SHAE",2,10,.1666667,.8333333,12,0,1,0,0
"SHANDA",0,12,0,1,12,0,1,0,1
"SHAUNTE",0,11,0,1,11,0,1,0,1
"SHENIQUA",0,14,0,1,14,0,1,0,1
"SIM",8,3,.7272727,.2727273,11,0,0,0,0
"SOFIE",0,16,0,1,16,0,1,0,1
"SOOJIN",0,7,0,1,7,0,1,0,1
"STAS",10,0,1,0,10,1,0,1,0
"STORM",11,5,.6875,.3125,16,0,0,0,0
"SUJATA",0,6,0,1,6,0,1,0,1
"SUPA",9,1,.9,.1,10,1,0,0,0
"SUSY",0,11,0,1,11,0,1,0,1
"TAHA",12,0,1,0,12,1,0,1,0
"TAMEIKA",0,10,0,1,10,0,1,0,1
"TARAH",1,8,.1111111,.8888889,9,0,1,0,0
"TASHANA",0,11,0,1,11,0,1,0,1
"TAUREAN",14,0,1,0,14,1,0,1,0
"TREVON",13,1,.9285714,.0714286,14,1,0,0,0
"UMA",0,11,0,1,11,0,1,0,1
"USHA",1,10,.0909091,.9090909,11,0,1,0,0
"VIKI",0,9,0,1,9,0,1,0,1
"VIV",0,8,0,1,8,0,1,0,1
"VLADISLAV",14,0,1,0,14,1,0,1,0
"WARNER",12,1,.9230769,.0769231,13,1,0,0,0
"WILBERT",15,0,1,0,15,1,0,1,0
"ZITA",0,10,0,1,10,0,1,0,1
"ZUBAIR",15,0,1,0,15,1,0,1,0
"AFIYA",0,11,0,1,11,0,1,0,1
"ALEXANDROS",12,0,1,0,12,1,0,1,0
"ALKA",1,8,.1111111,.8888889,9,0,1,0,0
"ALONDRA",0,12,0,1,12,0,1,0,1
"AMER",9,0,1,0,9,1,0,1,0
"ANAM",1,10,.0909091,.9090909,11,0,1,0,0
"ARMANI",9,3,.75,.25,12,0,0,0,0
"ARMEN",12,1,.9230769,.0769231,13,1,0,0,0
"ARSEN",11,0,1,0,11,1,0,1,0
"ATIBA",14,1,.9333333,.0666667,15,1,0,0,0
"AYDIN",8,0,1,0,8,1,0,1,0
"BANU",1,6,.1428571,.8571429,7,0,1,0,0
"BAR",8,2,.8,.2,10,1,0,0,0
"BATSHEVA",0,9,0,1,9,0,1,0,1
"BRANDIE",0,9,0,1,9,0,1,0,1
"BURCU",0,10,0,1,10,0,1,0,1
"CARLIE",2,4,.3333333,.6666667,6,0,0,0,0
"CASPER",11,4,.7333333,.2666667,15,0,0,0,0
"CLARKE",8,2,.8,.2,10,1,0,0,0
"CORDELIA",0,7,0,1,7,0,1,0,1
"CRISTA",0,9,0,1,9,0,1,0,1
"CRISTHIAN",11,0,1,0,11,1,0,1,0
"CRISTIANO",13,0,1,0,13,1,0,1,0
"DAFNA",0,4,0,1,4,0,1,0,1
"DAINA",0,7,0,1,7,0,1,0,1
"DAMANI",11,0,1,0,11,1,0,1,0
"DARLINE",0,15,0,1,15,0,1,0,1
"DARON",12,0,1,0,12,1,0,1,0
"DAVI",7,4,.6363636,.3636364,11,0,0,0,0
"DES",3,6,.3333333,.6666667,9,0,0,0,0
"DORY",3,10,.2307692,.7692308,13,0,1,0,0
"DYAN",0,11,0,1,11,0,1,0,1
"EBRU",0,14,0,1,14,0,1,0,1
"EDA",0,9,0,1,9,0,1,0,1
"EDI",9,3,.75,.25,12,0,0,0,0
"EFREN",12,0,1,0,12,1,0,1,0
"EVI",0,8,0,1,8,0,1,0,1
"EVONNE",0,12,0,1,12,0,1,0,1
"FELISHA",0,12,0,1,12,0,1,0,1
"GEORGI",11,1,.9166667,.0833333,12,1,0,0,0
"GERALYN",0,14,0,1,14,0,1,0,1
"GIANFRANCO",12,0,1,0,12,1,0,1,0
"HADAS",0,6,0,1,6,0,1,0,1
"HEMANT",10,0,1,0,10,1,0,1,0
"HERBIE",10,1,.9090909,.0909091,11,1,0,0,0
"HINDY",0,14,0,1,14,0,1,0,1
"HIROSHI",8,0,1,0,8,1,0,1,0
"HOLLI",0,5,0,1,5,0,1,0,1
"HOMER",14,1,.9333333,.0666667,15,1,0,0,0
"HUANG",6,4,.6,.4,10,0,0,0,0
"IDALIA",0,14,0,1,14,0,1,0,1
"IRAIDA",0,12,0,1,12,0,1,0,1
"IVORY",5,11,.3125,.6875,16,0,0,0,0
"JACI",0,10,0,1,10,0,1,0,1
"JAEL",1,10,.0909091,.9090909,11,0,1,0,0
"JANEY",0,8,0,1,8,0,1,0,1
"JANUARY",1,8,.1111111,.8888889,9,0,1,0,0
"JAQUELINE",0,11,0,1,11,0,1,0,1
"JASEN",13,0,1,0,13,1,0,1,0
"JAVI",8,1,.8888889,.1111111,9,1,0,0,0
"JAYMIE",1,7,.125,.875,8,0,1,0,0
"JIHAN",1,8,.1111111,.8888889,9,0,1,0,0
"JONA",3,5,.375,.625,8,0,0,0,0
"JOO",3,10,.2307692,.7692308,13,0,1,0,0
"JUNAID",13,0,1,0,13,1,0,1,0
"KACIE",0,8,0,1,8,0,1,0,1
"KALEB",11,0,1,0,11,1,0,1,0
"KAMAU",14,0,1,0,14,1,0,1,0
"KE",4,3,.5714286,.4285714,7,0,0,0,0
"KELLEN",8,3,.7272727,.2727273,11,0,0,0,0
"KEREM",12,0,1,0,12,1,0,1,0
"KERIN",2,8,.2,.8,10,0,1,0,0
"KHRIS",11,2,.8461539,.1538462,13,1,0,0,0
"KHURRAM",12,0,1,0,12,1,0,1,0
"KIRSTY",0,12,0,1,12,0,1,0,1
"KLAUS",9,0,1,0,9,1,0,1,0
"KORAY",10,0,1,0,10,1,0,1,0
"KWABENA",16,0,1,0,16,1,0,1,0
"LAI",4,4,.5,.5,8,0,0,0,0
"LASZLO",16,0,1,0,16,1,0,1,0
"LEANA",0,4,0,1,4,0,1,0,1
"LEDA",0,8,0,1,8,0,1,0,1
"LEELA",0,8,0,1,8,0,1,0,1
"LENI",2,7,.2222222,.7777778,9,0,1,0,0
"LENNIE",12,0,1,0,12,1,0,1,0
"LINUS",13,0,1,0,13,1,0,1,0
"LONI",0,9,0,1,9,0,1,0,1
"LORRI",0,13,0,1,13,0,1,0,1
"LUANA",0,12,0,1,12,0,1,0,1
"LUCI",1,8,.1111111,.8888889,9,0,1,0,0
"MADELIN",0,12,0,1,12,0,1,0,1
"MAGGY",0,12,0,1,12,0,1,0,1
"MALIN",2,11,.1538462,.8461539,13,0,1,0,0
"MANOLO",11,0,1,0,11,1,0,1,0
"MARCIO",13,0,1,0,13,1,0,1,0
"MARLY",1,10,.0909091,.9090909,11,0,1,0,0
"MARYJANE",0,14,0,1,14,0,1,0,1
"MARYROSE",0,9,0,1,9,0,1,0,1
"MAYANK",16,0,1,0,16,1,0,1,0
"MELLISSA",0,11,0,1,11,0,1,0,1
"MENDEL",11,0,1,0,11,1,0,1,0
"MEYER",9,0,1,0,9,1,0,1,0
"MICHIKO",0,12,0,1,12,0,1,0,1
"MITESH",14,1,.9333333,.0666667,15,1,0,0,0
"MOHSIN",13,0,1,0,13,1,0,1,0
"NADIR",11,0,1,0,11,1,0,1,0
"NAMI",0,8,0,1,8,0,1,0,1
"NAVA",0,7,0,1,7,0,1,0,1
"NEILL",10,0,1,0,10,1,0,1,0
"NICHOLA",1,10,.0909091,.9090909,11,0,1,0,0
"NILE",5,2,.7142857,.2857143,7,0,0,0,0
"NUR",4,8,.3333333,.6666667,12,0,0,0,0
"ORHAN",10,0,1,0,10,1,0,1,0
"ORION",11,1,.9166667,.0833333,12,1,0,0,0
"PATEL",11,2,.8461539,.1538462,13,1,0,0,0
"PAVAN",11,0,1,0,11,1,0,1,0
"PELIN",0,7,0,1,7,0,1,0,1
"PERI",1,8,.1111111,.8888889,9,0,1,0,0
"PHILIPPA",0,12,0,1,12,0,1,0,1
"QUE",10,5,.6666667,.3333333,15,0,0,0,0
"RACHID",12,0,1,0,12,1,0,1,0
"RALPHY",13,0,1,0,13,1,0,1,0
"RASHEEM",11,0,1,0,11,1,0,1,0
"REAGAN",3,6,.3333333,.6666667,9,0,0,0,0
"REKHA",0,8,0,1,8,0,1,0,1
"REVA",0,10,0,1,10,0,1,0,1
"REYNOLD",14,0,1,0,14,1,0,1,0
"RHONA",0,16,0,1,16,0,1,0,1
"RICHA",0,10,0,1,10,0,1,0,1
"RICKIE",5,4,.5555556,.4444444,9,0,0,0,0
"RIFAT",6,2,.75,.25,8,0,0,0,0
"RIK",13,0,1,0,13,1,0,1,0
"RIMMA",0,10,0,1,10,0,1,0,1
"RUDI",8,2,.8,.2,10,1,0,0,0
"SANIA",0,11,0,1,11,0,1,0,1
"SEYMOUR",15,1,.9375,.0625,16,1,0,0,0
"SHANEL",1,11,.0833333,.9166667,12,0,1,0,0
"SHANISE",0,17,0,1,17,0,1,0,1
"SHARMAINE",0,13,0,1,13,0,1,0,1
"SHELIA",0,12,0,1,12,0,1,0,1
"SHIFRA",0,8,0,1,8,0,1,0,1
"SHIRAN",2,5,.2857143,.7142857,7,0,0,0,0
"SHOMARI",14,0,1,0,14,1,0,1,0
"SIGAL",0,11,0,1,11,0,1,0,1
"SINA",8,6,.5714286,.4285714,14,0,0,0,0
"SMILEY",5,10,.3333333,.6666667,15,0,0,0,0
"SMITA",0,10,0,1,10,0,1,0,1
"SOCRATES",11,0,1,0,11,1,0,1,0
"SOFIYA",0,9,0,1,9,0,1,0,1
"SOHAIL",12,0,1,0,12,1,0,1,0
"SONU",11,3,.7857143,.2142857,14,1,0,0,0
"SYMONE",0,8,0,1,8,0,1,0,1
"TATJANA",0,12,0,1,12,0,1,0,1
"TESHA",0,12,0,1,12,0,1,0,1
"TITA",0,15,0,1,15,0,1,0,1
"TOD",16,0,1,0,16,1,0,1,0
"TONI-ANN",0,9,0,1,9,0,1,0,1
"TOPHER",10,0,1,0,10,1,0,1,0
"UMBERTO",12,0,1,0,12,1,0,1,0
"VEDA",0,9,0,1,9,0,1,0,1
"VERN",9,4,.6923077,.3076923,13,0,0,0,0
"VIVA",2,11,.1538462,.8461539,13,0,1,0,0
"VLADA",0,9,0,1,9,0,1,0,1
"WILLOW",0,8,0,1,8,0,1,0,1
"XING",8,5,.6153846,.3846154,13,0,0,0,0
"YANNA",0,8,0,1,8,0,1,0,1
"YARÃç",0,8,0,1,8,0,1,0,1
"YEMI",5,5,.5,.5,10,0,0,0,0
"YOHANNA",0,12,0,1,12,0,1,0,1
"YOMAIRA",0,12,0,1,12,0,1,0,1
"YUE",5,6,.4545455,.5454546,11,0,0,0,0
"ZIAD",9,0,1,0,9,1,0,1,0
"ZIGGY",14,0,1,0,14,1,0,1,0
"AAMIR",11,0,1,0,11,1,0,1,0
"ABID",11,0,1,0,11,1,0,1,0
"AIKO",1,8,.1111111,.8888889,9,0,1,0,0
"AKBAR",11,0,1,0,11,1,0,1,0
"ALEKSANDER",15,0,1,0,15,1,0,1,0
"ALESSIO",13,0,1,0,13,1,0,1,0
"ALONSO",10,0,1,0,10,1,0,1,0
"ALPHONSE",14,0,1,0,14,1,0,1,0
"AMARA",3,8,.2727273,.7272727,11,0,0,0,0
"AMBROSE",12,0,1,0,12,1,0,1,0
"AMISH",12,0,1,0,12,1,0,1,0
"AMPARO",0,11,0,1,11,0,1,0,1
"ANDRAE",14,0,1,0,14,1,0,1,0
"ANDREE",1,7,.125,.875,8,0,1,0,0
"ANG",3,4,.4285714,.5714286,7,0,0,0,0
"ARCADE",7,6,.5384616,.4615385,13,0,0,0,0
"ARLYN",0,10,0,1,10,0,1,0,1
"ARNEL",11,1,.9166667,.0833333,12,1,0,0,0
"ARSLAN",13,0,1,0,13,1,0,1,0
"ARTI",0,12,0,1,12,0,1,0,1
"ASHLY",0,11,0,1,11,0,1,0,1
"AUREA",0,12,0,1,12,0,1,0,1
"AVALON",1,11,.0833333,.9166667,12,0,1,0,0
"AVIV",6,0,1,0,6,1,0,1,0
"AYLA",0,11,0,1,11,0,1,0,1
"BELL",3,6,.3333333,.6666667,9,0,0,0,0
"BERNADINE",0,14,0,1,14,0,1,0,1
"BERTRAND",12,1,.9230769,.0769231,13,1,0,0,0
"BIRGIT",0,12,0,1,12,0,1,0,1
"BLAIRE",0,7,0,1,7,0,1,0,1
"BRYON",10,0,1,0,10,1,0,1,0
"BÃœLENT",13,0,1,0,13,1,0,1,0
"CARLEEN",0,8,0,1,8,0,1,0,1
"CESARE",13,0,1,0,13,1,0,1,0
"CHANTELL",0,9,0,1,9,0,1,0,1
"CIERRA",0,10,0,1,10,0,1,0,1
"CLEOPATRA",0,11,0,1,11,0,1,0,1
"COBY",11,1,.9166667,.0833333,12,1,0,0,0
"CORNELL",11,1,.9166667,.0833333,12,1,0,0,0
"COURTENAY",1,6,.1428571,.8571429,7,0,1,0,0
"DANYELLE",0,14,0,1,14,0,1,0,1
"DAWNMARIE",0,9,0,1,9,0,1,0,1
"DAYSI",0,13,0,1,13,0,1,0,1
"DENISHA",0,12,0,1,12,0,1,0,1
"DENNISE",0,10,0,1,10,0,1,0,1
"DENVER",14,0,1,0,14,1,0,1,0
"DERON",10,0,1,0,10,1,0,1,0
"DERYA",1,7,.125,.875,8,0,1,0,0
"DESHAUN",11,0,1,0,11,1,0,1,0
"DEVORA",0,7,0,1,7,0,1,0,1
"DEYANIRA",0,10,0,1,10,0,1,0,1
"DHRUV",9,0,1,0,9,1,0,1,0
"DIA",3,7,.3,.7,10,0,0,0,0
"DIMPLE",0,10,0,1,10,0,1,0,1
"DIXIE",0,13,0,1,13,0,1,0,1
"DIXON",11,3,.7857143,.2142857,14,1,0,0,0
"DONATO",11,0,1,0,11,1,0,1,0
"ELISEO",8,0,1,0,8,1,0,1,0
"EMANUELA",0,13,0,1,13,0,1,0,1
"EMORY",9,2,.8181818,.1818182,11,1,0,0,0
"ENOCH",13,0,1,0,13,1,0,1,0
"EOIN",5,0,1,0,5,1,0,1,0
"ERHAN",8,0,1,0,8,1,0,1,0
"EVENS",14,0,1,0,14,1,0,1,0
"FELICITA",0,12,0,1,12,0,1,0,1
"FILIZ",0,10,0,1,10,0,1,0,1
"FITZROY",15,0,1,0,15,1,0,1,0
"FLETCHER",8,1,.8888889,.1111111,9,1,0,0,0
"GENO",14,0,1,0,14,1,0,1,0
"GIZEM",0,7,0,1,7,0,1,0,1
"GRADY",7,0,1,0,7,1,0,1,0
"HALIL",10,0,1,0,10,1,0,1,0
"HARISH",7,0,1,0,7,1,0,1,0
"HARUN",8,0,1,0,8,1,0,1,0
"HASHIM",12,0,1,0,12,1,0,1,0
"HORACIO",13,0,1,0,13,1,0,1,0
"IGAL",9,0,1,0,9,1,0,1,0
"ILSE",0,13,0,1,13,0,1,0,1
"IMTIAZ",9,0,1,0,9,1,0,1,0
"IRV",13,0,1,0,13,1,0,1,0
"JACE",11,0,1,0,11,1,0,1,0
"JACQUE",4,8,.3333333,.6666667,12,0,0,0,0
"JALISSA",0,10,0,1,10,0,1,0,1
"JAMEEL",11,2,.8461539,.1538462,13,1,0,0,0
"JARETT",7,0,1,0,7,1,0,1,0
"JAYDEN",9,1,.9,.1,10,1,0,0,0
"JEFFRY",9,0,1,0,9,1,0,1,0
"JEMAL",10,0,1,0,10,1,0,1,0
"JENEE",0,8,0,1,8,0,1,0,1
"JENICE",0,15,0,1,15,0,1,0,1
"JENNIFFER",0,12,0,1,12,0,1,0,1
"JERALD",12,0,1,0,12,1,0,1,0
"JERRI",1,9,.1,.9,10,0,1,0,0
"JIGAR",10,0,1,0,10,1,0,1,0
"JORDYN",2,6,.25,.75,8,0,0,0,0
"JULIANN",2,10,.1666667,.8333333,12,0,1,0,0
"KACY",6,7,.4615385,.5384616,13,0,0,0,0
"KADY",0,11,0,1,11,0,1,0,1
"KAROLINE",0,9,0,1,9,0,1,0,1
"KENTON",5,0,1,0,5,1,0,1,0
"KEYSHA",0,11,0,1,11,0,1,0,1
"KFIR",11,0,1,0,11,1,0,1,0
"KIMMIE",0,8,0,1,8,0,1,0,1
"KRYSTEN",0,7,0,1,7,0,1,0,1
"LEESA",0,7,0,1,7,0,1,0,1
"LEIGHANN",0,7,0,1,7,0,1,0,1
"LEOPOLD",10,1,.9090909,.0909091,11,1,0,0,0
"LIYA",0,7,0,1,7,0,1,0,1
"LUPITA",0,11,0,1,11,0,1,0,1
"MAAYAN",0,11,0,1,11,0,1,0,1
"MACY",1,12,.0769231,.9230769,13,0,1,0,0
"MADINA",1,11,.0833333,.9166667,12,0,1,0,0
"MAKOTO",7,0,1,0,7,1,0,1,0
"MAUD",0,8,0,1,8,0,1,0,1
"MAXIMILIANO",11,0,1,0,11,1,0,1,0
"MELANIA",0,8,0,1,8,0,1,0,1
"MELYSSA",0,11,0,1,11,0,1,0,1
"MERRITT",3,1,.75,.25,4,0,0,0,0
"METIN",11,0,1,0,11,1,0,1,0
"MICH",2,5,.2857143,.7142857,7,0,0,0,0
"MICHELANGELO",11,0,1,0,11,1,0,1,0
"MIKO",7,3,.7,.3,10,0,0,0,0
"MOMO",5,6,.4545455,.5454546,11,0,0,0,0
"MOTI",9,0,1,0,9,1,0,1,0
"MOTTY",4,1,.8,.2,5,1,0,0,0
"MYKE",9,1,.9,.1,10,1,0,0,0
"NATISHA",0,12,0,1,12,0,1,0,1
"NAZMUL",12,0,1,0,12,1,0,1,0
"NEHAL",6,4,.6,.4,10,0,0,0,0
"NIKISHA",0,9,0,1,9,0,1,0,1
"NIKOLAY",10,0,1,0,10,1,0,1,0
"NORM",10,0,1,0,10,1,0,1,0
"ODALYS",0,9,0,1,9,0,1,0,1
"OFIR",7,1,.875,.125,8,1,0,0,0
"OLYMPIA",0,11,0,1,11,0,1,0,1
"PALLAVI",0,8,0,1,8,0,1,0,1
"PATRIK",14,0,1,0,14,1,0,1,0
"PEBBLES",0,10,0,1,10,0,1,0,1
"PEMA",4,8,.3333333,.6666667,12,0,0,0,0
"PINAR",0,8,0,1,8,0,1,0,1
"PURVI",0,6,0,1,6,0,1,0,1
"QUINTIN",14,0,1,0,14,1,0,1,0
"RA",10,3,.7692308,.2307692,13,1,0,0,0
"RACHEAL",0,13,0,1,13,0,1,0,1
"RAGHAV",12,0,1,0,12,1,0,1,0
"RAHMEL",13,0,1,0,13,1,0,1,0
"RANDELL",13,0,1,0,13,1,0,1,0
"RAVIN",8,1,.8888889,.1111111,9,1,0,0,0
"RAVIT",0,7,0,1,7,0,1,0,1
"RAYON",10,0,1,0,10,1,0,1,0
"REA",2,9,.1818182,.8181818,11,0,1,0,0
"REG",9,2,.8181818,.1818182,11,1,0,0,0
"REGIS",13,0,1,0,13,1,0,1,0
"RIKA",1,6,.1428571,.8571429,7,0,1,0,0
"RONG",7,3,.7,.3,10,0,0,0,0
"RUBI",3,8,.2727273,.7272727,11,0,0,0,0
"RYOKO",0,9,0,1,9,0,1,0,1
"SALIH",11,0,1,0,11,1,0,1,0
"SALIMA",0,8,0,1,8,0,1,0,1
"SANAA",0,5,0,1,5,0,1,0,1
"SANAM",1,5,.1666667,.8333333,6,0,1,0,0
"SANDER",11,0,1,0,11,1,0,1,0
"SANDIE",0,5,0,1,5,0,1,0,1
"SANELA",0,12,0,1,12,0,1,0,1
"SANYA",2,9,.1818182,.8181818,11,0,1,0,0
"SAPPHIRE",0,11,0,1,11,0,1,0,1
"SEB",12,0,1,0,12,1,0,1,0
"SELIM",8,0,1,0,8,1,0,1,0
"SHARMILA",0,8,0,1,8,0,1,0,1
"SHAUL",8,0,1,0,8,1,0,1,0
"SHONA",0,6,0,1,6,0,1,0,1
"SIN",5,5,.5,.5,10,0,0,0,0
"SIRI",0,7,0,1,7,0,1,0,1
"SITA",1,11,.0833333,.9166667,12,0,1,0,0
"SLOAN",5,3,.625,.375,8,0,0,0,0
"SUHAIL",6,4,.6,.4,10,0,0,0,0
"SULTANA",1,9,.1,.9,10,0,1,0,0
"SUMEET",11,0,1,0,11,1,0,1,0
"SUNDEEP",10,0,1,0,10,1,0,1,0
"SUSI",0,8,0,1,8,0,1,0,1
"TAHIRA",0,7,0,1,7,0,1,0,1
"TALYA",0,8,0,1,8,0,1,0,1
"TEA",1,9,.1,.9,10,0,1,0,0
"TEJAS",12,0,1,0,12,1,0,1,0
"TYSHAWN",13,1,.9285714,.0714286,14,1,0,0,0
"VAIBHAV",12,0,1,0,12,1,0,1,0
"WASEEM",12,0,1,0,12,1,0,1,0
"WESTON",9,1,.9,.1,10,1,0,0,0
"WINDY",2,9,.1818182,.8181818,11,0,1,0,0
"WINSOME",0,16,0,1,16,0,1,0,1
"YETUNDE",0,12,0,1,12,0,1,0,1
"YOCHEVED",0,4,0,1,4,0,1,0,1
"YORK",10,2,.8333333,.1666667,12,1,0,0,0
"YUDI",5,4,.5555556,.4444444,9,0,0,0,0
"ZAIRA",0,8,0,1,8,0,1,0,1
"ZARINA",0,8,0,1,8,0,1,0,1
"ZEN",8,5,.6153846,.3846154,13,0,0,0,0
"ZHONG",6,4,.6,.4,10,0,0,0,0
"ADRIEL",7,1,.875,.125,8,1,0,0,0
"ADÃÅN",11,0,1,0,11,1,0,1,0
"AHARON",10,0,1,0,10,1,0,1,0
"AKOSUA",0,7,0,1,7,0,1,0,1
"ALETHEA",0,9,0,1,9,0,1,0,1
"ALFIE",12,1,.9230769,.0769231,13,1,0,0,0
"ALISTAIR",10,0,1,0,10,1,0,1,0
"AMADOU",13,1,.9285714,.0714286,14,1,0,0,0
"AMINATA",0,9,0,1,9,0,1,0,1
"ANDREINA",0,10,0,1,10,0,1,0,1
"ANDRIANA",0,6,0,1,6,0,1,0,1
"ANGELITA",0,11,0,1,11,0,1,0,1
"ARAMIS",13,0,1,0,13,1,0,1,0
"ARETHA",0,11,0,1,11,0,1,0,1
"ARIN",5,4,.5555556,.4444444,9,0,0,0,0
"ARKADIY",10,0,1,0,10,1,0,1,0
"ARLINE",0,13,0,1,13,0,1,0,1
"ARY",3,3,.5,.5,6,0,0,0,0
"ASHLIE",0,11,0,1,11,0,1,0,1
"ASTON",9,0,1,0,9,1,0,1,0
"AVIGAIL",0,11,0,1,11,0,1,0,1
"BABETTE",0,8,0,1,8,0,1,0,1
"BAHAR",1,6,.1428571,.8571429,7,0,1,0,0
"BAO",7,1,.875,.125,8,1,0,0,0
"BASHIR",11,1,.9166667,.0833333,12,1,0,0,0
"BE",5,3,.625,.375,8,0,0,0,0
"BENEDETTA",0,10,0,1,10,0,1,0,1
"BENJY",8,0,1,0,8,1,0,1,0
"BLISS",4,6,.4,.6,10,0,0,0,0
"BOJAN",12,0,1,0,12,1,0,1,0
"BRANDO",10,0,1,0,10,1,0,1,0
"BRANT",5,0,1,0,5,1,0,1,0
"BRIEN",9,1,.9,.1,10,1,0,0,0
"BRITTNY",0,9,0,1,9,0,1,0,1
"BRITTON",2,4,.3333333,.6666667,6,0,0,0,0
"BURHAN",12,0,1,0,12,1,0,1,0
"CALOGERO",9,0,1,0,9,1,0,1,0
"CARLEY",0,9,0,1,9,0,1,0,1
"CARROLL",1,8,.1111111,.8888889,9,0,1,0,0
"CATARINA",0,10,0,1,10,0,1,0,1
"CECI",0,12,0,1,12,0,1,0,1
"CENK",10,0,1,0,10,1,0,1,0
"CHARLTON",8,1,.8888889,.1111111,9,1,0,0,0
"CHAVI",0,10,0,1,10,0,1,0,1
"CHO",8,5,.6153846,.3846154,13,0,0,0,0
"CLARISSE",0,10,0,1,10,0,1,0,1
"CORDELL",10,1,.9090909,.0909091,11,1,0,0,0
"CORIE",1,9,.1,.9,10,0,1,0,0
"CORINE",0,8,0,1,8,0,1,0,1
"DAE",11,1,.9166667,.0833333,12,1,0,0,0
"DANISHA",0,12,0,1,12,0,1,0,1
"DAVIDSON",10,1,.9090909,.0909091,11,1,0,0,0
"DAX",7,0,1,0,7,1,0,1,0
"DEA",1,6,.1428571,.8571429,7,0,1,0,0
"DENZIL",11,0,1,0,11,1,0,1,0
"DIEDRE",0,13,0,1,13,0,1,0,1
"DONAL",13,0,1,0,13,1,0,1,0
"DORENE",0,15,0,1,15,0,1,0,1
"DRITAN",9,0,1,0,9,1,0,1,0
"DROR",4,0,1,0,4,1,0,1,0
"EDINA",0,10,0,1,10,0,1,0,1
"EFE",11,1,.9166667,.0833333,12,1,0,0,0
"EHAB",11,0,1,0,11,1,0,1,0
"EINAT",0,4,0,1,4,0,1,0,1
"ELMA",0,12,0,1,12,0,1,0,1
"ELOISA",0,9,0,1,9,0,1,0,1
"ELONA",0,7,0,1,7,0,1,0,1
"ELOY",10,0,1,0,10,1,0,1,0
"ERIKO",0,6,0,1,6,0,1,0,1
"FADY",13,0,1,0,13,1,0,1,0
"FAHEEM",12,0,1,0,12,1,0,1,0
"FAREED",7,0,1,0,7,1,0,1,0
"FATMA",0,5,0,1,5,0,1,0,1
"FLY",16,2,.8888889,.1111111,18,1,0,0,0
"FUNMI",1,7,.125,.875,8,0,1,0,0
"GAEL",4,7,.3636364,.6363636,11,0,0,0,0
"GAGAN",7,2,.7777778,.2222222,9,1,0,0,0
"GARCIA",6,5,.5454546,.4545455,11,0,0,0,0
"GARRET",9,0,1,0,9,1,0,1,0
"GEOVANNI",8,0,1,0,8,1,0,1,0
"GILES",8,0,1,0,8,1,0,1,0
"HADASSAH",0,7,0,1,7,0,1,0,1
"HALIMA",0,13,0,1,13,0,1,0,1
"HANDE",0,5,0,1,5,0,1,0,1
"HARDY",6,0,1,0,6,1,0,1,0
"HEBA",0,6,0,1,6,0,1,0,1
"HOI",7,3,.7,.3,10,0,0,0,0
"HONOR",0,9,0,1,9,0,1,0,1
"ILIA",4,6,.4,.6,10,0,0,0,0
"ILYSSA",0,6,0,1,6,0,1,0,1
"ISAIAS",12,0,1,0,12,1,0,1,0
"JACINTA",0,12,0,1,12,0,1,0,1
"JAMELL",14,0,1,0,14,1,0,1,0
"JANENE",0,4,0,1,4,0,1,0,1
"JANNY",1,6,.1428571,.8571429,7,0,1,0,0
"JEB",11,0,1,0,11,1,0,1,0
"JENSEN",9,1,.9,.1,10,1,0,0,0
"KALINA",0,10,0,1,10,0,1,0,1
"KAN",8,3,.7272727,.2727273,11,0,0,0,0
"KANAKO",0,8,0,1,8,0,1,0,1
"KANG",11,0,1,0,11,1,0,1,0
"KASANDRA",0,10,0,1,10,0,1,0,1
"KASSIE",0,10,0,1,10,0,1,0,1
"KATALIN",0,11,0,1,11,0,1,0,1
"KEARA",0,8,0,1,8,0,1,0,1
"KERRIN",0,9,0,1,9,0,1,0,1
"KERVIN",9,0,1,0,9,1,0,1,0
"KETAN",13,0,1,0,13,1,0,1,0
"KETURAH",0,9,0,1,9,0,1,0,1
"KISHORE",11,0,1,0,11,1,0,1,0
"KRISH",7,0,1,0,7,1,0,1,0
"LAM",9,1,.9,.1,10,1,0,0,0
"LARON",11,0,1,0,11,1,0,1,0
"LASHANDA",0,9,0,1,9,0,1,0,1
"LASHAUN",1,7,.125,.875,8,0,1,0,0
"LEEANNE",0,6,0,1,6,0,1,0,1
"LINDEN",8,2,.8,.2,10,1,0,0,0
"LON",10,1,.9090909,.0909091,11,1,0,0,0
"LOREEN",0,10,0,1,10,0,1,0,1
"LORELEI",0,7,0,1,7,0,1,0,1
"LOS",9,0,1,0,9,1,0,1,0
"LOUANN",0,13,0,1,13,0,1,0,1
"LUCIO",10,0,1,0,10,1,0,1,0
"LYSTRA",0,11,0,1,11,0,1,0,1
"MAHENDRA",10,0,1,0,10,1,0,1,0
"MAIREAD",0,11,0,1,11,0,1,0,1
"MAJID",8,0,1,0,8,1,0,1,0
"MAJOR",11,0,1,0,11,1,0,1,0
"MALI",2,7,.2222222,.7777778,9,0,1,0,0
"MANI",4,6,.4,.6,10,0,0,0,0
"MANSI",0,8,0,1,8,0,1,0,1
"MASAKO",0,8,0,1,8,0,1,0,1
"MELANI",0,9,0,1,9,0,1,0,1
"MELONIE",0,8,0,1,8,0,1,0,1
"MEME",2,7,.2222222,.7777778,9,0,1,0,0
"MERRI",0,10,0,1,10,0,1,0,1
"MILICA",0,9,0,1,9,0,1,0,1
"MIRIAN",0,14,0,1,14,0,1,0,1
"MIRKO",12,0,1,0,12,1,0,1,0
"MIRTA",0,12,0,1,12,0,1,0,1
"MIRTHA",1,9,.1,.9,10,0,1,0,0
"MISAEL",11,0,1,0,11,1,0,1,0
"NAJEE",7,1,.875,.125,8,1,0,0,0
"NAQUAN",14,0,1,0,14,1,0,1,0
"NARI",1,4,.2,.8,5,0,1,0,0
"NATI",3,4,.4285714,.5714286,7,0,0,0,0
"NATTY",6,4,.6,.4,10,0,0,0,0
"NEETA",0,11,0,1,11,0,1,0,1
"NEFTALI",13,0,1,0,13,1,0,1,0
"NESHA",0,7,0,1,7,0,1,0,1
"NGOZI",2,5,.2857143,.7142857,7,0,0,0,0
"NIAMH",0,7,0,1,7,0,1,0,1
"NIELS",5,0,1,0,5,1,0,1,0
"NIESHA",0,13,0,1,13,0,1,0,1
"NITZAN",5,2,.7142857,.2857143,7,0,0,0,0
"NIURKA",0,7,0,1,7,0,1,0,1
"NOLA",0,10,0,1,10,0,1,0,1
"NOMI",2,6,.25,.75,8,0,0,0,0
"NONI",2,5,.2857143,.7142857,7,0,0,0,0
"NURIT",0,6,0,1,6,0,1,0,1
"OANA",0,8,0,1,8,0,1,0,1
"OH",3,5,.375,.625,8,0,0,0,0
"OR",6,2,.75,.25,8,0,0,0,0
"ORNELLA",0,8,0,1,8,0,1,0,1
"OSWALD",12,0,1,0,12,1,0,1,0
"PALMA",1,12,.0769231,.9230769,13,0,1,0,0
"PETERSON",13,0,1,0,13,1,0,1,0
"PREET",6,4,.6,.4,10,0,0,0,0
"QIN",6,3,.6666667,.3333333,9,0,0,0,0
"RACHNA",0,10,0,1,10,0,1,0,1
"RALPHIE",13,0,1,0,13,1,0,1,0
"RASHEEN",10,0,1,0,10,1,0,1,0
"RAYSA",0,12,0,1,12,0,1,0,1
"REDA",10,0,1,0,10,1,0,1,0
"REHAN",8,0,1,0,8,1,0,1,0
"RICHMOND",11,0,1,0,11,1,0,1,0
"ROHINI",0,7,0,1,7,0,1,0,1
"RONAN",7,0,1,0,7,1,0,1,0
"ROSALINA",0,10,0,1,10,0,1,0,1
"ROSANGELA",0,8,0,1,8,0,1,0,1
"ROZA",0,10,0,1,10,0,1,0,1
"RUDDY",10,1,.9090909,.0909091,11,1,0,0,0
"SANJEEV",13,0,1,0,13,1,0,1,0
"SARIKA",0,6,0,1,6,0,1,0,1
"SATOSHI",13,0,1,0,13,1,0,1,0
"SAVERIO",10,0,1,0,10,1,0,1,0
"SAYAKA",0,6,0,1,6,0,1,0,1
"SELCUK",7,0,1,0,7,1,0,1,0
"SHAINDY",0,4,0,1,4,0,1,0,1
"SHALONDA",0,10,0,1,10,0,1,0,1
"SHANON",4,7,.3636364,.6363636,11,0,0,0,0
"SHANTAE",0,11,0,1,11,0,1,0,1
"SHANTAL",0,10,0,1,10,0,1,0,1
"SHANTELLE",0,11,0,1,11,0,1,0,1
"SHAR",0,7,0,1,7,0,1,0,1
"SHARITA",0,11,0,1,11,0,1,0,1
"SHARLEEN",0,9,0,1,9,0,1,0,1
"SHASHA",0,9,0,1,9,0,1,0,1
"SHERISE",0,10,0,1,10,0,1,0,1
"SHONDA",0,8,0,1,8,0,1,0,1
"SHREYA",0,7,0,1,7,0,1,0,1
"SIENNA",0,7,0,1,7,0,1,0,1
"SIMO",12,0,1,0,12,1,0,1,0
"SLIM",6,5,.5454546,.4545455,11,0,0,0,0
"SLOANE",0,5,0,1,5,0,1,0,1
"SON",10,1,.9090909,.0909091,11,1,0,0,0
"STEFANOS",7,0,1,0,7,1,0,1,0
"STEPHANIA",0,10,0,1,10,0,1,0,1
"SUNDAY",6,5,.5454546,.4545455,11,0,0,0,0
"TANAYA",0,10,0,1,10,0,1,0,1
"TATE",7,0,1,0,7,1,0,1,0
"TATUM",4,6,.4,.6,10,0,0,0,0
"TERELL",10,1,.9090909,.0909091,11,1,0,0,0
"TERESITA",0,13,0,1,13,0,1,0,1
"THANH",8,2,.8,.2,10,1,0,0,0
"TIERRA",0,10,0,1,10,0,1,0,1
"TIMO",11,0,1,0,11,1,0,1,0
"TRENTON",12,0,1,0,12,1,0,1,0
"TRIPP",6,0,1,0,6,1,0,1,0
"TRISTA",0,3,0,1,3,0,1,0,1
"UGO",8,2,.8,.2,10,1,0,0,0
"VAISHALI",0,2,0,1,2,0,1,0,1
"VANITA",0,9,0,1,9,0,1,0,1
"VANITY",2,5,.2857143,.7142857,7,0,0,0,0
"VASILIS",5,1,.8333333,.1666667,6,1,0,0,0
"VERED",0,6,0,1,6,0,1,0,1
"WHIT",4,2,.6666667,.3333333,6,0,0,0,0
"WOJCIECH",10,0,1,0,10,1,0,1,0
"WOLF",6,1,.8571429,.1428571,7,1,0,0,0
"YAHYA",14,0,1,0,14,1,0,1,0
"YECHIEL",9,0,1,0,9,1,0,1,0
"YEE",3,4,.4285714,.5714286,7,0,0,0,0
"YEHUDIS",0,6,0,1,6,0,1,0,1
"YOMI",8,3,.7272727,.2727273,11,0,0,0,0
"YORAM",11,0,1,0,11,1,0,1,0
"ZHAO",6,4,.6,.4,10,0,0,0,0
"ZION",9,0,1,0,9,1,0,1,0
"ABDOULAYE",11,0,1,0,11,1,0,1,0
"ABHAY",7,0,1,0,7,1,0,1,0
"ABIR",8,1,.8888889,.1111111,9,1,0,0,0
"ADALBERTO",12,0,1,0,12,1,0,1,0
"AJANI",7,0,1,0,7,1,0,1,0
"ALLANA",0,7,0,1,7,0,1,0,1
"ALLYN",6,5,.5454546,.4545455,11,0,0,0,0
"AMERICA",0,5,0,1,5,0,1,0,1
"AMNA",0,12,0,1,12,0,1,0,1
"AMOL",10,0,1,0,10,1,0,1,0
"ANGELIA",0,7,0,1,7,0,1,0,1
"ANKITA",0,9,0,1,9,0,1,0,1
"ARZU",0,9,0,1,9,0,1,0,1
"ASAKO",0,11,0,1,11,0,1,0,1
"AVION",2,8,.2,.8,10,0,1,0,0
"AYALA",1,4,.2,.8,5,0,1,0,0
"AYODELE",8,4,.6666667,.3333333,12,0,0,0,0
"BARRI",0,8,0,1,8,0,1,0,1
"BASIA",0,9,0,1,9,0,1,0,1
"BEAR",9,1,.9,.1,10,1,0,0,0
"BEBA",0,7,0,1,7,0,1,0,1
"BEKIM",12,0,1,0,12,1,0,1,0
"BELA",5,6,.4545455,.5454546,11,0,0,0,0
"BENDER",14,0,1,0,14,1,0,1,0
"BENNIE",7,2,.7777778,.2222222,9,1,0,0,0
"BERRY",1,5,.1666667,.8333333,6,0,1,0,0
"BESNIK",9,0,1,0,9,1,0,1,0
"BHAVIN",11,0,1,0,11,1,0,1,0
"BLAZE",9,2,.8181818,.1818182,11,1,0,0,0
"BOBO",6,2,.75,.25,8,0,0,0,0
"BOLIVAR",6,0,1,0,6,1,0,1,0
"BRIDGETT",0,12,0,1,12,0,1,0,1
"CATHI",0,10,0,1,10,0,1,0,1
"CENGIZ",13,0,1,0,13,1,0,1,0
"CHAR",2,4,.3333333,.6666667,6,0,0,0,0
"CHARLEEN",0,12,0,1,12,0,1,0,1
"CHERISH",0,8,0,1,8,0,1,0,1
"CHEVON",3,3,.5,.5,6,0,0,0,0
"CHEVONNE",0,8,0,1,8,0,1,0,1
"CICELY",0,9,0,1,9,0,1,0,1
"CLEM",7,0,1,0,7,1,0,1,0
"CLEMENTE",7,1,.875,.125,8,1,0,0,0
"COLEMAN",6,3,.6666667,.3333333,9,0,0,0,0
"CORBIN",8,0,1,0,8,1,0,1,0
"CORIN",5,3,.625,.375,8,0,0,0,0
"COURT",5,1,.8333333,.1666667,6,1,0,0,0
"CRISTEN",0,7,0,1,7,0,1,0,1
"DAHIANA",0,10,0,1,10,0,1,0,1
"DAIANA",0,8,0,1,8,0,1,0,1
"DAISUKE",7,0,1,0,7,1,0,1,0
"DAMIR",13,0,1,0,13,1,0,1,0
"DANITA",0,10,0,1,10,0,1,0,1
"DAPHNEE",0,10,0,1,10,0,1,0,1
"DARCEL",0,8,0,1,8,0,1,0,1
"DARNEL",12,0,1,0,12,1,0,1,0
"DAYO",7,3,.7,.3,10,0,0,0,0
"DEEPIKA",0,10,0,1,10,0,1,0,1
"DEVEN",9,1,.9,.1,10,1,0,0,0
"DEVYN",2,4,.3333333,.6666667,6,0,0,0,0
"DILEK",0,3,0,1,3,0,1,0,1
"DIVINA",1,9,.1,.9,10,0,1,0,0
"DONATELLA",0,10,0,1,10,0,1,0,1
"DONELL",9,1,.9,.1,10,1,0,0,0
"EBEN",6,0,1,0,6,1,0,1,0
"EDAN",7,0,1,0,7,1,0,1,0
"EDER",11,0,1,0,11,1,0,1,0
"EFRAT",0,7,0,1,7,0,1,0,1
"ELICIA",0,10,0,1,10,0,1,0,1
"EUGENIE",0,7,0,1,7,0,1,0,1
"FAINA",0,11,0,1,11,0,1,0,1
"FLEUR",0,9,0,1,9,0,1,0,1
"FOUAD",8,0,1,0,8,1,0,1,0
"FUAD",6,0,1,0,6,1,0,1,0
"GALO",14,0,1,0,14,1,0,1,0
"GAMAL",14,0,1,0,14,1,0,1,0
"GENNADY",12,0,1,0,12,1,0,1,0
"GITTY",0,6,0,1,6,0,1,0,1
"GLENYS",0,9,0,1,9,0,1,0,1
"GOLDA",0,11,0,1,11,0,1,0,1
"GREY",5,4,.5555556,.4444444,9,0,0,0,0
"GRZEGORZ",12,0,1,0,12,1,0,1,0
"HA",2,7,.2222222,.7777778,9,0,1,0,0
"HADAR",2,3,.4,.6,5,0,0,0,0
"HARDIK",16,0,1,0,16,1,0,1,0
"HEAVEN",0,5,0,1,5,0,1,0,1
"HELAINE",0,12,0,1,12,0,1,0,1
"HELGA",0,12,0,1,12,0,1,0,1
"HILL",3,4,.4285714,.5714286,7,0,0,0,0
"HITOMI",1,7,.125,.875,8,0,1,0,0
"HUMA",0,6,0,1,6,0,1,0,1
"IKEY",10,0,1,0,10,1,0,1,0
"ISLAM",10,1,.9090909,.0909091,11,1,0,0,0
"ISSAC",11,0,1,0,11,1,0,1,0
"JAD",12,1,.9230769,.0769231,13,1,0,0,0
"JAMISON",9,0,1,0,9,1,0,1,0
"JASPREET",12,1,.9230769,.0769231,13,1,0,0,0
"JAZ",3,5,.375,.625,8,0,0,0,0
"JIHYE",0,10,0,1,10,0,1,0,1
"JOHNNA",0,7,0,1,7,0,1,0,1
"JOHNPAUL",9,0,1,0,9,1,0,1,0
"JOSLYN",0,7,0,1,7,0,1,0,1
"JOYCELYN",0,13,0,1,13,0,1,0,1
"JUICE",9,0,1,0,9,1,0,1,0
"KAMILLA",0,10,0,1,10,0,1,0,1
"KAROLYN",0,8,0,1,8,0,1,0,1
"KARON",7,4,.6363636,.3636364,11,0,0,0,0
"KEKE",0,8,0,1,8,0,1,0,1
"KENDEL",10,0,1,0,10,1,0,1,0
"KEZIA",0,10,0,1,10,0,1,0,1
"KHARI",4,2,.6666667,.3333333,6,0,0,0,0
"KINDA",0,5,0,1,5,0,1,0,1
"KO",6,0,1,0,6,1,0,1,0
"KOKO",3,8,.2727273,.7272727,11,0,0,0,0
"KOREN",1,4,.2,.8,5,0,1,0,0
"LAKIA",0,13,0,1,13,0,1,0,1
"LAMBERT",5,1,.8333333,.1666667,6,1,0,0,0
"LANCELOT",10,0,1,0,10,1,0,1,0
"LAQUAN",10,0,1,0,10,1,0,1,0
"LARAINE",0,7,0,1,7,0,1,0,1
"LATONIA",0,11,0,1,11,0,1,0,1
"LAWANDA",0,12,0,1,12,0,1,0,1
"LILIBETH",1,9,.1,.9,10,0,1,0,0
"LILLI",0,7,0,1,7,0,1,0,1
"LIORA",0,4,0,1,4,0,1,0,1
"LISSY",0,9,0,1,9,0,1,0,1
"LUKA",5,3,.625,.375,8,0,0,0,0
"LYNSEY",0,7,0,1,7,0,1,0,1
"MADHAVI",0,6,0,1,6,0,1,0,1
"MAGALIE",0,9,0,1,9,0,1,0,1
"MAIRA",0,7,0,1,7,0,1,0,1
"MAKEBA",0,8,0,1,8,0,1,0,1
"MALACHI",10,1,.9090909,.0909091,11,1,0,0,0
"MANPREET",7,3,.7,.3,10,0,0,0,0
"MARAT",9,0,1,0,9,1,0,1,0
"MARCELLUS",13,0,1,0,13,1,0,1,0
"MARIELENA",0,5,0,1,5,0,1,0,1
"MARILU",0,8,0,1,8,0,1,0,1
"MARTINEZ",8,3,.7272727,.2727273,11,0,0,0,0
"MARWA",0,11,0,1,11,0,1,0,1
"MARYANA",0,8,0,1,8,0,1,0,1
"MATEUSZ",9,0,1,0,9,1,0,1,0
"MATHILDE",0,8,0,1,8,0,1,0,1
"MAURY",8,2,.8,.2,10,1,0,0,0
"MAXIMILLIAN",10,0,1,0,10,1,0,1,0
"MEGHNA",0,6,0,1,6,0,1,0,1
"MELI",1,6,.1428571,.8571429,7,0,1,0,0
"MELLISA",0,9,0,1,9,0,1,0,1
"MERVIN",12,0,1,0,12,1,0,1,0
"MICKAEL",14,0,1,0,14,1,0,1,0
"MISA",0,10,0,1,10,0,1,0,1
"MIYUKI",0,8,0,1,8,0,1,0,1
"MON",7,3,.7,.3,10,0,0,0,0
"MURTAZA",10,0,1,0,10,1,0,1,0
"MYRTLE",0,11,0,1,11,0,1,0,1
"NAAMA",0,9,0,1,9,0,1,0,1
"NABEEL",11,0,1,0,11,1,0,1,0
"NAFTALI",6,0,1,0,6,1,0,1,0
"NAILA",0,8,0,1,8,0,1,0,1
"NAM",7,1,.875,.125,8,1,0,0,0
"NANDO",12,0,1,0,12,1,0,1,0
"NASH",6,2,.75,.25,8,0,0,0,0
"NATOYA",0,10,0,1,10,0,1,0,1
"NAVEED",8,0,1,0,8,1,0,1,0
"NEETU",0,9,0,1,9,0,1,0,1
"NEO",12,0,1,0,12,1,0,1,0
"NILESH",8,0,1,0,8,1,0,1,0
"NILI",0,6,0,1,6,0,1,0,1
"NYU",4,2,.6666667,.3333333,6,0,0,0,0
"ONI",3,3,.5,.5,6,0,0,0,0
"ORAL",16,0,1,0,16,1,0,1,0
"OSEI",11,0,1,0,11,1,0,1,0
"PALMER",6,1,.8571429,.1428571,7,1,0,0,0
"PARUL",0,7,0,1,7,0,1,0,1
"PATRINA",0,7,0,1,7,0,1,0,1
"PEPPER",3,8,.2727273,.7272727,11,0,0,0,0
"PETR",12,0,1,0,12,1,0,1,0
"PIERA",0,9,0,1,9,0,1,0,1
"PINNY",6,0,1,0,6,1,0,1,0
"POPPY",1,6,.1428571,.8571429,7,0,1,0,0
"PREYA",0,8,0,1,8,0,1,0,1
"QASIM",11,0,1,0,11,1,0,1,0
"RAMSES",12,1,.9230769,.0769231,13,1,0,0,0
"RANDAL",6,0,1,0,6,1,0,1,0
"RANJIT",7,0,1,0,7,1,0,1,0
"RASHAAD",8,0,1,0,8,1,0,1,0
"REAL",8,0,1,0,8,1,0,1,0
"REBA",0,11,0,1,11,0,1,0,1
"RELL",7,2,.7777778,.2222222,9,1,0,0,0
"RIAN",10,1,.9090909,.0909091,11,1,0,0,0
"RIGOBERTO",12,0,1,0,12,1,0,1,0
"ROI",7,1,.875,.125,8,1,0,0,0
"ROLANDA",0,9,0,1,9,0,1,0,1
"ROMANA",0,10,0,1,10,0,1,0,1
"ROMI",3,6,.3333333,.6666667,9,0,0,0,0
"RONAK",6,0,1,0,6,1,0,1,0
"ROSAURA",0,10,0,1,10,0,1,0,1
"ROSEY",1,6,.1428571,.8571429,7,0,1,0,0
"ROSI",0,8,0,1,8,0,1,0,1
"ROYA",0,9,0,1,9,0,1,0,1
"SAKI",4,6,.4,.6,10,0,0,0,0
"SAMAR",2,7,.2222222,.7777778,9,0,1,0,0
"SANCHEZ",4,2,.6666667,.3333333,6,0,0,0,0
"SANTI",9,3,.75,.25,12,0,0,0,0
"SANTINA",0,5,0,1,5,0,1,0,1
"SANTOSH",8,0,1,0,8,1,0,1,0
"SEKOU",12,0,1,0,12,1,0,1,0
"SERENE",0,12,0,1,12,0,1,0,1
"SERHAT",5,0,1,0,5,1,0,1,0
"SERINA",0,10,0,1,10,0,1,0,1
"SHAMIM",8,0,1,0,8,1,0,1,0
"SHAMIR",11,0,1,0,11,1,0,1,0
"SHANEE",0,7,0,1,7,0,1,0,1
"SHANNEL",0,12,0,1,12,0,1,0,1
"SHEELA",0,4,0,1,4,0,1,0,1
"SHEIKH",8,0,1,0,8,1,0,1,0
"SHELL",2,8,.2,.8,10,0,1,0,0
"SHERA",0,8,0,1,8,0,1,0,1
"SHERINE",0,12,0,1,12,0,1,0,1
"SILVA",3,5,.375,.625,8,0,0,0,0
"SPARKY",12,0,1,0,12,1,0,1,0
"STACY-ANN",0,6,0,1,6,0,1,0,1
"STANFORD",13,0,1,0,13,1,0,1,0
"STEFFEN",12,0,1,0,12,1,0,1,0
"STEPHANI",0,7,0,1,7,0,1,0,1
"SUJIN",1,8,.1111111,.8888889,9,0,1,0,0
"SYD",6,2,.75,.25,8,0,0,0,0
"TAKISHA",0,5,0,1,5,0,1,0,1
"TALISA",0,11,0,1,11,0,1,0,1
"TANIQUA",0,13,0,1,13,0,1,0,1
"TEISHA",0,11,0,1,11,0,1,0,1
"TESSIE",0,8,0,1,8,0,1,0,1
"THE",8,0,1,0,8,1,0,1,0
"THOMPSON",9,3,.75,.25,12,0,0,0,0
"TUAN",12,0,1,0,12,1,0,1,0
"VALBONA",0,9,0,1,9,0,1,0,1
"VELVET",1,10,.0909091,.9090909,11,0,1,0,0
"WINTER",0,4,0,1,4,0,1,0,1
"WOLFGANG",8,0,1,0,8,1,0,1,0
"YANET",0,9,0,1,9,0,1,0,1
"YANICK",3,8,.2727273,.7272727,11,0,0,0,0
"YASMINA",0,8,0,1,8,0,1,0,1
"YINKA",6,3,.6666667,.3333333,9,0,0,0,0
"YOELY",6,0,1,0,6,1,0,1,0
"YONA",3,6,.3333333,.6666667,9,0,0,0,0
"YUEN",3,7,.3,.7,10,0,0,0,0
"YUNUS",13,0,1,0,13,1,0,1,0
"ZAN",5,3,.625,.375,8,0,0,0,0
"ZEHRA",0,9,0,1,9,0,1,0,1
"ZULAY",0,6,0,1,6,0,1,0,1
"AAKASH",9,0,1,0,9,1,0,1,0
"ABDOUL",10,0,1,0,10,1,0,1,0
"AGATHE",0,7,0,1,7,0,1,0,1
"AH",5,6,.4545455,.5454546,11,0,0,0,0
"AKIM",10,0,1,0,10,1,0,1,0
"AKRAM",6,0,1,0,6,1,0,1,0
"ALAA",5,3,.625,.375,8,0,0,0,0
"AMADO",12,0,1,0,12,1,0,1,0
"AMITA",0,9,0,1,9,0,1,0,1
"ANDRY",6,2,.75,.25,8,0,0,0,0
"ANDRZEJ",13,0,1,0,13,1,0,1,0
"ANOOP",13,0,1,0,13,1,0,1,0
"ANTONINA",0,6,0,1,6,0,1,0,1
"AR",5,2,.7142857,.2857143,7,0,0,0,0
"ARDA",6,0,1,0,6,1,0,1,0
"ARIES",5,4,.5555556,.4444444,9,0,0,0,0
"ASUKA",0,8,0,1,8,0,1,0,1
"AUDE",0,6,0,1,6,0,1,0,1
"AVIS",2,7,.2222222,.7777778,9,0,1,0,0
"AZEEM",11,0,1,0,11,1,0,1,0
"BABAK",7,0,1,0,7,1,0,1,0
"BABATUNDE",10,0,1,0,10,1,0,1,0
"BERK",9,0,1,0,9,1,0,1,0
"BERTRAM",11,0,1,0,11,1,0,1,0
"BIGG",10,0,1,0,10,1,0,1,0
"BORUCH",6,0,1,0,6,1,0,1,0
"BRANKO",10,0,1,0,10,1,0,1,0
"BRONWEN",0,6,0,1,6,0,1,0,1
"BURKE",7,1,.875,.125,8,1,0,0,0
"CAITY",0,3,0,1,3,0,1,0,1
"CAMMY",0,9,0,1,9,0,1,0,1
"CATHRINE",0,8,0,1,8,0,1,0,1
"CHICHI",2,8,.2,.8,10,0,1,0,0
"CHONG",5,0,1,0,5,1,0,1,0
"CIELO",0,9,0,1,9,0,1,0,1
"CLEMENTINE",0,3,0,1,3,0,1,0,1
"COREEN",0,12,0,1,12,0,1,0,1
"CRISTIANA",0,8,0,1,8,0,1,0,1
"DANELLE",0,9,0,1,9,0,1,0,1
"DELON",6,0,1,0,6,1,0,1,0
"DEN",9,2,.8181818,.1818182,11,1,0,0,0
"DERIC",4,0,1,0,4,1,0,1,0
"DIANN",0,8,0,1,8,0,1,0,1
"DIGNA",0,10,0,1,10,0,1,0,1
"DIOGENES",9,0,1,0,9,1,0,1,0
"DONN",10,0,1,0,10,1,0,1,0
"DORINA",0,8,0,1,8,0,1,0,1
"DOT",4,9,.3076923,.6923077,13,0,0,0,0
"DRAGANA",0,9,0,1,9,0,1,0,1
"DUTCH",6,0,1,0,6,1,0,1,0
"DYANA",0,7,0,1,7,0,1,0,1
"EDIN",8,0,1,0,8,1,0,1,0
"EKTA",0,9,0,1,9,0,1,0,1
"ELDER",8,2,.8,.2,10,1,0,0,0
"EMERALD",1,8,.1111111,.8888889,9,0,1,0,0
"EMILEE",0,9,0,1,9,0,1,0,1
"EMMANUELLA",0,8,0,1,8,0,1,0,1
"ENGIN",10,0,1,0,10,1,0,1,0
"ENIS",7,2,.7777778,.2222222,9,1,0,0,0
"ESIN",0,7,0,1,7,0,1,0,1
"EYTAN",8,0,1,0,8,1,0,1,0
"FANTA",0,7,0,1,7,0,1,0,1
"FILIPE",11,0,1,0,11,1,0,1,0
"FOTINI",0,5,0,1,5,0,1,0,1
"FOX",8,2,.8,.2,10,1,0,0,0
"FREYA",0,8,0,1,8,0,1,0,1
"GIANA",0,9,0,1,9,0,1,0,1
"GIORGIA",0,8,0,1,8,0,1,0,1
"GIRISH",9,0,1,0,9,1,0,1,0
"GISSELL",0,9,0,1,9,0,1,0,1
"GOPAL",9,0,1,0,9,1,0,1,0
"GUNNAR",6,0,1,0,6,1,0,1,0
"GWYNETH",0,8,0,1,8,0,1,0,1
"HADI",8,0,1,0,8,1,0,1,0
"HALLE",0,5,0,1,5,0,1,0,1
"HAYWOOD",12,0,1,0,12,1,0,1,0
"HAZEM",8,0,1,0,8,1,0,1,0
"HENRIQUE",10,0,1,0,10,1,0,1,0
"HESHY",11,0,1,0,11,1,0,1,0
"HULYA",0,9,0,1,9,0,1,0,1
"HYACINTH",0,11,0,1,11,0,1,0,1
"HYUNG",12,0,1,0,12,1,0,1,0
"IPEK",0,5,0,1,5,0,1,0,1
"ISAMAR",0,11,0,1,11,0,1,0,1
"ITAMAR",10,0,1,0,10,1,0,1,0
"JANG",3,4,.4285714,.5714286,7,0,0,0,0
"JAS",4,5,.4444444,.5555556,9,0,0,0,0
"JEAN-CLAUDE",6,0,1,0,6,1,0,1,0
"JEHAN",1,3,.25,.75,4,0,0,0,0
"JIANG",9,1,.9,.1,10,1,0,0,0
"JO-ANNE",0,5,0,1,5,0,1,0,1
"JORDI",7,2,.7777778,.2222222,9,1,0,0,0
"JOVANI",6,1,.8571429,.1428571,7,1,0,0,0
"JOVANNY",8,1,.8888889,.1111111,9,1,0,0,0
"JOYA",0,5,0,1,5,0,1,0,1
"JULIYA",0,9,0,1,9,0,1,0,1
"JUNIE",3,5,.375,.625,8,0,0,0,0
"KAHLIL",9,0,1,0,9,1,0,1,0
"KAIA",0,3,0,1,3,0,1,0,1
"KALPANA",0,7,0,1,7,0,1,0,1
"KAREEMA",0,4,0,1,4,0,1,0,1
"KARRIE",0,9,0,1,9,0,1,0,1
"KASH",9,0,1,0,9,1,0,1,0
"KATIANA",0,8,0,1,8,0,1,0,1
"KEITA",3,3,.5,.5,6,0,0,0,0
"KENN",9,0,1,0,9,1,0,1,0
"KERA",0,9,0,1,9,0,1,0,1
"KERMIT",10,0,1,0,10,1,0,1,0
"KILEY",2,5,.2857143,.7142857,7,0,0,0,0
"KIRI",1,7,.125,.875,8,0,1,0,0
"KOLA",10,0,1,0,10,1,0,1,0
"KRISTOFFER",7,0,1,0,7,1,0,1,0
"LANNY",10,4,.7142857,.2857143,14,0,0,0,0
"LASHANA",0,7,0,1,7,0,1,0,1
"LATIFA",0,9,0,1,9,0,1,0,1
"LATRICIA",0,6,0,1,6,0,1,0,1
"LAVON",8,3,.7272727,.2727273,11,0,0,0,0
"LEISA",0,8,0,1,8,0,1,0,1
"LELIA",0,10,0,1,10,0,1,0,1
"LILIANE",0,9,0,1,9,0,1,0,1
"LOPEZ",2,4,.3333333,.6666667,6,0,0,0,0
"LORY",0,6,0,1,6,0,1,0,1
"MAHER",10,0,1,0,10,1,0,1,0
"MAHOGANY",0,7,0,1,7,0,1,0,1
"MAITE",0,7,0,1,7,0,1,0,1
"MALINI",0,9,0,1,9,0,1,0,1
"MALOU",0,6,0,1,6,0,1,0,1
"MAMIE",0,8,0,1,8,0,1,0,1
"MANFRED",7,0,1,0,7,1,0,1,0
"MARIAELENA",0,6,0,1,6,0,1,0,1
"MARIOS",10,0,1,0,10,1,0,1,0
"MARV",11,0,1,0,11,1,0,1,0
"MARYA",0,10,0,1,10,0,1,0,1
"MARYSE",0,10,0,1,10,0,1,0,1
"MATTIE",1,7,.125,.875,8,0,1,0,0
"MAXIMUS",14,0,1,0,14,1,0,1,0
"MELANY",0,13,0,1,13,0,1,0,1
"MICHA",5,6,.4545455,.5454546,11,0,0,0,0
"MICHAELLE",1,12,.0769231,.9230769,13,0,1,0,0
"MINISTER",9,3,.75,.25,12,0,0,0,0
"MIO",1,7,.125,.875,8,0,1,0,0
"MIYA",0,8,0,1,8,0,1,0,1
"MONISHA",0,8,0,1,8,0,1,0,1
"MUNA",0,9,0,1,9,0,1,0,1
"NACHO",9,0,1,0,9,1,0,1,0
"NADEEN",0,9,0,1,9,0,1,0,1
"NADIM",9,0,1,0,9,1,0,1,0
"NAINA",0,4,0,1,4,0,1,0,1
"NANDI",1,7,.125,.875,8,0,1,0,0
"NEENA",0,7,0,1,7,0,1,0,1
"NENE",4,7,.3636364,.6363636,11,0,0,0,0
"NERY",2,10,.1666667,.8333333,12,0,1,0,0
"NETTA",0,9,0,1,9,0,1,0,1
"NEWTON",12,0,1,0,12,1,0,1,0
"NIKKIA",0,7,0,1,7,0,1,0,1
"NOMAN",10,0,1,0,10,1,0,1,0
"NORDIA",0,11,0,1,11,0,1,0,1
"NUNZIO",9,0,1,0,9,1,0,1,0
"NUSRAT",1,9,.1,.9,10,0,1,0,0
"OBI",7,2,.7777778,.2222222,9,1,0,0,0
"ODETTA",0,9,0,1,9,0,1,0,1
"OUSMANE",11,0,1,0,11,1,0,1,0
"PADMA",0,8,0,1,8,0,1,0,1
"PAMELLA",0,12,0,1,12,0,1,0,1
"PAPI",13,1,.9285714,.0714286,14,1,0,0,0
"PARAG",11,0,1,0,11,1,0,1,0
"PARRIS",5,4,.5555556,.4444444,9,0,0,0,0
"PARTH",9,0,1,0,9,1,0,1,0
"PETROS",8,0,1,0,8,1,0,1,0
"PHILLY",10,1,.9090909,.0909091,11,1,0,0,0
"PIETER",13,0,1,0,13,1,0,1,0
"PINA",1,7,.125,.875,8,0,1,0,0
"PUI",2,8,.2,.8,10,0,1,0,0
"RADA",0,9,0,1,9,0,1,0,1
"RADAMES",11,0,1,0,11,1,0,1,0
"RAJAN",11,0,1,0,11,1,0,1,0
"RAJIB",11,0,1,0,11,1,0,1,0
"RAMONE",11,0,1,0,11,1,0,1,0
"RAMYA",0,6,0,1,6,0,1,0,1
"RENU",0,6,0,1,6,0,1,0,1
"RIAD",9,1,.9,.1,10,1,0,0,0
"RIAZ",13,0,1,0,13,1,0,1,0
"RIGO",8,1,.8888889,.1111111,9,1,0,0,0
"RINAT",1,9,.1,.9,10,0,1,0,0
"RINO",13,0,1,0,13,1,0,1,0
"RIVERA",5,4,.5555556,.4444444,9,0,0,0,0
"ROMAINE",5,6,.4545455,.5454546,11,0,0,0,0
"ROME",7,1,.875,.125,8,1,0,0,0
"ROSALEE",0,10,0,1,10,0,1,0,1
"ROSINA",0,9,0,1,9,0,1,0,1
"RU",3,3,.5,.5,6,0,0,0,0
"RYANN",1,6,.1428571,.8571429,7,0,1,0,0
"SABAH",2,4,.3333333,.6666667,6,0,0,0,0
"SAKURA",0,7,0,1,7,0,1,0,1
"SALAH",9,0,1,0,9,1,0,1,0
"SAMEH",9,0,1,0,9,1,0,1,0
"SANNA",0,10,0,1,10,0,1,0,1
"SEAD",10,0,1,0,10,1,0,1,0
"SEDA",0,7,0,1,7,0,1,0,1
"SEETA",0,12,0,1,12,0,1,0,1
"SENA",1,6,.1428571,.8571429,7,0,1,0,0
"SHAHZAD",11,0,1,0,11,1,0,1,0
"SHANKAR",9,0,1,0,9,1,0,1,0
"SHANNAN",0,9,0,1,9,0,1,0,1
"SHEFALI",0,6,0,1,6,0,1,0,1
"SHERESE",0,10,0,1,10,0,1,0,1
"SIDRA",0,7,0,1,7,0,1,0,1
"SING",8,5,.6153846,.3846154,13,0,0,0,0
"SOREN",5,1,.8333333,.1666667,6,1,0,0,0
"SPRING",0,6,0,1,6,0,1,0,1
"STEPHENIE",0,9,0,1,9,0,1,0,1
"STREET",9,1,.9,.1,10,1,0,0,0
"SUDHIR",8,0,1,0,8,1,0,1,0
"TALHA",8,0,1,0,8,1,0,1,0
"TARAS",9,0,1,0,9,1,0,1,0
"TENESHA",0,10,0,1,10,0,1,0,1
"THAO",0,11,0,1,11,0,1,0,1
"TIBOR",10,0,1,0,10,1,0,1,0
"TIJUANA",1,11,.0833333,.9166667,12,0,1,0,0
"TINAMARIE",0,8,0,1,8,0,1,0,1
"TITI",1,7,.125,.875,8,0,1,0,0
"TORRES",7,3,.7,.3,10,0,0,0,0
"TOSHA",0,12,0,1,12,0,1,0,1
"TYQUAN",12,0,1,0,12,1,0,1,0
"ULRICH",10,0,1,0,10,1,0,1,0
"UMUT",9,0,1,0,9,1,0,1,0
"VALERIO",8,0,1,0,8,1,0,1,0
"VARSHA",0,9,0,1,9,0,1,0,1
"VENECIA",0,10,0,1,10,0,1,0,1
"VERO",1,7,.125,.875,8,0,1,0,0
"VI",0,4,0,1,4,0,1,0,1
"VIELKA",0,8,0,1,8,0,1,0,1
"WAGNER",9,1,.9,.1,10,1,0,0,0
"WE",7,1,.875,.125,8,1,0,0,0
"WILLEM",8,0,1,0,8,1,0,1,0
"YANINA",0,10,0,1,10,0,1,0,1
"YASH",10,0,1,0,10,1,0,1,0
"YAW",10,0,1,0,10,1,0,1,0
"YOCASTA",0,10,0,1,10,0,1,0,1
"YOSI",9,1,.9,.1,10,1,0,0,0
"YOUNES",12,0,1,0,12,1,0,1,0
"ZAFER",9,0,1,0,9,1,0,1,0
"ZAKI",8,0,1,0,8,1,0,1,0
"ZAKIA",0,9,0,1,9,0,1,0,1
"ZANA",0,8,0,1,8,0,1,0,1
"AB",7,2,.7777778,.2222222,9,1,0,0,0
"ADAMA",6,6,.5,.5,12,0,0,0,0
"AISLINN",0,6,0,1,6,0,1,0,1
"AKANE",0,9,0,1,9,0,1,0,1
"ALASTAIR",5,0,1,0,5,1,0,1,0
"ALBANIA",1,6,.1428571,.8571429,7,0,1,0,0
"ALDRIN",7,0,1,0,7,1,0,1,0
"ALIREZA",5,0,1,0,5,1,0,1,0
"ALLISTER",9,0,1,0,9,1,0,1,0
"ALYONA",0,10,0,1,10,0,1,0,1
"AMANDINE",0,8,0,1,8,0,1,0,1
"AMIRAH",0,6,0,1,6,0,1,0,1
"AMOY",0,9,0,1,9,0,1,0,1
"ANASTASIOS",7,0,1,0,7,1,0,1,0
"ANGE",3,5,.375,.625,8,0,0,0,0
"ANGELIC",0,8,0,1,8,0,1,0,1
"ANGELIKI",0,7,0,1,7,0,1,0,1
"ANIS",9,1,.9,.1,10,1,0,0,0
"ANITRA",0,8,0,1,8,0,1,0,1
"ANKUSH",7,0,1,0,7,1,0,1,0
"ANNE-LAURE",0,4,0,1,4,0,1,0,1
"ANNELISE",0,5,0,1,5,0,1,0,1
"ANTE",7,0,1,0,7,1,0,1,0
"ANTWON",7,0,1,0,7,1,0,1,0
"ARINA",0,5,0,1,5,0,1,0,1
"ARTAN",10,0,1,0,10,1,0,1,0
"ARUNA",1,6,.1428571,.8571429,7,0,1,0,0
"ATARA",0,4,0,1,4,0,1,0,1
"AURORE",0,4,0,1,4,0,1,0,1
"BAMBI",0,9,0,1,9,0,1,0,1
"BECKA",0,7,0,1,7,0,1,0,1
"BENJ",6,0,1,0,6,1,0,1,0
"BERTO",8,0,1,0,8,1,0,1,0
"BHAVNA",0,4,0,1,4,0,1,0,1
"BIANKA",0,10,0,1,10,0,1,0,1
"BIBIANA",0,8,0,1,8,0,1,0,1
"BRADEN",8,0,1,0,8,1,0,1,0
"BRIELLE",0,5,0,1,5,0,1,0,1
"BRIGHT",7,1,.875,.125,8,1,0,0,0
"BROADWAY",6,1,.8571429,.1428571,7,1,0,0,0
"BUBBA",9,3,.75,.25,12,0,0,0,0
"CAROLYNE",0,10,0,1,10,0,1,0,1
"CARRINGTON",7,1,.875,.125,8,1,0,0,0
"CASTILLO",5,3,.625,.375,8,0,0,0,0
"CELESTINE",0,8,0,1,8,0,1,0,1
"CELSO",13,0,1,0,13,1,0,1,0
"CHAI",6,4,.6,.4,10,0,0,0,0
"CHITRA",0,9,0,1,9,0,1,0,1
"CIERA",0,8,0,1,8,0,1,0,1
"CINTIA",0,11,0,1,11,0,1,0,1
"CINZIA",0,10,0,1,10,0,1,0,1
"COLUMBIA",1,3,.25,.75,4,0,0,0,0
"CONSTANTIN",9,0,1,0,9,1,0,1,0
"COOL",10,0,1,0,10,1,0,1,0
"COSTAS",9,0,1,0,9,1,0,1,0
"CY",8,4,.6666667,.3333333,12,0,0,0,0
"CYN",0,8,0,1,8,0,1,0,1
"DAI",4,0,1,0,4,1,0,1,0
"DAMLA",0,11,0,1,11,0,1,0,1
"DANISH",10,0,1,0,10,1,0,1,0
"DARLEEN",0,8,0,1,8,0,1,0,1
"DAWNE",0,11,0,1,11,0,1,0,1
"DEANDRE",9,0,1,0,9,1,0,1,0
"DEMIAN",6,0,1,0,6,1,0,1,0
"DEMIR",9,1,.9,.1,10,1,0,0,0
"DEVENDRA",8,0,1,0,8,1,0,1,0
"DIALLO",7,1,.875,.125,8,1,0,0,0
"DINI",0,7,0,1,7,0,1,0,1
"DORCAS",0,8,0,1,8,0,1,0,1
"EDD",7,0,1,0,7,1,0,1,0
"EDO",9,0,1,0,9,1,0,1,0
"ELIDA",0,10,0,1,10,0,1,0,1
"EMY",1,7,.125,.875,8,0,1,0,0
"ESHA",0,7,0,1,7,0,1,0,1
"EV",2,3,.4,.6,5,0,0,0,0
"EVGENIA",0,6,0,1,6,0,1,0,1
"FATEMA",0,7,0,1,7,0,1,0,1
"FATOUMATA",0,10,0,1,10,0,1,0,1
"FERMIN",9,0,1,0,9,1,0,1,0
"FION",0,5,0,1,5,0,1,0,1
"FURKAN",10,0,1,0,10,1,0,1,0
"GALIA",0,8,0,1,8,0,1,0,1
"GAY",2,10,.1666667,.8333333,12,0,1,0,0
"GLEB",9,0,1,0,9,1,0,1,0
"GLENNY",0,8,0,1,8,0,1,0,1
"GUI",8,0,1,0,8,1,0,1,0
"HAMISH",10,0,1,0,10,1,0,1,0
"HANG",6,5,.5454546,.4545455,11,0,0,0,0
"HATTIE",0,9,0,1,9,0,1,0,1
"HENG",6,3,.6666667,.3333333,9,0,0,0,0
"IJEOMA",1,7,.125,.875,8,0,1,0,0
"ILL",9,1,.9,.1,10,1,0,0,0
"JAEWON",7,0,1,0,7,1,0,1,0
"JAMELA",0,6,0,1,6,0,1,0,1
"JAMILLA",0,5,0,1,5,0,1,0,1
"JANNIE",0,7,0,1,7,0,1,0,1
"JASNA",0,5,0,1,5,0,1,0,1
"JATINDER",4,0,1,0,4,1,0,1,0
"JAVAN",10,2,.8333333,.1666667,12,1,0,0,0
"JEAN-MARC",4,0,1,0,4,1,0,1,0
"JEIMY",1,8,.1111111,.8888889,9,0,1,0,0
"JENNYFER",0,7,0,1,7,0,1,0,1
"JEREL",8,0,1,0,8,1,0,1,0
"JERILYN",0,8,0,1,8,0,1,0,1
"JESPER",6,0,1,0,6,1,0,1,0
"JINGJING",2,9,.1818182,.8181818,11,0,1,0,0
"JOACHIM",5,0,1,0,5,1,0,1,0
"JOCELYNE",0,11,0,1,11,0,1,0,1
"JOSELITO",12,0,1,0,12,1,0,1,0
"KADIR",8,0,1,0,8,1,0,1,0
"KAE",3,7,.3,.7,10,0,0,0,0
"KALISHA",0,6,0,1,6,0,1,0,1
"KALLI",0,5,0,1,5,0,1,0,1
"KALVIN",9,0,1,0,9,1,0,1,0
"KAMALA",0,8,0,1,8,0,1,0,1
"KAREL",8,1,.8888889,.1111111,9,1,0,0,0
"KARLY",1,3,.25,.75,4,0,0,0,0
"KARMEN",1,8,.1111111,.8888889,9,0,1,0,0
"KATHERIN",0,7,0,1,7,0,1,0,1
"KATHIA",0,8,0,1,8,0,1,0,1
"KAYODE",9,0,1,0,9,1,0,1,0
"KELI",0,9,0,1,9,0,1,0,1
"KELLEE",0,11,0,1,11,0,1,0,1
"KERBY",8,1,.8888889,.1111111,9,1,0,0,0
"KIMESHA",0,6,0,1,6,0,1,0,1
"KLEBER",10,0,1,0,10,1,0,1,0
"KOJI",7,0,1,0,7,1,0,1,0
"KRISTAN",0,8,0,1,8,0,1,0,1
"KWOK",7,0,1,0,7,1,0,1,0
"LANIE",0,4,0,1,4,0,1,0,1
"LATEEF",11,0,1,0,11,1,0,1,0
"LATIFAH",0,8,0,1,8,0,1,0,1
"LATOSHA",0,13,0,1,13,0,1,0,1
"LAURETTA",0,10,0,1,10,0,1,0,1
"LAURICE",0,6,0,1,6,0,1,0,1
"LEOPOLDO",9,0,1,0,9,1,0,1,0
"LIBERTY",2,8,.2,.8,10,0,1,0,0
"LILLIAM",0,12,0,1,12,0,1,0,1
"LIZABETH",0,11,0,1,11,0,1,0,1
"LOIDA",0,8,0,1,8,0,1,0,1
"LOLITA",0,9,0,1,9,0,1,0,1
"LORNE",7,0,1,0,7,1,0,1,0
"LUCILA",0,8,0,1,8,0,1,0,1
"LUDWIG",4,1,.8,.2,5,1,0,0,0
"LUI",6,2,.75,.25,8,0,0,0,0
"MADI",1,7,.125,.875,8,0,1,0,0
"MAHDI",10,0,1,0,10,1,0,1,0
"MAHMUD",12,0,1,0,12,1,0,1,0
"MANJU",1,7,.125,.875,8,0,1,0,0
"MARISHA",0,4,0,1,4,0,1,0,1
"MARJORY",0,9,0,1,9,0,1,0,1
"MARLEEN",0,7,0,1,7,0,1,0,1
"MARLINE",1,8,.1111111,.8888889,9,0,1,0,0
"MARQUISE",10,0,1,0,10,1,0,1,0
"MARS",5,4,.5555556,.4444444,9,0,0,0,0
"MAXX",7,0,1,0,7,1,0,1,0
"MAYTAL",0,6,0,1,6,0,1,0,1
"MAZEN",10,0,1,0,10,1,0,1,0
"MEGGIE",0,4,0,1,4,0,1,0,1
"MELO",5,0,1,0,5,1,0,1,0
"MERLYN",1,8,.1111111,.8888889,9,0,1,0,0
"MERRIE",0,9,0,1,9,0,1,0,1
"MESHA",0,9,0,1,9,0,1,0,1
"MIAO",2,4,.3333333,.6666667,6,0,0,0,0
"MIC",6,1,.8571429,.1428571,7,1,0,0,0
"MICHELL",1,7,.125,.875,8,0,1,0,0
"MIHAELA",0,8,0,1,8,0,1,0,1
"MINDI",0,8,0,1,8,0,1,0,1
"MIROSLAV",10,0,1,0,10,1,0,1,0
"MITRA",3,7,.3,.7,10,0,0,0,0
"MONAE",0,10,0,1,10,0,1,0,1
"MORITZ",6,0,1,0,6,1,0,1,0
"MOURAD",9,0,1,0,9,1,0,1,0
"MOUSTAFA",7,0,1,0,7,1,0,1,0
"NANCIE",0,11,0,1,11,0,1,0,1
"NANDINI",0,6,0,1,6,0,1,0,1
"NANI",2,8,.2,.8,10,0,1,0,0
"NANNETTE",0,9,0,1,9,0,1,0,1
"NAO",1,7,.125,.875,8,0,1,0,0
"NAS",6,1,.8571429,.1428571,7,1,0,0,0
"NASTASSIA",0,9,0,1,9,0,1,0,1
"NATASIA",0,8,0,1,8,0,1,0,1
"NEDRA",0,5,0,1,5,0,1,0,1
"NEELA",0,5,0,1,5,0,1,0,1
"NELLE",0,6,0,1,6,0,1,0,1
"NELLI",0,5,0,1,5,0,1,0,1
"NICOLAI",7,1,.875,.125,8,1,0,0,0
"NILA",0,7,0,1,7,0,1,0,1
"NKECHI",0,4,0,1,4,0,1,0,1
"NNAMDI",12,0,1,0,12,1,0,1,0
"NYA",0,11,0,1,11,0,1,0,1
"ODALIS",3,6,.3333333,.6666667,9,0,0,0,0
"OHAD",9,0,1,0,9,1,0,1,0
"OLU",10,1,.9090909,.0909091,11,1,0,0,0
"OMAIRA",0,9,0,1,9,0,1,0,1
"OMID",7,0,1,0,7,1,0,1,0
"ORLI",0,6,0,1,6,0,1,0,1
"ORTAL",0,3,0,1,3,0,1,0,1
"PAPO",11,0,1,0,11,1,0,1,0
"PEREZ",3,5,.375,.625,8,0,0,0,0
"PHAEDRA",0,9,0,1,9,0,1,0,1
"RAFFY",7,1,.875,.125,8,1,0,0,0
"RAHMAN",8,0,1,0,8,1,0,1,0
"RAJENDRA",11,0,1,0,11,1,0,1,0
"RALF",7,0,1,0,7,1,0,1,0
"RENALDO",10,0,1,0,10,1,0,1,0
"RHETT",5,0,1,0,5,1,0,1,0
"ROULA",0,6,0,1,6,0,1,0,1
"RUBINA",0,9,0,1,9,0,1,0,1
"SACHIKO",0,3,0,1,3,0,1,0,1
"SAKINAH",0,8,0,1,8,0,1,0,1
"SAMAN",2,3,.4,.6,5,0,0,0,0
"SE",4,6,.4,.6,10,0,0,0,0
"SHAKEEMA",0,11,0,1,11,0,1,0,1
"SHAKEMA",0,8,0,1,8,0,1,0,1
"SHALIN",5,0,1,0,5,1,0,1,0
"SHANEKA",0,8,0,1,8,0,1,0,1
"SHANETTE",0,10,0,1,10,0,1,0,1
"SHAO",6,1,.8571429,.1428571,7,1,0,0,0
"SHAQUANNA",0,11,0,1,11,0,1,0,1
"SHARAD",12,0,1,0,12,1,0,1,0
"SHARAN",3,3,.5,.5,6,0,0,0,0
"SHEIK",9,0,1,0,9,1,0,1,0
"SHELLIE",0,6,0,1,6,0,1,0,1
"SHERELLE",0,10,0,1,10,0,1,0,1
"SHERIE",0,4,0,1,4,0,1,0,1
"SHERMAINE",1,4,.2,.8,5,0,1,0,0
"SHOLA",6,4,.6,.4,10,0,0,0,0
"SHOLOM",7,0,1,0,7,1,0,1,0
"SHONETTE",0,8,0,1,8,0,1,0,1
"SHORTY",4,6,.4,.6,10,0,0,0,0
"SHUN",8,0,1,0,8,1,0,1,0
"SOLA",6,2,.75,.25,8,0,0,0,0
"SRULI",4,0,1,0,4,1,0,1,0
"STEVENS",11,0,1,0,11,1,0,1,0
"STORMY",1,7,.125,.875,8,0,1,0,0
"SULTAN",12,0,1,0,12,1,0,1,0
"TAK",5,0,1,0,5,1,0,1,0
"TALISHA",0,8,0,1,8,0,1,0,1
"TAMICA",0,7,0,1,7,0,1,0,1
"TANVI",0,7,0,1,7,0,1,0,1
"TAREQ",9,0,1,0,9,1,0,1,0
"TASHIA",0,8,0,1,8,0,1,0,1
"TATI",0,8,0,1,8,0,1,0,1
"TATIANNA",0,4,0,1,4,0,1,0,1
"TAYA",0,5,0,1,5,0,1,0,1
"TEAL",1,5,.1666667,.8333333,6,0,1,0,0
"TELLY",8,2,.8,.2,10,1,0,0,0
"TEO",6,1,.8571429,.1428571,7,1,0,0,0
"THA",8,3,.7272727,.2727273,11,0,0,0,0
"THAD",10,0,1,0,10,1,0,1,0
"TOSHI",9,1,.9,.1,10,1,0,0,0
"TREASURE",1,7,.125,.875,8,0,1,0,0
"TRIXIE",0,8,0,1,8,0,1,0,1
"TU",7,2,.7777778,.2222222,9,1,0,0,0
"TWANA",0,7,0,1,7,0,1,0,1
"URSZULA",0,8,0,1,8,0,1,0,1
"VIKASH",9,0,1,0,9,1,0,1,0
"WILEY",7,1,.875,.125,8,1,0,0,0
"WILKINS",12,0,1,0,12,1,0,1,0
"WILTON",12,1,.9230769,.0769231,13,1,0,0,0
"WOO",9,0,1,0,9,1,0,1,0
"YAMILE",0,5,0,1,5,0,1,0,1
"YASSINE",7,0,1,0,7,1,0,1,0
"YELITZA",0,8,0,1,8,0,1,0,1
"YEVGENIYA",0,9,0,1,9,0,1,0,1
"YIRA",0,8,0,1,8,0,1,0,1
"YOGI",9,0,1,0,9,1,0,1,0
"YOKASTA",0,11,0,1,11,0,1,0,1
"YUNA",0,8,0,1,8,0,1,0,1
"ZAHAVA",0,3,0,1,3,0,1,0,1
"ZHENYA",1,7,.125,.875,8,0,1,0,0
"ZHOU",8,5,.6153846,.3846154,13,0,0,0,0
"ZOHAR",6,2,.75,.25,8,0,0,0,0
"ZORAYA",0,6,0,1,6,0,1,0,1
"ZUZANA",0,8,0,1,8,0,1,0,1
"ABNER",11,0,1,0,11,1,0,1,0
"ABY",8,0,1,0,8,1,0,1,0
"ACHILLES",11,0,1,0,11,1,0,1,0
"ADANNA",0,9,0,1,9,0,1,0,1
"ADEBAYO",8,1,.8888889,.1111111,9,1,0,0,0
"ADELAIDA",0,10,0,1,10,0,1,0,1
"ADEWALE",7,1,.875,.125,8,1,0,0,0
"AFSHAN",0,5,0,1,5,0,1,0,1
"AKEMI",0,7,0,1,7,0,1,0,1
"ALBANA",0,8,0,1,8,0,1,0,1
"ALVINA",0,6,0,1,6,0,1,0,1
"ANANT",10,0,1,0,10,1,0,1,0
"ANDA",0,9,0,1,9,0,1,0,1
"ANEL",3,6,.3333333,.6666667,9,0,0,0,0
"ANGELI",1,4,.2,.8,5,0,1,0,0
"ANNELIESE",0,3,0,1,3,0,1,0,1
"ANNICK",0,7,0,1,7,0,1,0,1
"ANUPAMA",1,6,.1428571,.8571429,7,0,1,0,0
"ARDIAN",11,0,1,0,11,1,0,1,0
"ARSALAN",6,0,1,0,6,1,0,1,0
"ATSUKO",0,9,0,1,9,0,1,0,1
"AUGUSTUS",8,0,1,0,8,1,0,1,0
"AUNG",8,0,1,0,8,1,0,1,0
"BABITA",0,4,0,1,4,0,1,0,1
"BABS",1,7,.125,.875,8,0,1,0,0
"BARNABY",5,0,1,0,5,1,0,1,0
"BASTIEN",9,1,.9,.1,10,1,0,0,0
"BAXTER",7,0,1,0,7,1,0,1,0
"BRAM",6,0,1,0,6,1,0,1,0
"BUKOLA",2,6,.25,.75,8,0,0,0,0
"CAMMIE",0,5,0,1,5,0,1,0,1
"CANDIE",0,8,0,1,8,0,1,0,1
"CARLYN",0,6,0,1,6,0,1,0,1
"CARMELITA",0,8,0,1,8,0,1,0,1
"CHAKA",6,3,.6666667,.3333333,9,0,0,0,0
"CHANAN",5,0,1,0,5,1,0,1,0
"CHANNING",3,6,.3333333,.6666667,9,0,0,0,0
"CHANTAY",0,6,0,1,6,0,1,0,1
"CHAS",5,1,.8333333,.1666667,6,1,0,0,0
"CHEE",3,3,.5,.5,6,0,0,0,0
"CHELLE",0,8,0,1,8,0,1,0,1
"CHELSIE",0,7,0,1,7,0,1,0,1
"CHERELLE",0,9,0,1,9,0,1,0,1
"CHU",6,4,.6,.4,10,0,0,0,0
"CLARISA",0,7,0,1,7,0,1,0,1
"CLEON",10,0,1,0,10,1,0,1,0
"CLOVER",2,8,.2,.8,10,0,1,0,0
"COCOA",1,7,.125,.875,8,0,1,0,0
"CORETTA",0,8,0,1,8,0,1,0,1
"DAGMARA",0,6,0,1,6,0,1,0,1
"DAMIANO",10,0,1,0,10,1,0,1,0
"DARELL",10,0,1,0,10,1,0,1,0
"DARIUSZ",10,0,1,0,10,1,0,1,0
"DARKO",5,0,1,0,5,1,0,1,0
"DARLA",0,8,0,1,8,0,1,0,1
"DARRON",9,0,1,0,9,1,0,1,0
"DAWA",4,4,.5,.5,8,0,0,0,0
"DEANE",2,3,.4,.6,5,0,0,0,0
"DEEPALI",0,7,0,1,7,0,1,0,1
"DELICIA",0,4,0,1,4,0,1,0,1
"DEVA",3,6,.3333333,.6666667,9,0,0,0,0
"DEVRA",0,9,0,1,9,0,1,0,1
"DEWI",0,2,0,1,2,0,1,0,1
"DHAVAL",7,0,1,0,7,1,0,1,0
"DIETER",12,0,1,0,12,1,0,1,0
"DIMAS",10,0,1,0,10,1,0,1,0
"DIMITAR",9,0,1,0,9,1,0,1,0
"DIONNA",0,5,0,1,5,0,1,0,1
"DO",6,3,.6666667,.3333333,9,0,0,0,0
"DUYGU",0,4,0,1,4,0,1,0,1
"EDGARD",11,0,1,0,11,1,0,1,0
"EDITA",0,10,0,1,10,0,1,0,1
"EDMUNDO",9,0,1,0,9,1,0,1,0
"EFRAIM",10,0,1,0,10,1,0,1,0
"ELBERT",8,0,1,0,8,1,0,1,0
"ELIANE",0,5,0,1,5,0,1,0,1
"ELON",7,2,.7777778,.2222222,9,1,0,0,0
"ELSON",4,0,1,0,4,1,0,1,0
"ELSY",0,7,0,1,7,0,1,0,1
"EMIKO",0,8,0,1,8,0,1,0,1
"EN",3,2,.6,.4,5,0,0,0,0
"EVANGELIA",0,8,0,1,8,0,1,0,1
"FLORENT",2,0,1,0,2,1,0,1,0
"FLORIN",6,0,1,0,6,1,0,1,0
"FRANCE",0,9,0,1,9,0,1,0,1
"GAB",6,1,.8571429,.1428571,7,1,0,0,0
"GALI",0,4,0,1,4,0,1,0,1
"GAMZE",0,8,0,1,8,0,1,0,1
"GAVRIEL",8,0,1,0,8,1,0,1,0
"GEENA",0,5,0,1,5,0,1,0,1
"GERMAIN",8,1,.8888889,.1111111,9,1,0,0,0
"GISEL",0,5,0,1,5,0,1,0,1
"GLYNIS",0,7,0,1,7,0,1,0,1
"GODWIN",7,0,1,0,7,1,0,1,0
"GOOD",6,1,.8571429,.1428571,7,1,0,0,0
"GOTHAM",4,0,1,0,4,1,0,1,0
"HAE",4,4,.5,.5,8,0,0,0,0
"HAGIT",0,3,0,1,3,0,1,0,1
"HALI",0,4,0,1,4,0,1,0,1
"HAMAD",8,0,1,0,8,1,0,1,0
"HEIDE",0,8,0,1,8,0,1,0,1
"HENNA",0,6,0,1,6,0,1,0,1
"HOA",3,2,.6,.4,5,0,0,0,0
"HUY",5,0,1,0,5,1,0,1,0
"IFE",1,10,.0909091,.9090909,11,0,1,0,0
"ILHAN",9,0,1,0,9,1,0,1,0
"ILYSE",0,4,0,1,4,0,1,0,1
"INDHIRA",0,5,0,1,5,0,1,0,1
"INDIANA",0,8,0,1,8,0,1,0,1
"INGER",0,9,0,1,9,0,1,0,1
"ISH",5,0,1,0,5,1,0,1,0
"ITAY",6,0,1,0,6,1,0,1,0
"IVOR",9,0,1,0,9,1,0,1,0
"IZUMI",1,5,.1666667,.8333333,6,0,1,0,0
"JAC",5,3,.625,.375,8,0,0,0,0
"JAMILAH",0,7,0,1,7,0,1,0,1
"JAMILLAH",0,7,0,1,7,0,1,0,1
"JASLEEN",1,6,.1428571,.8571429,7,0,1,0,0
"JAVID",8,0,1,0,8,1,0,1,0
"JEAN-LUC",8,0,1,0,8,1,0,1,0
"JELISSA",0,3,0,1,3,0,1,0,1
"JEMEL",5,1,.8333333,.1666667,6,1,0,0,0
"JEMMA",0,9,0,1,9,0,1,0,1
"JENNETTE",0,8,0,1,8,0,1,0,1
"JERRELL",10,0,1,0,10,1,0,1,0
"JESICA",0,8,0,1,8,0,1,0,1
"JOANNIE",0,11,0,1,11,0,1,0,1
"JOANNY",2,7,.2222222,.7777778,9,0,1,0,0
"JODEE",0,7,0,1,7,0,1,0,1
"JOELLEN",0,7,0,1,7,0,1,0,1
"JON-PAUL",7,0,1,0,7,1,0,1,0
"JUDIT",0,11,0,1,11,0,1,0,1
"JUDSON",3,0,1,0,3,1,0,1,0
"JULY",0,9,0,1,9,0,1,0,1
"JUNITO",7,0,1,0,7,1,0,1,0
"KAMERON",10,0,1,0,10,1,0,1,0
"KAMILLE",0,9,0,1,9,0,1,0,1
"KARENA",0,6,0,1,6,0,1,0,1
"KARLI",0,7,0,1,7,0,1,0,1
"KARSTEN",9,0,1,0,9,1,0,1,0
"KATALINA",0,7,0,1,7,0,1,0,1
"KATERYNA",0,4,0,1,4,0,1,0,1
"KATHYANN",0,9,0,1,9,0,1,0,1
"KAVITHA",0,2,0,1,2,0,1,0,1
"KAYLIN",1,5,.1666667,.8333333,6,0,1,0,0
"KAYON",1,7,.125,.875,8,0,1,0,0
"KAZ",9,2,.8181818,.1818182,11,1,0,0,0
"KENDAL",5,6,.4545455,.5454546,11,0,0,0,0
"KENTARO",7,0,1,0,7,1,0,1,0
"KEVAN",6,0,1,0,6,1,0,1,0
"KEVYN",8,0,1,0,8,1,0,1,0
"KEY",6,3,.6666667,.3333333,9,0,0,0,0
"KIKE",6,1,.8571429,.1428571,7,1,0,0,0
"KOBY",9,0,1,0,9,1,0,1,0
"KRISZTINA",0,6,0,1,6,0,1,0,1
"KRYS",3,1,.75,.25,4,0,0,0,0
"KRYSTEL",0,8,0,1,8,0,1,0,1
"KYAW",11,0,1,0,11,1,0,1,0
"LAKESHA",0,9,0,1,9,0,1,0,1
"LAMARR",7,0,1,0,7,1,0,1,0
"LAMIN",10,0,1,0,10,1,0,1,0
"LATIA",0,7,0,1,7,0,1,0,1
"LAZER",5,0,1,0,5,1,0,1,0
"LEONELA",0,9,0,1,9,0,1,0,1
"LESLYE",0,8,0,1,8,0,1,0,1
"LETIZIA",0,8,0,1,8,0,1,0,1
"LEYDI",0,8,0,1,8,0,1,0,1
"LIZETH",0,7,0,1,7,0,1,0,1
"LUANNE",0,9,0,1,9,0,1,0,1
"LUCIUS",10,0,1,0,10,1,0,1,0
"LUDMILA",0,9,0,1,9,0,1,0,1
"LULA",1,9,.1,.9,10,0,1,0,0
"MACARENA",0,8,0,1,8,0,1,0,1
"MADIHA",0,4,0,1,4,0,1,0,1
"MALEK",7,1,.875,.125,8,1,0,0,0
"MALENA",0,5,0,1,5,0,1,0,1
"MAMI",0,7,0,1,7,0,1,0,1
"MAMTA",1,6,.1428571,.8571429,7,0,1,0,0
"MANDIE",0,7,0,1,7,0,1,0,1
"MANDISA",0,12,0,1,12,0,1,0,1
"MANSOOR",11,0,1,0,11,1,0,1,0
"MARCELL",10,2,.8333333,.1666667,12,1,0,0,0
"MARGA",0,4,0,1,4,0,1,0,1
"MARIANGELA",0,7,0,1,7,0,1,0,1
"MARILENA",0,7,0,1,7,0,1,0,1
"MARILIA",0,5,0,1,5,0,1,0,1
"MARILYNN",0,9,0,1,9,0,1,0,1
"MARJAN",1,7,.125,.875,8,0,1,0,0
"MATI",4,4,.5,.5,8,0,0,0,0
"MAZAL",0,8,0,1,8,0,1,0,1
"MEHREEN",0,8,0,1,8,0,1,0,1
"MEIRA",0,7,0,1,7,0,1,0,1
"MEKA",0,8,0,1,8,0,1,0,1
"MELIS",0,6,0,1,6,0,1,0,1
"MELONY",0,9,0,1,9,0,1,0,1
"MELY",0,8,0,1,8,0,1,0,1
"MEYTAL",0,4,0,1,4,0,1,0,1
"MICHAELANGELO",11,0,1,0,11,1,0,1,0
"MICHI",1,5,.1666667,.8333333,6,0,1,0,0
"MILEY",0,7,0,1,7,0,1,0,1
"MIRACLE",2,8,.2,.8,10,0,1,0,0
"MOCHA",0,8,0,1,8,0,1,0,1
"MORGANE",0,5,0,1,5,0,1,0,1
"MOYA",1,10,.0909091,.9090909,11,0,1,0,0
"MUHAMED",7,0,1,0,7,1,0,1,0
"MUNIR",11,0,1,0,11,1,0,1,0
"MUSTAPHA",9,0,1,0,9,1,0,1,0
"MYUNG",4,4,.5,.5,8,0,0,0,0
"NAJA",0,6,0,1,6,0,1,0,1
"NAMAN",10,0,1,0,10,1,0,1,0
"NAMRATA",0,8,0,1,8,0,1,0,1
"NANDITA",0,7,0,1,7,0,1,0,1
"NARDA",0,8,0,1,8,0,1,0,1
"NATASA",0,8,0,1,8,0,1,0,1
"NEVIN",4,2,.6666667,.3333333,6,0,0,0,0
"NIHAL",2,2,.5,.5,4,0,0,0,0
"NII",9,0,1,0,9,1,0,1,0
"NIKLAS",11,0,1,0,11,1,0,1,0
"NIRMALA",0,9,0,1,9,0,1,0,1
"NIYA",0,7,0,1,7,0,1,0,1
"NOURA",0,6,0,1,6,0,1,0,1
"NUALA",0,7,0,1,7,0,1,0,1
"NURI",5,1,.8333333,.1666667,6,1,0,0,0
"OLI",9,0,1,0,9,1,0,1,0
"OMEGA",5,5,.5,.5,10,0,0,0,0
"OREL",7,1,.875,.125,8,1,0,0,0
"PARESH",8,0,1,0,8,1,0,1,0
"PATRIC",7,0,1,0,7,1,0,1,0
"PHILOMENA",0,10,0,1,10,0,1,0,1
"PIYUSH",9,0,1,0,9,1,0,1,0
"PNINA",1,3,.25,.75,4,0,0,0,0
"PRATIMA",0,8,0,1,8,0,1,0,1
"RACHELI",0,7,0,1,7,0,1,0,1
"RADU",8,0,1,0,8,1,0,1,0
"RAGHU",9,0,1,0,9,1,0,1,0
"RAS",9,2,.8181818,.1818182,11,1,0,0,0
"RASHAAN",10,1,.9090909,.0909091,11,1,0,0,0
"RASHIDAH",0,7,0,1,7,0,1,0,1
"RAVINDRA",8,0,1,0,8,1,0,1,0
"RAYA",0,6,0,1,6,0,1,0,1
"RAYSHAWN",10,0,1,0,10,1,0,1,0
"RENAUD",4,0,1,0,4,1,0,1,0
"RENNIE",4,1,.8,.2,5,1,0,0,0
"RESA",0,5,0,1,5,0,1,0,1
"REVITAL",0,8,0,1,8,0,1,0,1
"RHINA",0,7,0,1,7,0,1,0,1
"RIZA",6,6,.5,.5,12,0,0,0,0
"ROSALINE",0,9,0,1,9,0,1,0,1
"ROSELINE",0,9,0,1,9,0,1,0,1
"ROSSELLA",0,5,0,1,5,0,1,0,1
"RUDOLF",10,0,1,0,10,1,0,1,0
"SAADIA",1,5,.1666667,.8333333,6,0,1,0,0
"SAE",4,3,.5714286,.4285714,7,0,0,0,0
"SAFET",9,0,1,0,9,1,0,1,0
"SALLYANN",0,11,0,1,11,0,1,0,1
"SANJANA",0,6,0,1,6,0,1,0,1
"SANTINO",6,0,1,0,6,1,0,1,0
"SAORI",0,6,0,1,6,0,1,0,1
"SATOKO",0,6,0,1,6,0,1,0,1
"SAVITRI",0,10,0,1,10,0,1,0,1
"SEVEN",7,4,.6363636,.3636364,11,0,0,0,0
"SHACHAR",5,1,.8333333,.1666667,6,1,0,0,0
"SHAHEEN",2,3,.4,.6,5,0,0,0,0
"SHAKINA",0,11,0,1,11,0,1,0,1
"SHAREEF",8,1,.8888889,.1111111,9,1,0,0,0
"SHARESE",0,11,0,1,11,0,1,0,1
"SHARLA",0,7,0,1,7,0,1,0,1
"SHARONDA",0,12,0,1,12,0,1,0,1
"SHAWANDA",0,10,0,1,10,0,1,0,1
"SHAYE",3,4,.4285714,.5714286,7,0,0,0,0
"SHELLYANN",0,6,0,1,6,0,1,0,1
"SHEM",5,1,.8333333,.1666667,6,1,0,0,0
"SHENELLE",0,9,0,1,9,0,1,0,1
"SHENG",9,0,1,0,9,1,0,1,0
"SHERENE",0,6,0,1,6,0,1,0,1
"SHERIKA",0,8,0,1,8,0,1,0,1
"SHERRELL",0,10,0,1,10,0,1,0,1
"SHEVON",1,3,.25,.75,4,0,0,0,0
"SHIKHA",0,6,0,1,6,0,1,0,1
"SHIRLY",0,4,0,1,4,0,1,0,1
"SHONDELL",4,4,.5,.5,8,0,0,0,0
"SHOSHANNA",0,6,0,1,6,0,1,0,1
"SIA",0,9,0,1,9,0,1,0,1
"SIBYL",0,7,0,1,7,0,1,0,1
"SIDDHARTHA",5,0,1,0,5,1,0,1,0
"SINEM",0,5,0,1,5,0,1,0,1
"SISSY",2,5,.2857143,.7142857,7,0,0,0,0
"SOFYA",0,7,0,1,7,0,1,0,1
"SOKOL",7,0,1,0,7,1,0,1,0
"SOPHY",0,5,0,1,5,0,1,0,1
"SRINIVAS",10,0,1,0,10,1,0,1,0
"SRIRAM",7,0,1,0,7,1,0,1,0
"STACEY-ANN",0,10,0,1,10,0,1,0,1
"STANTON",10,0,1,0,10,1,0,1,0
"SUMON",10,1,.9090909,.0909091,11,1,0,0,0
"SUPRIYA",0,8,0,1,8,0,1,0,1
"SUSHIL",7,0,1,0,7,1,0,1,0
"SUZANNAH",0,5,0,1,5,0,1,0,1
"SWAN",3,3,.5,.5,6,0,0,0,0
"SWETA",0,8,0,1,8,0,1,0,1
"TAMRA",0,7,0,1,7,0,1,0,1
"TARO",7,0,1,0,7,1,0,1,0
"TEJAL",0,5,0,1,5,0,1,0,1
"THAI",8,2,.8,.2,10,1,0,0,0
"TI",5,3,.625,.375,8,0,0,0,0
"TIERNEY",1,6,.1428571,.8571429,7,0,1,0,0
"TIGER",9,2,.8181818,.1818182,11,1,0,0,0
"TOMI",3,4,.4285714,.5714286,7,0,0,0,0
"TONG",6,1,.8571429,.1428571,7,1,0,0,0
"TRAN",4,8,.3333333,.6666667,12,0,0,0,0
"TRAY",7,4,.6363636,.3636364,11,0,0,0,0
"TRES",8,4,.6666667,.3333333,12,0,0,0,0
"TRESSA",0,8,0,1,8,0,1,0,1
"TRUNG",7,0,1,0,7,1,0,1,0
"UDAY",8,0,1,0,8,1,0,1,0
"UMESH",9,0,1,0,9,1,0,1,0
"VASILI",6,0,1,0,6,1,0,1,0
"VERNELL",2,9,.1818182,.8181818,11,0,1,0,0
"VITTORIA",0,4,0,1,4,0,1,0,1
"VONETTA",0,9,0,1,9,0,1,0,1
"VOULA",0,8,0,1,8,0,1,0,1
"WALE",6,0,1,0,6,1,0,1,0
"WERNER",9,0,1,0,9,1,0,1,0
"WILBUR",10,0,1,0,10,1,0,1,0
"WILD",7,1,.875,.125,8,1,0,0,0
"WILHELMINA",0,11,0,1,11,0,1,0,1
"XUE",1,6,.1428571,.8571429,7,0,1,0,0
"YEKATERINA",0,6,0,1,6,0,1,0,1
"YUDELKA",0,9,0,1,9,0,1,0,1
"YUKARI",0,7,0,1,7,0,1,0,1
"ZACHARIAH",8,0,1,0,8,1,0,1,0
"ZAFAR",7,0,1,0,7,1,0,1,0
"ZEINA",0,8,0,1,8,0,1,0,1
"ZI",5,3,.625,.375,8,0,0,0,0
"ZURI",3,3,.5,.5,6,0,0,0,0
"ABDIEL",9,0,1,0,9,1,0,1,0
"ACACIA",0,3,0,1,3,0,1,0,1
"AGIM",7,0,1,0,7,1,0,1,0
"AGUSTINA",0,3,0,1,3,0,1,0,1
"AK",8,1,.8888889,.1111111,9,1,0,0,0
"AKWASI",9,0,1,0,9,1,0,1,0
"ALEXUS",1,6,.1428571,.8571429,7,0,1,0,0
"ALMIRA",0,6,0,1,6,0,1,0,1
"ALPA",1,3,.25,.75,4,0,0,0,0
"AMERICO",10,0,1,0,10,1,0,1,0
"AMILCAR",8,0,1,0,8,1,0,1,0
"AMJAD",11,0,1,0,11,1,0,1,0
"ANABELLE",0,6,0,1,6,0,1,0,1
"ANALIA",0,9,0,1,9,0,1,0,1
"ANAR",3,5,.375,.625,8,0,0,0,0
"ANEESA",0,4,0,1,4,0,1,0,1
"ANGELES",1,4,.2,.8,5,0,1,0,0
"ANJANA",0,6,0,1,6,0,1,0,1
"ANSEL",6,0,1,0,6,1,0,1,0
"ANUPAM",5,0,1,0,5,1,0,1,0
"ARACELY",0,7,0,1,7,0,1,0,1
"ARAVIND",6,0,1,0,6,1,0,1,0
"ASTA",1,5,.1666667,.8333333,6,0,1,0,0
"AURELIO",12,1,.9230769,.0769231,13,1,0,0,0
"AVISHAI",6,0,1,0,6,1,0,1,0
"AVNER",8,0,1,0,8,1,0,1,0
"AVNI",2,2,.5,.5,4,0,0,0,0
"AYÃ‡A",0,6,0,1,6,0,1,0,1
"BAKER",3,3,.5,.5,6,0,0,0,0
"BARTON",6,0,1,0,6,1,0,1,0
"BASEM",10,0,1,0,10,1,0,1,0
"BEENA",0,8,0,1,8,0,1,0,1
"BEKAH",0,4,0,1,4,0,1,0,1
"BETO",11,0,1,0,11,1,0,1,0
"BETZAIDA",0,9,0,1,9,0,1,0,1
"BINU",7,3,.7,.3,10,0,0,0,0
"BINYAMIN",4,0,1,0,4,1,0,1,0
"BITA",0,4,0,1,4,0,1,0,1
"BLU",7,2,.7777778,.2222222,9,1,0,0,0
"BOOGIE",5,1,.8333333,.1666667,6,1,0,0,0
"BRANDEE",0,8,0,1,8,0,1,0,1
"BRANDT",3,1,.75,.25,4,0,0,0,0
"BRAYAN",8,0,1,0,8,1,0,1,0
"BREANA",0,4,0,1,4,0,1,0,1
"BUFFY",0,5,0,1,5,0,1,0,1
"BUSTER",10,0,1,0,10,1,0,1,0
"BUZZ",8,0,1,0,8,1,0,1,0
"CANDIDO",9,0,1,0,9,1,0,1,0
"CANDIS",0,6,0,1,6,0,1,0,1
"CARLEE",0,4,0,1,4,0,1,0,1
"CARLIN",8,3,.7272727,.2727273,11,0,0,0,0
"CASSY",0,8,0,1,8,0,1,0,1
"CELENA",0,6,0,1,6,0,1,0,1
"CELESTINA",0,10,0,1,10,0,1,0,1
"CEREN",0,4,0,1,4,0,1,0,1
"CHA",0,7,0,1,7,0,1,0,1
"CHAITANYA",5,1,.8333333,.1666667,6,1,0,0,0
"CHANNEL",0,8,0,1,8,0,1,0,1
"CHARIS",1,7,.125,.875,8,0,1,0,0
"CHARLINE",0,9,0,1,9,0,1,0,1
"CHARU",2,5,.2857143,.7142857,7,0,0,0,0
"CHIAKI",0,9,0,1,9,0,1,0,1
"CHRISTO",7,0,1,0,7,1,0,1,0
"CIHAN",8,1,.8888889,.1111111,9,1,0,0,0
"COHEN",3,3,.5,.5,6,0,0,0,0
"CON",4,1,.8,.2,5,1,0,0,0
"CONSTANTINOS",7,0,1,0,7,1,0,1,0
"CORTEZ",9,0,1,0,9,1,0,1,0
"COSIMO",8,0,1,0,8,1,0,1,0
"COURTENEY",1,6,.1428571,.8571429,7,0,1,0,0
"CRISTI",0,3,0,1,3,0,1,0,1
"DAIN",4,1,.8,.2,5,1,0,0,0
"DANIE",1,4,.2,.8,5,0,1,0,0
"DANNIE",2,6,.25,.75,8,0,0,0,0
"DANNIELLE",0,9,0,1,9,0,1,0,1
"DASHAUN",9,0,1,0,9,1,0,1,0
"DEIRDRA",0,10,0,1,10,0,1,0,1
"DENYSE",0,7,0,1,7,0,1,0,1
"DERMOT",7,0,1,0,7,1,0,1,0
"DERRON",10,0,1,0,10,1,0,1,0
"DERYCK",7,0,1,0,7,1,0,1,0
"DESIRE",1,8,.1111111,.8888889,9,0,1,0,0
"DEVAUGHN",8,0,1,0,8,1,0,1,0
"DEZ",4,2,.6666667,.3333333,6,0,0,0,0
"DIAZ",2,2,.5,.5,4,0,0,0,0
"DILCIA",0,10,0,1,10,0,1,0,1
"DIOR",2,6,.25,.75,8,0,0,0,0
"DONAVAN",8,0,1,0,8,1,0,1,0
"DONIELLE",0,7,0,1,7,0,1,0,1
"DONYA",0,5,0,1,5,0,1,0,1
"DURELL",9,0,1,0,9,1,0,1,0
"EAMONN",8,0,1,0,8,1,0,1,0
"EDWARDS",5,2,.7142857,.2857143,7,0,0,0,0
"ELADIO",9,0,1,0,9,1,0,1,0
"ELIZAVETA",0,4,0,1,4,0,1,0,1
"ELKA",0,6,0,1,6,0,1,0,1
"ELKIN",7,0,1,0,7,1,0,1,0
"ELMO",9,0,1,0,9,1,0,1,0
"EMEL",2,6,.25,.75,8,0,0,0,0
"EMELIA",0,10,0,1,10,0,1,0,1
"EMERY",4,3,.5714286,.4285714,7,0,0,0,0
"ENMANUEL",8,0,1,0,8,1,0,1,0
"EON",8,0,1,0,8,1,0,1,0
"ERSIN",4,0,1,0,4,1,0,1,0
"ESSIE",0,7,0,1,7,0,1,0,1
"ESTA",0,8,0,1,8,0,1,0,1
"EVGENY",10,0,1,0,10,1,0,1,0
"EVREN",4,0,1,0,4,1,0,1,0
"EWAN",6,0,1,0,6,1,0,1,0
"FARIHA",0,4,0,1,4,0,1,0,1
"FAROOQ",4,0,1,0,4,1,0,1,0
"FERHAT",7,0,1,0,7,1,0,1,0
"FERRIS",3,1,.75,.25,4,0,0,0,0
"FIOR",0,10,0,1,10,0,1,0,1
"FRANCIE",0,4,0,1,4,0,1,0,1
"FRANNIE",0,6,0,1,6,0,1,0,1
"FREDDA",0,7,0,1,7,0,1,0,1
"FREDERICA",0,10,0,1,10,0,1,0,1
"FREDERIK",8,0,1,0,8,1,0,1,0
"FREDRIC",8,0,1,0,8,1,0,1,0
"FUMIKO",0,7,0,1,7,0,1,0,1
"GALA",0,5,0,1,5,0,1,0,1
"GAR",5,2,.7142857,.2857143,7,0,0,0,0
"GAYE",0,7,0,1,7,0,1,0,1
"GENNADIY",6,0,1,0,6,1,0,1,0
"GLENNA",0,6,0,1,6,0,1,0,1
"GOLDEN",3,4,.4285714,.5714286,7,0,0,0,0
"GOLDY",1,4,.2,.8,5,0,1,0,0
"HALINA",0,7,0,1,7,0,1,0,1
"HAMLET",9,0,1,0,9,1,0,1,0
"HAMMAD",6,0,1,0,6,1,0,1,0
"HANSON",9,0,1,0,9,1,0,1,0
"HARSHA",3,3,.5,.5,6,0,0,0,0
"HEEJIN",0,6,0,1,6,0,1,0,1
"HERMES",9,1,.9,.1,10,1,0,0,0
"HEZEKIAH",8,0,1,0,8,1,0,1,0
"HITESH",7,0,1,0,7,1,0,1,0
"HOSSAM",4,0,1,0,4,1,0,1,0
"HUA",6,3,.6666667,.3333333,9,0,0,0,0
"ILDIKO",0,8,0,1,8,0,1,0,1
"ILISSA",0,5,0,1,5,0,1,0,1
"IMAD",9,0,1,0,9,1,0,1,0
"INGE",0,6,0,1,6,0,1,0,1
"IQBAL",10,0,1,0,10,1,0,1,0
"IRISH",1,2,.3333333,.6666667,3,0,0,0,0
"ISMET",7,1,.875,.125,8,1,0,0,0
"ISOBEL",0,2,0,1,2,0,1,0,1
"IVE",1,5,.1666667,.8333333,6,0,1,0,0
"JACKEE",0,10,0,1,10,0,1,0,1
"JACOPO",10,0,1,0,10,1,0,1,0
"JACQUELIN",0,7,0,1,7,0,1,0,1
"JAMIN",6,1,.8571429,.1428571,7,1,0,0,0
"JANAINA",0,5,0,1,5,0,1,0,1
"JANETT",0,6,0,1,6,0,1,0,1
"JAREK",7,0,1,0,7,1,0,1,0
"JASMYN",0,8,0,1,8,0,1,0,1
"JAYMEE",0,7,0,1,7,0,1,0,1
"JEAN-BAPTISTE",3,0,1,0,3,1,0,1,0
"JEAN-LOUIS",8,0,1,0,8,1,0,1,0
"JIHYUN",1,5,.1666667,.8333333,6,0,1,0,0
"JILLY",0,6,0,1,6,0,1,0,1
"JIMBO",7,0,1,0,7,1,0,1,0
"JIMENA",0,3,0,1,3,0,1,0,1
"JOB",10,1,.9090909,.0909091,11,1,0,0,0
"JORY",4,1,.8,.2,5,1,0,0,0
"JOVANY",7,0,1,0,7,1,0,1,0
"JURGEN",7,0,1,0,7,1,0,1,0
"KACI",1,7,.125,.875,8,0,1,0,0
"KAELA",0,5,0,1,5,0,1,0,1
"KAISHA",0,6,0,1,6,0,1,0,1
"KAMAR",9,0,1,0,9,1,0,1,0
"KANDACE",0,4,0,1,4,0,1,0,1
"KAORU",0,3,0,1,3,0,1,0,1
"KAREY",0,5,0,1,5,0,1,0,1
"KATHERINA",0,9,0,1,9,0,1,0,1
"KATHRINE",0,6,0,1,6,0,1,0,1
"KATLYN",0,7,0,1,7,0,1,0,1
"KAYDIAN",0,10,0,1,10,0,1,0,1
"KELECHI",8,1,.8888889,.1111111,9,1,0,0,0
"KELLY-ANN",0,9,0,1,9,0,1,0,1
"KENICHI",11,0,1,0,11,1,0,1,0
"KERRON",9,1,.9,.1,10,1,0,0,0
"KIKA",0,9,0,1,9,0,1,0,1
"KIMA",0,11,0,1,11,0,1,0,1
"KISHAN",6,0,1,0,6,1,0,1,0
"KOBE",7,0,1,0,7,1,0,1,0
"KORIN",1,5,.1666667,.8333333,6,0,1,0,0
"KRISSIE",0,6,0,1,6,0,1,0,1
"KRUPA",0,6,0,1,6,0,1,0,1
"KUSH",5,1,.8333333,.1666667,6,1,0,0,0
"KWADWO",11,0,1,0,11,1,0,1,0
"LADII",0,7,0,1,7,0,1,0,1
"LAEL",1,3,.25,.75,4,0,0,0,0
"LASHANNA",0,9,0,1,9,0,1,0,1
"LASHONDA",0,8,0,1,8,0,1,0,1
"LATEEFAH",0,10,0,1,10,0,1,0,1
"LATEISHA",0,10,0,1,10,0,1,0,1
"LAZAR",6,0,1,0,6,1,0,1,0
"LAZARO",9,0,1,0,9,1,0,1,0
"LEONIDAS",10,0,1,0,10,1,0,1,0
"LINN",1,7,.125,.875,8,0,1,0,0
"LISANNE",0,5,0,1,5,0,1,0,1
"LITAL",0,7,0,1,7,0,1,0,1
"LORETA",0,12,0,1,12,0,1,0,1
"LUAN",5,2,.7142857,.2857143,7,0,0,0,0
"LUDA",0,6,0,1,6,0,1,0,1
"MADELAINE",0,8,0,1,8,0,1,0,1
"MAGGI",0,8,0,1,8,0,1,0,1
"MAHALIA",0,6,0,1,6,0,1,0,1
"MAHMUT",11,0,1,0,11,1,0,1,0
"MAL",6,1,.8571429,.1428571,7,1,0,0,0
"MALICK",7,0,1,0,7,1,0,1,0
"MALINA",0,6,0,1,6,0,1,0,1
"MALORIE",0,7,0,1,7,0,1,0,1
"MAMUN",6,0,1,0,6,1,0,1,0
"MANHATTAN",4,2,.6666667,.3333333,6,0,0,0,0
"MAOR",11,0,1,0,11,1,0,1,0
"MARILUZ",0,9,0,1,9,0,1,0,1
"MARYLIN",0,9,0,1,9,0,1,0,1
"MEITAL",0,6,0,1,6,0,1,0,1
"MELAINE",0,10,0,1,10,0,1,0,1
"MILKA",0,4,0,1,4,0,1,0,1
"MILLA",0,5,0,1,5,0,1,0,1
"MINAL",0,8,0,1,8,0,1,0,1
"MINJUNG",0,7,0,1,7,0,1,0,1
"MIOSOTIS",0,8,0,1,8,0,1,0,1
"MIRJANA",0,9,0,1,9,0,1,0,1
"MIRSAD",9,2,.8181818,.1818182,11,1,0,0,0
"MITA",1,5,.1666667,.8333333,6,0,1,0,0
"MONTGOMERY",7,1,.875,.125,8,1,0,0,0
"MUKESH",12,0,1,0,12,1,0,1,0
"MYLA",0,7,0,1,7,0,1,0,1
"NAJAH",2,7,.2222222,.7777778,9,0,1,0,0
"NAKISHA",0,8,0,1,8,0,1,0,1
"NAKITA",1,4,.2,.8,5,0,1,0,0
"NAOKI",8,0,1,0,8,1,0,1,0
"NAVDEEP",4,1,.8,.2,5,1,0,0,0
"NEESHA",0,4,0,1,4,0,1,0,1
"NEL",4,3,.5714286,.4285714,7,0,0,0,0
"NGOC",1,5,.1666667,.8333333,6,0,1,0,0
"NI",3,5,.375,.625,8,0,0,0,0
"NIASIA",0,8,0,1,8,0,1,0,1
"NICKESHA",0,10,0,1,10,0,1,0,1
"NICOL",0,7,0,1,7,0,1,0,1
"NIL",0,3,0,1,3,0,1,0,1
"NISSIM",7,0,1,0,7,1,0,1,0
"NIXON",7,0,1,0,7,1,0,1,0
"OM",5,1,.8333333,.1666667,6,1,0,0,0
"OXANA",0,7,0,1,7,0,1,0,1
"PASCUAL",7,0,1,0,7,1,0,1,0
"PER",3,0,1,0,3,1,0,1,0
"PORSHA",0,6,0,1,6,0,1,0,1
"PRATEEK",8,0,1,0,8,1,0,1,0
"PRERNA",0,4,0,1,4,0,1,0,1
"PRISCA",0,7,0,1,7,0,1,0,1
"RAFA",7,2,.7777778,.2222222,9,1,0,0,0
"RAINER",9,0,1,0,9,1,0,1,0
"RANDIE",1,6,.1428571,.8571429,7,0,1,0,0
"RASHEDA",0,8,0,1,8,0,1,0,1
"RASHEL",1,6,.1428571,.8571429,7,0,1,0,0
"RAVINDER",6,2,.75,.25,8,0,0,0,0
"RAYMUNDO",7,0,1,0,7,1,0,1,0
"RAZ",6,1,.8571429,.1428571,7,1,0,0,0
"RAZA",6,0,1,0,6,1,0,1,0
"REBEKKA",0,6,0,1,6,0,1,0,1
"REILLY",5,0,1,0,5,1,0,1,0
"REMA",0,4,0,1,4,0,1,0,1
"RICHARDSON",7,0,1,0,7,1,0,1,0
"RIYA",0,3,0,1,3,0,1,0,1
"RONELL",4,4,.5,.5,8,0,0,0,0
"RONNELL",5,2,.7142857,.2857143,7,0,0,0,0
"RORI",0,6,0,1,6,0,1,0,1
"ROSANN",0,7,0,1,7,0,1,0,1
"ROSCOE",9,0,1,0,9,1,0,1,0
"ROSELLE",0,6,0,1,6,0,1,0,1
"RUMI",4,6,.4,.6,10,0,0,0,0
"RUTHANN",0,5,0,1,5,0,1,0,1
"SAHARA",0,5,0,1,5,0,1,0,1
"SALEM",8,0,1,0,8,1,0,1,0
"SANDIP",7,0,1,0,7,1,0,1,0
"SAQIB",5,0,1,0,5,1,0,1,0
"SATOMI",0,3,0,1,3,0,1,0,1
"SAUDIA",0,5,0,1,5,0,1,0,1
"SEGUN",8,0,1,0,8,1,0,1,0
"SEIKO",0,7,0,1,7,0,1,0,1
"SHAHAR",7,0,1,0,7,1,0,1,0
"SHAHIN",4,3,.5714286,.4285714,7,0,0,0,0
"SHAILA",0,6,0,1,6,0,1,0,1
"SHAILESH",7,0,1,0,7,1,0,1,0
"SHAKIL",8,0,1,0,8,1,0,1,0
"SHAKIR",8,0,1,0,8,1,0,1,0
"SHANY",1,1,.5,.5,2,0,0,0,0
"SHARISE",0,6,0,1,6,0,1,0,1
"SHARISSE",0,10,0,1,10,0,1,0,1
"SHAWANNA",0,12,0,1,12,0,1,0,1
"SHELLA",0,5,0,1,5,0,1,0,1
"SHERIN",0,5,0,1,5,0,1,0,1
"SHIHO",0,8,0,1,8,0,1,0,1
"SHIMI",5,1,.8333333,.1666667,6,1,0,0,0
"SHIMMY",3,1,.75,.25,4,0,0,0,0
"SHIVAM",6,0,1,0,6,1,0,1,0
"SHOKO",0,7,0,1,7,0,1,0,1
"SHONNA",0,9,0,1,9,0,1,0,1
"SHOSHI",0,6,0,1,6,0,1,0,1
"SHULI",1,6,.1428571,.8571429,7,0,1,0,0
"SIAN",0,6,0,1,6,0,1,0,1
"SIXTO",10,0,1,0,10,1,0,1,0
"SONER",6,0,1,0,6,1,0,1,0
"STALIN",10,1,.9090909,.0909091,11,1,0,0,0
"STEEVE",6,0,1,0,6,1,0,1,0
"TAHSIN",7,0,1,0,7,1,0,1,0
"TAMANNA",0,4,0,1,4,0,1,0,1
"TANG",6,2,.75,.25,8,0,0,0,0
"TANIESHA",0,8,0,1,8,0,1,0,1
"TANVEER",7,1,.875,.125,8,1,0,0,0
"TARRA",0,8,0,1,8,0,1,0,1
"TASH",1,6,.1428571,.8571429,7,0,1,0,0
"TAZ",6,2,.75,.25,8,0,0,0,0
"TEDD",8,0,1,0,8,1,0,1,0
"TEODORA",0,5,0,1,5,0,1,0,1
"THERON",8,0,1,0,8,1,0,1,0
"THIBAUT",4,0,1,0,4,1,0,1,0
"TONEY",8,0,1,0,8,1,0,1,0
"TONIANNE",0,3,0,1,3,0,1,0,1
"TONISHA",0,8,0,1,8,0,1,0,1
"TOVAH",0,7,0,1,7,0,1,0,1
"TRANG",0,5,0,1,5,0,1,0,1
"TRIP",7,0,1,0,7,1,0,1,0
"TRUDI",0,9,0,1,9,0,1,0,1
"UMIT",8,0,1,0,8,1,0,1,0
"URIAH",8,1,.8888889,.1111111,9,1,0,0,0
"VALON",5,0,1,0,5,1,0,1,0
"VASILIKI",0,8,0,1,8,0,1,0,1
"VICKEY",2,4,.3333333,.6666667,6,0,0,0,0
"VIPIN",8,0,1,0,8,1,0,1,0
"VIPUL",8,0,1,0,8,1,0,1,0
"VIRAL",5,0,1,0,5,1,0,1,0
"WAHID",7,0,1,0,7,1,0,1,0
"WATSON",4,4,.5,.5,8,0,0,0,0
"WESTLEY",8,0,1,0,8,1,0,1,0
"WILBER",6,0,1,0,6,1,0,1,0
"WILDA",0,8,0,1,8,0,1,0,1
"WILLARD",9,0,1,0,9,1,0,1,0
"WOJTEK",7,0,1,0,7,1,0,1,0
"WOODLEY",7,0,1,0,7,1,0,1,0
"XIU",4,3,.5714286,.4285714,7,0,0,0,0
"YA",4,5,.4444444,.5555556,9,0,0,0,0
"YAYA",2,6,.25,.75,8,0,0,0,0
"YOLA",0,8,0,1,8,0,1,0,1
"YULI",0,4,0,1,4,0,1,0,1
"YULIANA",0,7,0,1,7,0,1,0,1
"YULISSA",0,5,0,1,5,0,1,0,1
"YUMIKO",0,8,0,1,8,0,1,0,1
"YURA",3,4,.4285714,.5714286,7,0,0,0,0
"ZAKARIA",6,0,1,0,6,1,0,1,0
"ZALMAN",8,0,1,0,8,1,0,1,0
"ZANDRA",0,7,0,1,7,0,1,0,1
"ZANETA",0,4,0,1,4,0,1,0,1
"ZENIA",0,6,0,1,6,0,1,0,1
"ZESHAN",7,1,.875,.125,8,1,0,0,0
"ZEUS",8,0,1,0,8,1,0,1,0
"ZSOLT",9,0,1,0,9,1,0,1,0
"ABBI",0,4,0,1,4,0,1,0,1
"ABUL",5,0,1,0,5,1,0,1,0
"ADAMS",7,2,.7777778,.2222222,9,1,0,0,0
"ADENIKE",0,5,0,1,5,0,1,0,1
"ADWOA",0,6,0,1,6,0,1,0,1
"ADY",3,7,.3,.7,10,0,0,0,0
"AGA",1,7,.125,.875,8,0,1,0,0
"AGUS",9,1,.9,.1,10,1,0,0,0
"ALEA",0,6,0,1,6,0,1,0,1
"ALETA",0,6,0,1,6,0,1,0,1
"ALFONZO",5,0,1,0,5,1,0,1,0
"ALIN",6,4,.6,.4,10,0,0,0,0
"ALITA",0,5,0,1,5,0,1,0,1
"ALLEY",0,8,0,1,8,0,1,0,1
"ALLON",7,0,1,0,7,1,0,1,0
"ALP",9,0,1,0,9,1,0,1,0
"ALTAF",9,0,1,0,9,1,0,1,0
"AMARI",5,3,.625,.375,8,0,0,0,0
"AMISHA",0,6,0,1,6,0,1,0,1
"AMMA",0,7,0,1,7,0,1,0,1
"ANALISA",0,5,0,1,5,0,1,0,1
"ANDRIY",8,0,1,0,8,1,0,1,0
"ANISAH",0,6,0,1,6,0,1,0,1
"ANJELICA",0,6,0,1,6,0,1,0,1
"ANJUM",5,2,.7142857,.2857143,7,0,0,0,0
"ANSHUL",8,1,.8888889,.1111111,9,1,0,0,0
"ANTIONETTE",0,10,0,1,10,0,1,0,1
"ANURADHA",0,5,0,1,5,0,1,0,1
"APRYL",0,4,0,1,4,0,1,0,1
"AQEEL",9,0,1,0,9,1,0,1,0
"ARABELLA",0,6,0,1,6,0,1,0,1
"ARGIE",1,2,.3333333,.6666667,3,0,0,0,0
"ARISTOTLE",7,0,1,0,7,1,0,1,0
"ARLEN",6,3,.6666667,.3333333,9,0,0,0,0
"ARPIT",5,0,1,0,5,1,0,1,0
"ARRON",7,1,.875,.125,8,1,0,0,0
"ARSHAD",8,0,1,0,8,1,0,1,0
"ARYAN",8,0,1,0,8,1,0,1,0
"ASHLI",0,6,0,1,6,0,1,0,1
"ASHLYN",0,3,0,1,3,0,1,0,1
"ASI",7,0,1,0,7,1,0,1,0
"AUNDREA",1,6,.1428571,.8571429,7,0,1,0,0
"AUSTEN",5,1,.8333333,.1666667,6,1,0,0,0
"AWA",0,7,0,1,7,0,1,0,1
"AWAIS",4,0,1,0,4,1,0,1,0
"AY",3,1,.75,.25,4,0,0,0,0
"AYE",3,7,.3,.7,10,0,0,0,0
"BABU",7,0,1,0,7,1,0,1,0
"BAHADIR",5,0,1,0,5,1,0,1,0
"BALDWIN",6,0,1,0,6,1,0,1,0
"BAM",8,1,.8888889,.1111111,9,1,0,0,0
"BAPTISTE",4,0,1,0,4,1,0,1,0
"BAYO",8,1,.8888889,.1111111,9,1,0,0,0
"BENTON",5,0,1,0,5,1,0,1,0
"BESIM",7,0,1,0,7,1,0,1,0
"BETHANN",0,9,0,1,9,0,1,0,1
"BETINA",0,8,0,1,8,0,1,0,1
"BETTIE",0,7,0,1,7,0,1,0,1
"BEVIN",2,2,.5,.5,4,0,0,0,0
"BIAGIO",8,0,1,0,8,1,0,1,0
"BIJU",6,0,1,0,6,1,0,1,0
"BINDU",0,7,0,1,7,0,1,0,1
"BONNI",0,5,0,1,5,0,1,0,1
"BRIGIDA",0,10,0,1,10,0,1,0,1
"BRINA",0,6,0,1,6,0,1,0,1
"BRODY",5,1,.8333333,.1666667,6,1,0,0,0
"CAITIE",0,5,0,1,5,0,1,0,1
"CAMILE",0,3,0,1,3,0,1,0,1
"CARLISLE",5,0,1,0,5,1,0,1,0
"CARMINA",0,4,0,1,4,0,1,0,1
"CASSI",0,4,0,1,4,0,1,0,1
"CECILIO",9,0,1,0,9,1,0,1,0
"CEDRICK",11,0,1,0,11,1,0,1,0
"CHARLA",0,5,0,1,5,0,1,0,1
"CHARLYN",0,6,0,1,6,0,1,0,1
"CHARO",0,7,0,1,7,0,1,0,1
"CHERILYN",0,5,0,1,5,0,1,0,1
"CHINYERE",1,6,.1428571,.8571429,7,0,1,0,0
"CHOI",1,2,.3333333,.6666667,3,0,0,0,0
"CHRIST",4,4,.5,.5,8,0,0,0,0
"CHRYS",1,3,.25,.75,4,0,0,0,0
"CIRA",0,5,0,1,5,0,1,0,1
"CONAN",5,0,1,0,5,1,0,1,0
"CONNER",5,3,.625,.375,8,0,0,0,0
"CONROY",9,0,1,0,9,1,0,1,0
"CORALIE",0,2,0,1,2,0,1,0,1
"CORRADO",9,0,1,0,9,1,0,1,0
"CORRINA",0,4,0,1,4,0,1,0,1
"CRISPIN",6,0,1,0,6,1,0,1,0
"DALI",2,7,.2222222,.7777778,9,0,1,0,0
"DANIT",0,6,0,1,6,0,1,0,1
"DAPHNA",0,5,0,1,5,0,1,0,1
"DARINA",0,4,0,1,4,0,1,0,1
"DAY",5,2,.7142857,.2857143,7,0,0,0,0
"DEDRA",0,7,0,1,7,0,1,0,1
"DELL",7,2,.7777778,.2222222,9,1,0,0,0
"DENIA",0,5,0,1,5,0,1,0,1
"DERRELL",5,0,1,0,5,1,0,1,0
"DESERIE",0,10,0,1,10,0,1,0,1
"DESIRAE",0,7,0,1,7,0,1,0,1
"DILIP",9,0,1,0,9,1,0,1,0
"DIONISIO",10,0,1,0,10,1,0,1,0
"DOMO",7,1,.875,.125,8,1,0,0,0
"DOROTHEE",0,8,0,1,8,0,1,0,1
"DOVI",4,1,.8,.2,5,1,0,0,0
"DOYLE",4,0,1,0,4,1,0,1,0
"DOÄ_AN",7,0,1,0,7,1,0,1,0
"DURAN",6,0,1,0,6,1,0,1,0
"DURRELL",9,0,1,0,9,1,0,1,0
"EARLE",8,0,1,0,8,1,0,1,0
"ECE",0,8,0,1,8,0,1,0,1
"EKIN",3,3,.5,.5,6,0,0,0,0
"ELIRAN",6,0,1,0,6,1,0,1,0
"ELZBIETA",0,7,0,1,7,0,1,0,1
"EMA",0,6,0,1,6,0,1,0,1
"EMELIE",0,5,0,1,5,0,1,0,1
"EMIN",7,0,1,0,7,1,0,1,0
"ERDAL",7,0,1,0,7,1,0,1,0
"ERDEM",6,0,1,0,6,1,0,1,0
"ERINA",0,6,0,1,6,0,1,0,1
"ERLINDA",0,11,0,1,11,0,1,0,1
"ERNA",0,7,0,1,7,0,1,0,1
"ETTA",0,8,0,1,8,0,1,0,1
"ETTY",0,5,0,1,5,0,1,0,1
"EVIN",3,0,1,0,3,1,0,1,0
"EVON",2,4,.3333333,.6666667,6,0,0,0,0
"EZZY",5,3,.625,.375,8,0,0,0,0
"FAHMIDA",0,3,0,1,3,0,1,0,1
"FANCY",0,9,0,1,9,0,1,0,1
"FE",0,10,0,1,10,0,1,0,1
"FITZGERALD",11,0,1,0,11,1,0,1,0
"FOREST",7,0,1,0,7,1,0,1,0
"FRENCH",6,1,.8571429,.1428571,7,1,0,0,0
"GARDY",8,1,.8888889,.1111111,9,1,0,0,0
"GARNET",8,0,1,0,8,1,0,1,0
"GENESE",0,5,0,1,5,0,1,0,1
"GERONIMO",6,0,1,0,6,1,0,1,0
"GIBRAN",8,0,1,0,8,1,0,1,0
"GIN",2,2,.5,.5,4,0,0,0,0
"GINNA",0,7,0,1,7,0,1,0,1
"GRETTA",0,4,0,1,4,0,1,0,1
"GRISELLE",0,5,0,1,5,0,1,0,1
"HAGAR",0,3,0,1,3,0,1,0,1
"HALE",4,4,.5,.5,8,0,0,0,0
"HARUKA",1,6,.1428571,.8571429,7,0,1,0,0
"HEIKE",0,8,0,1,8,0,1,0,1
"HENNING",8,0,1,0,8,1,0,1,0
"HERSHEY",5,1,.8333333,.1666667,6,1,0,0,0
"HIRA",1,7,.125,.875,8,0,1,0,0
"HIREN",9,0,1,0,9,1,0,1,0
"HISHAM",4,0,1,0,4,1,0,1,0
"HYO",3,5,.375,.625,8,0,0,0,0
"IGNAZIO",6,0,1,0,6,1,0,1,0
"IL",7,1,.875,.125,8,1,0,0,0
"ILIAS",5,0,1,0,5,1,0,1,0
"ILSA",0,5,0,1,5,0,1,0,1
"ITALO",6,0,1,0,6,1,0,1,0
"JACINDA",0,9,0,1,9,0,1,0,1
"JAHMAL",7,0,1,0,7,1,0,1,0
"JANNINE",0,8,0,1,8,0,1,0,1
"JARRAD",5,0,1,0,5,1,0,1,0
"JEAN-MICHEL",8,0,1,0,8,1,0,1,0
"JEF",6,0,1,0,6,1,0,1,0
"JENYA",1,6,.1428571,.8571429,7,0,1,0,0
"JERELL",7,0,1,0,7,1,0,1,0
"JERMAIN",6,0,1,0,6,1,0,1,0
"JEWELS",2,6,.25,.75,8,0,0,0,0
"JODI-ANN",0,8,0,1,8,0,1,0,1
"JOLA",0,6,0,1,6,0,1,0,1
"JOLYNN",0,4,0,1,4,0,1,0,1
"JOMO",9,0,1,0,9,1,0,1,0
"JOREL",7,1,.875,.125,8,1,0,0,0
"JOSEFINE",0,6,0,1,6,0,1,0,1
"JOSELIN",1,6,.1428571,.8571429,7,0,1,0,0
"JOVITA",0,9,0,1,9,0,1,0,1
"JUNO",4,3,.5714286,.4285714,7,0,0,0,0
"JUSTO",8,0,1,0,8,1,0,1,0
"KAJAL",0,4,0,1,4,0,1,0,1
"KALEENA",0,5,0,1,5,0,1,0,1
"KALYAN",9,0,1,0,9,1,0,1,0
"KAMARIA",0,8,0,1,8,0,1,0,1
"KAMISHA",0,8,0,1,8,0,1,0,1
"KANDI",0,7,0,1,7,0,1,0,1
"KARISA",0,7,0,1,7,0,1,0,1
"KATELYNN",0,4,0,1,4,0,1,0,1
"KAWANA",0,4,0,1,4,0,1,0,1
"KAYO",0,7,0,1,7,0,1,0,1
"KEE",4,6,.4,.6,10,0,0,0,0
"KEL",3,2,.6,.4,5,0,0,0,0
"KELSIE",1,3,.25,.75,4,0,0,0,0
"KENYON",8,1,.8888889,.1111111,9,1,0,0,0
"KENZIE",0,3,0,1,3,0,1,0,1
"KERIANN",0,6,0,1,6,0,1,0,1
"KERRIANNE",0,3,0,1,3,0,1,0,1
"KEYANNA",0,7,0,1,7,0,1,0,1
"KEYON",9,2,.8181818,.1818182,11,1,0,0,0
"KHANH",4,4,.5,.5,8,0,0,0,0
"KIMARA",0,9,0,1,9,0,1,0,1
"KIMBER",0,2,0,1,2,0,1,0,1
"KIMIKO",0,3,0,1,3,0,1,0,1
"KRYSTIAN",8,2,.8,.2,10,1,0,0,0
"KRYSTIN",0,7,0,1,7,0,1,0,1
"KUMI",0,5,0,1,5,0,1,0,1
"KUNLE",6,0,1,0,6,1,0,1,0
"KY",5,1,.8333333,.1666667,6,1,0,0,0
"LALITA",0,6,0,1,6,0,1,0,1
"LAMIA",0,9,0,1,9,0,1,0,1
"LAQUANA",0,8,0,1,8,0,1,0,1
"LAQUANDA",0,8,0,1,8,0,1,0,1
"LARYSSA",0,5,0,1,5,0,1,0,1
"LAU",4,5,.4444444,.5555556,9,0,0,0,0
"LAURALEE",0,8,0,1,8,0,1,0,1
"LAYNE",4,3,.5714286,.4285714,7,0,0,0,0
"LEEZA",0,5,0,1,5,0,1,0,1
"LENNON",6,1,.8571429,.1428571,7,1,0,0,0
"LICIA",0,4,0,1,4,0,1,0,1
"LILITH",0,8,0,1,8,0,1,0,1
"LILLA",0,8,0,1,8,0,1,0,1
"LINDITA",0,4,0,1,4,0,1,0,1
"LINNETTE",0,7,0,1,7,0,1,0,1
"LISANDRO",7,0,1,0,7,1,0,1,0
"LONNY",7,0,1,0,7,1,0,1,0
"LORE",1,7,.125,.875,8,0,1,0,0
"LOVELL",5,1,.8333333,.1666667,6,1,0,0,0
"LOYDA",0,9,0,1,9,0,1,0,1
"LUCRECIA",0,7,0,1,7,0,1,0,1
"LYSA",0,9,0,1,9,0,1,0,1
"LYSETTE",0,9,0,1,9,0,1,0,1
"LYUBOV",0,8,0,1,8,0,1,0,1
"MACHO",8,0,1,0,8,1,0,1,0
"MADELENE",0,5,0,1,5,0,1,0,1
"MADY",3,5,.375,.625,8,0,0,0,0
"MAGED",6,0,1,0,6,1,0,1,0
"MAGNOLIA",0,6,0,1,6,0,1,0,1
"MAIDA",0,9,0,1,9,0,1,0,1
"MAISIE",0,2,0,1,2,0,1,0,1
"MALVIN",9,0,1,0,9,1,0,1,0
"MALVINA",0,6,0,1,6,0,1,0,1
"MANA",1,4,.2,.8,5,0,1,0,0
"MARCELINO",7,0,1,0,7,1,0,1,0
"MARGIT",0,6,0,1,6,0,1,0,1
"MARIANELLA",0,8,0,1,8,0,1,0,1
"MARIELY",0,7,0,1,7,0,1,0,1
"MARTYNA",0,7,0,1,7,0,1,0,1
"MARYJO",0,4,0,1,4,0,1,0,1
"MASA",3,1,.75,.25,4,0,0,0,0
"MASAHIRO",7,0,1,0,7,1,0,1,0
"MAXIE",2,5,.2857143,.7142857,7,0,0,0,0
"MAYTE",0,5,0,1,5,0,1,0,1
"MAYU",0,8,0,1,8,0,1,0,1
"MEGA",4,2,.6666667,.3333333,6,0,0,0,0
"MEIRAV",0,2,0,1,2,0,1,0,1
"MELIH",5,0,1,0,5,1,0,1,0
"METE",7,0,1,0,7,1,0,1,0
"MICKIE",1,6,.1428571,.8571429,7,0,1,0,0
"MIHAI",7,0,1,0,7,1,0,1,0
"MIMA",0,9,0,1,9,0,1,0,1
"MINE",1,4,.2,.8,5,0,1,0,0
"MONIE",0,8,0,1,8,0,1,0,1
"MORTON",6,0,1,0,6,1,0,1,0
"MUSHKY",0,3,0,1,3,0,1,0,1
"NAIMAH",0,9,0,1,9,0,1,0,1
"NAIROBI",2,3,.4,.6,5,0,0,0,0
"NALA",2,5,.2857143,.7142857,7,0,0,0,0
"NARAYAN",9,0,1,0,9,1,0,1,0
"NARENDRA",9,0,1,0,9,1,0,1,0
"NARISSA",0,6,0,1,6,0,1,0,1
"NATIA",0,6,0,1,6,0,1,0,1
"NAUSHEEN",0,4,0,1,4,0,1,0,1
"NAVI",2,5,.2857143,.7142857,7,0,0,0,0
"NEMO",7,0,1,0,7,1,0,1,0
"NESS",5,1,.8333333,.1666667,6,1,0,0,0
"NICKEY",0,6,0,1,6,0,1,0,1
"NIMROD",8,0,1,0,8,1,0,1,0
"NINOSKA",0,7,0,1,7,0,1,0,1
"NIRMAL",4,0,1,0,4,1,0,1,0
"NONNA",0,7,0,1,7,0,1,0,1
"NOVELLA",0,8,0,1,8,0,1,0,1
"NYASHA",0,6,0,1,6,0,1,0,1
"NYASIA",0,6,0,1,6,0,1,0,1
"NYISHA",0,6,0,1,6,0,1,0,1
"ODELIA",0,5,0,1,5,0,1,0,1
"OKAN",8,0,1,0,8,1,0,1,0
"OLE",8,0,1,0,8,1,0,1,0
"OLUFEMI",7,0,1,0,7,1,0,1,0
"ONEIDA",0,6,0,1,6,0,1,0,1
"ONICA",0,6,0,1,6,0,1,0,1
"ORSON",8,0,1,0,8,1,0,1,0
"ORTIZ",3,3,.5,.5,6,0,0,0,0
"OSHANE",8,0,1,0,8,1,0,1,0
"PAK",5,3,.625,.375,8,0,0,0,0
"PAU",2,4,.3333333,.6666667,6,0,0,0,0
"PERNELL",9,0,1,0,9,1,0,1,0
"PORTER",5,0,1,0,5,1,0,1,0
"PRASAD",9,0,1,0,9,1,0,1,0
"PRASHANTH",7,0,1,0,7,1,0,1,0
"PRO",4,0,1,0,4,1,0,1,0
"RABI",4,0,1,0,4,1,0,1,0
"RAND",6,0,1,0,6,1,0,1,0
"RASHI",2,5,.2857143,.7142857,7,0,0,0,0
"RAYMON",8,0,1,0,8,1,0,1,0
"RAYNARD",7,0,1,0,7,1,0,1,0
"REE",1,3,.25,.75,4,0,0,0,0
"RENO",5,1,.8333333,.1666667,6,1,0,0,0
"REYNOLDS",5,0,1,0,5,1,0,1,0
"RICHY",6,0,1,0,6,1,0,1,0
"RIDWAN",7,0,1,0,7,1,0,1,0
"RITIKA",0,4,0,1,4,0,1,0,1
"RITZ",2,9,.1818182,.8181818,11,0,1,0,0
"RIVER",4,4,.5,.5,8,0,0,0,0
"ROMONA",0,8,0,1,8,0,1,0,1
"ROSETTE",0,9,0,1,9,0,1,0,1
"ROSSI",2,5,.2857143,.7142857,7,0,0,0,0
"RUCHIE",0,5,0,1,5,0,1,0,1
"RUPAL",0,4,0,1,4,0,1,0,1
"RUSH",5,2,.7142857,.2857143,7,0,0,0,0
"SAFRAZ",8,0,1,0,8,1,0,1,0
"SAINT",5,2,.7142857,.2857143,7,0,0,0,0
"SAMM",5,2,.7142857,.2857143,7,0,0,0,0
"SANAZ",0,4,0,1,4,0,1,0,1
"SANDOR",6,0,1,0,6,1,0,1,0
"SANTHOSH",7,0,1,0,7,1,0,1,0
"SARRA",0,4,0,1,4,0,1,0,1
"SASA",6,2,.75,.25,8,0,0,0,0
"SAYURI",0,4,0,1,4,0,1,0,1
"SEBASTIANO",8,0,1,0,8,1,0,1,0
"SEMI",3,5,.375,.625,8,0,0,0,0
"SEN",6,1,.8571429,.1428571,7,1,0,0,0
"SENAD",7,0,1,0,7,1,0,1,0
"SEO",3,2,.6,.4,5,0,0,0,0
"SERAFINA",0,5,0,1,5,0,1,0,1
"SERITA",0,9,0,1,9,0,1,0,1
"SHAHED",6,0,1,0,6,1,0,1,0
"SHAHRIAR",7,0,1,0,7,1,0,1,0
"SHAKEEM",6,0,1,0,6,1,0,1,0
"SHAM",4,1,.8,.2,5,1,0,0,0
"SHAMEEK",5,2,.7142857,.2857143,7,0,0,0,0
"SHANITA",0,7,0,1,7,0,1,0,1
"SHARENE",0,7,0,1,7,0,1,0,1
"SHATIMA",0,7,0,1,7,0,1,0,1
"SHAWNETTE",0,6,0,1,6,0,1,0,1
"SHEMIKA",0,5,0,1,5,0,1,0,1
"SHERVON",3,4,.4285714,.5714286,7,0,0,0,0
"SHIELA",0,5,0,1,5,0,1,0,1
"SHILPI",2,4,.3333333,.6666667,6,0,0,0,0
"SHIRAZ",7,1,.875,.125,8,1,0,0,0
"SHPRESA",0,7,0,1,7,0,1,0,1
"SHUCHI",0,7,0,1,7,0,1,0,1
"SHY",2,5,.2857143,.7142857,7,0,0,0,0
"SILKE",0,6,0,1,6,0,1,0,1
"SISI",0,7,0,1,7,0,1,0,1
"SLY",7,0,1,0,7,1,0,1,0
"SNOW",3,5,.375,.625,8,0,0,0,0
"SOFI",0,3,0,1,3,0,1,0,1
"SOMA",1,4,.2,.8,5,0,1,0,0
"SOMMER",0,5,0,1,5,0,1,0,1
"SOYEON",0,5,0,1,5,0,1,0,1
"SOYOUNG",0,2,0,1,2,0,1,0,1
"SPYROS",7,0,1,0,7,1,0,1,0
"SRI",5,4,.5555556,.4444444,9,0,0,0,0
"STACYANN",0,6,0,1,6,0,1,0,1
"STEFFAN",6,0,1,0,6,1,0,1,0
"STEFFANIE",0,2,0,1,2,0,1,0,1
"STEPHIE",0,3,0,1,3,0,1,0,1
"SULE",4,2,.6666667,.3333333,6,0,0,0,0
"SULEYMAN",6,0,1,0,6,1,0,1,0
"SUZZETTE",0,7,0,1,7,0,1,0,1
"SWAPNA",0,3,0,1,3,0,1,0,1
"SWETHA",0,8,0,1,8,0,1,0,1
"SYLVANA",0,5,0,1,5,0,1,0,1
"TAHIRAH",0,7,0,1,7,0,1,0,1
"TAHISHA",0,9,0,1,9,0,1,0,1
"TAKA",6,0,1,0,6,1,0,1,0
"TAKIYAH",0,5,0,1,5,0,1,0,1
"TALAL",6,0,1,0,6,1,0,1,0
"TAMAS",10,0,1,0,10,1,0,1,0
"TAPAN",7,0,1,0,7,1,0,1,0
"TEHILA",0,4,0,1,4,0,1,0,1
"TERA",0,11,0,1,11,0,1,0,1
"TERE",0,3,0,1,3,0,1,0,1
"TERRYANN",0,9,0,1,9,0,1,0,1
"THIBAULT",2,0,1,0,2,1,0,1,0
"TIEN",3,4,.4285714,.5714286,7,0,0,0,0
"TIKI",3,5,.375,.625,8,0,0,0,0
"TOMEK",4,0,1,0,4,1,0,1,0
"TOMOMI",0,4,0,1,4,0,1,0,1
"TOREY",4,3,.5714286,.4285714,7,0,0,0,0
"TORRE",3,5,.375,.625,8,0,0,0,0
"TRACE",4,2,.6666667,.3333333,6,0,0,0,0
"TRI",5,2,.7142857,.2857143,7,0,0,0,0
"TRINI",5,6,.4545455,.5454546,11,0,0,0,0
"TUBA",0,3,0,1,3,0,1,0,1
"TURNER",3,3,.5,.5,6,0,0,0,0
"ULI",6,2,.75,.25,8,0,0,0,0
"UMER",6,0,1,0,6,1,0,1,0
"VALERIYA",0,8,0,1,8,0,1,0,1
"VEGA",7,0,1,0,7,1,0,1,0
"VENETIA",0,6,0,1,6,0,1,0,1
"VIKA",0,3,0,1,3,0,1,0,1
"WALDEMAR",8,0,1,0,8,1,0,1,0
"WAQAR",5,0,1,0,5,1,0,1,0
"WEST",1,1,.5,.5,2,0,0,0,0
"WINNY",0,3,0,1,3,0,1,0,1
"WYLIE",5,1,.8333333,.1666667,6,1,0,0,0
"WYNN",6,1,.8571429,.1428571,7,1,0,0,0
"YALITZA",0,7,0,1,7,0,1,0,1
"YAMILET",0,5,0,1,5,0,1,0,1
"YARDEN",2,2,.5,.5,4,0,0,0,0
"YASHA",7,0,1,0,7,1,0,1,0
"YASUKO",0,5,0,1,5,0,1,0,1
"YECENIA",0,6,0,1,6,0,1,0,1
"YIGAL",6,1,.8571429,.1428571,7,1,0,0,0
"YITZ",7,0,1,0,7,1,0,1,0
"YITZCHOK",6,0,1,0,6,1,0,1,0
"YONIT",0,6,0,1,6,0,1,0,1
"YOO",2,5,.2857143,.7142857,7,0,0,0,0
"YOSELIN",0,7,0,1,7,0,1,0,1
"YOSHIKO",0,5,0,1,5,0,1,0,1
"YUKIE",0,4,0,1,4,0,1,0,1
"YURIKO",0,4,0,1,4,0,1,0,1
"ZAHEER",9,0,1,0,9,1,0,1,0
"ZAKIYYAH",0,9,0,1,9,0,1,0,1
"ZARAH",0,5,0,1,5,0,1,0,1
"ZETA",2,6,.25,.75,8,0,0,0,0
"ZIV",3,1,.75,.25,4,0,0,0,0
"ZULEMA",0,6,0,1,6,0,1,0,1
"ABIMBOLA",2,3,.4,.6,5,0,0,0,0
"ADMIR",10,0,1,0,10,1,0,1,0
"ADRI",1,4,.2,.8,5,0,1,0,0
"AFIA",0,3,0,1,3,0,1,0,1
"AFUA",0,5,0,1,5,0,1,0,1
"AICHA",0,7,0,1,7,0,1,0,1
"AISHAH",0,7,0,1,7,0,1,0,1
"ALCIDES",7,0,1,0,7,1,0,1,0
"ALEIDA",0,6,0,1,6,0,1,0,1
"ALEXANDREA",0,7,0,1,7,0,1,0,1
"ALISSON",2,5,.2857143,.7142857,7,0,0,0,0
"ALSTON",5,1,.8333333,.1666667,6,1,0,0,0
"ALVA",2,4,.3333333,.6666667,6,0,0,0,0
"ALWYN",7,1,.875,.125,8,1,0,0,0
"AMADA",0,7,0,1,7,0,1,0,1
"AMEDEO",6,0,1,0,6,1,0,1,0
"AMEET",7,0,1,0,7,1,0,1,0
"AMEL",2,3,.4,.6,5,0,0,0,0
"AMOR",4,3,.5714286,.4285714,7,0,0,0,0
"ANDRAS",4,0,1,0,4,1,0,1,0
"ANDREJ",5,0,1,0,5,1,0,1,0
"ANDREWS",5,1,.8333333,.1666667,6,1,0,0,0
"ANIK",1,1,.5,.5,2,0,0,0,0
"ANNABELLA",0,5,0,1,5,0,1,0,1
"ANNALISE",0,2,0,1,2,0,1,0,1
"ANUSHA",0,8,0,1,8,0,1,0,1
"APURVA",7,1,.875,.125,8,1,0,0,0
"ARDIT",6,0,1,0,6,1,0,1,0
"ARIADNA",0,7,0,1,7,0,1,0,1
"ARKADIUSZ",5,0,1,0,5,1,0,1,0
"ARTA",0,5,0,1,5,0,1,0,1
"ATAKAN",7,0,1,0,7,1,0,1,0
"ATEF",9,0,1,0,9,1,0,1,0
"AUDIE",2,2,.5,.5,4,0,0,0,0
"AUGUSTA",0,7,0,1,7,0,1,0,1
"AUGUSTINA",0,6,0,1,6,0,1,0,1
"AVE",1,6,.1428571,.8571429,7,0,1,0,0
"AVRUMI",5,0,1,0,5,1,0,1,0
"AYINDE",5,1,.8333333,.1666667,6,1,0,0,0
"AYÅ_EGÃœL",0,5,0,1,5,0,1,0,1
"BAILA",0,5,0,1,5,0,1,0,1
"BARAN",6,0,1,0,6,1,0,1,0
"BARRON",7,0,1,0,7,1,0,1,0
"BASSEM",7,0,1,0,7,1,0,1,0
"BEAT",6,0,1,0,6,1,0,1,0
"BECKI",0,5,0,1,5,0,1,0,1
"BECKIE",0,8,0,1,8,0,1,0,1
"BENI",6,0,1,0,6,1,0,1,0
"BENJIE",9,1,.9,.1,10,1,0,0,0
"BENTLEY",9,0,1,0,9,1,0,1,0
"BERNA",0,5,0,1,5,0,1,0,1
"BERNHARD",6,0,1,0,6,1,0,1,0
"BEST",4,4,.5,.5,8,0,0,0,0
"BETTYANN",0,7,0,1,7,0,1,0,1
"BHAVESH",5,0,1,0,5,1,0,1,0
"BIKRAM",4,2,.6666667,.3333333,6,0,0,0,0
"BINH",4,1,.8,.2,5,1,0,0,0
"BLAYNE",0,2,0,1,2,0,1,0,1
"BLEDAR",8,0,1,0,8,1,0,1,0
"BLERIM",10,0,1,0,10,1,0,1,0
"BLERTA",1,6,.1428571,.8571429,7,0,1,0,0
"BONG",7,1,.875,.125,8,1,0,0,0
"BORN",4,1,.8,.2,5,1,0,0,0
"BOSCO",6,1,.8571429,.1428571,7,1,0,0,0
"BRANDAN",6,0,1,0,6,1,0,1,0
"BRE",0,6,0,1,6,0,1,0,1
"BRIDIE",0,7,0,1,7,0,1,0,1
"BRYANNA",0,4,0,1,4,0,1,0,1
"BRYSON",3,1,.75,.25,4,0,0,0,0
"BUDDHA",8,0,1,0,8,1,0,1,0
"CARISA",0,3,0,1,3,0,1,0,1
"CARLITOS",9,0,1,0,9,1,0,1,0
"CARMELINA",0,6,0,1,6,0,1,0,1
"CARMIT",0,4,0,1,4,0,1,0,1
"CATA",0,7,0,1,7,0,1,0,1
"CEASAR",5,0,1,0,5,1,0,1,0
"CEO",7,1,.875,.125,8,1,0,0,0
"CHAY",0,5,0,1,5,0,1,0,1
"CHENELLE",0,5,0,1,5,0,1,0,1
"CHEUNG",3,3,.5,.5,6,0,0,0,0
"CHEZ",1,2,.3333333,.6666667,3,0,0,0,0
"CHIA",0,5,0,1,5,0,1,0,1
"CHRISTIANNA",0,6,0,1,6,0,1,0,1
"CHUCKY",6,1,.8571429,.1428571,7,1,0,0,0
"CINNAMON",0,8,0,1,8,0,1,0,1
"CIPRIAN",6,0,1,0,6,1,0,1,0
"CLEVE",6,0,1,0,6,1,0,1,0
"COLTON",6,0,1,0,6,1,0,1,0
"CONO",7,0,1,0,7,1,0,1,0
"CONSTANZA",0,5,0,1,5,0,1,0,1
"CORRY",3,2,.6,.4,5,0,0,0,0
"CRICKET",1,5,.1666667,.8333333,6,0,1,0,0
"CULLEN",7,1,.875,.125,8,1,0,0,0
"DAGMAR",0,6,0,1,6,0,1,0,1
"DANIIL",3,0,1,0,3,1,0,1,0
"DANYEL",0,3,0,1,3,0,1,0,1
"DARCI",0,7,0,1,7,0,1,0,1
"DARIANA",0,5,0,1,5,0,1,0,1
"DARIEL",5,1,.8333333,.1666667,6,1,0,0,0
"DARLING",0,7,0,1,7,0,1,0,1
"DARRICK",5,0,1,0,5,1,0,1,0
"DAYLE",0,2,0,1,2,0,1,0,1
"DEACON",5,0,1,0,5,1,0,1,0
"DEISY",0,6,0,1,6,0,1,0,1
"DENI",2,2,.5,.5,4,0,0,0,0
"DENISA",0,4,0,1,4,0,1,0,1
"DENNIE",2,2,.5,.5,4,0,0,0,0
"DENYS",5,1,.8333333,.1666667,6,1,0,0,0
"DEWEY",7,0,1,0,7,1,0,1,0
"DIJON",5,1,.8333333,.1666667,6,1,0,0,0
"DINARA",0,7,0,1,7,0,1,0,1
"DING",6,2,.75,.25,8,0,0,0,0
"DINORAH",0,7,0,1,7,0,1,0,1
"DIONA",0,6,0,1,6,0,1,0,1
"DIONE",1,5,.1666667,.8333333,6,0,1,0,0
"DIONIS",6,2,.75,.25,8,0,0,0,0
"DONNETTE",0,9,0,1,9,0,1,0,1
"DOUGIE",7,0,1,0,7,1,0,1,0
"DRITA",0,8,0,1,8,0,1,0,1
"DUSAN",7,0,1,0,7,1,0,1,0
"EAZY",6,1,.8571429,.1428571,7,1,0,0,0
"EBENEZER",9,0,1,0,9,1,0,1,0
"EDEL",2,1,.6666667,.3333333,3,0,0,0,0
"ELDAD",6,0,1,0,6,1,0,1,0
"ELIS",4,2,.6666667,.3333333,6,0,0,0,0
"ELSPETH",0,5,0,1,5,0,1,0,1
"ELYSA",0,5,0,1,5,0,1,0,1
"EMELYN",0,5,0,1,5,0,1,0,1
"EMMET",7,0,1,0,7,1,0,1,0
"EMMIE",1,8,.1111111,.8888889,9,0,1,0,0
"ERMAL",7,0,1,0,7,1,0,1,0
"ERNESTINA",0,9,0,1,9,0,1,0,1
"EUNYOUNG",0,5,0,1,5,0,1,0,1
"EVELYNE",0,5,0,1,5,0,1,0,1
"EVER",7,0,1,0,7,1,0,1,0
"FAB",4,3,.5714286,.4285714,7,0,0,0,0
"FAIGY",0,6,0,1,6,0,1,0,1
"FARIS",7,0,1,0,7,1,0,1,0
"FARRUKH",7,0,1,0,7,1,0,1,0
"FELISA",0,7,0,1,7,0,1,0,1
"FISH",6,3,.6666667,.3333333,9,0,0,0,0
"FLORINA",0,8,0,1,8,0,1,0,1
"FORTUNE",3,3,.5,.5,6,0,0,0,0
"FREDERICO",5,0,1,0,5,1,0,1,0
"FREEDOM",5,3,.625,.375,8,0,0,0,0
"FRESH",2,1,.6666667,.3333333,3,0,0,0,0
"FULL",4,1,.8,.2,5,1,0,0,0
"GAIA",0,7,0,1,7,0,1,0,1
"GARLAND",6,2,.75,.25,8,0,0,0,0
"GASPARE",5,0,1,0,5,1,0,1,0
"GAURI",0,2,0,1,2,0,1,0,1
"GENISE",0,8,0,1,8,0,1,0,1
"GEORG",6,0,1,0,6,1,0,1,0
"GEORGIANNA",0,6,0,1,6,0,1,0,1
"GERHARD",4,0,1,0,4,1,0,1,0
"GERSHON",6,0,1,0,6,1,0,1,0
"GET",5,1,.8333333,.1666667,6,1,0,0,0
"GIADA",0,3,0,1,3,0,1,0,1
"GIANNIS",5,0,1,0,5,1,0,1,0
"GIFTY",0,5,0,1,5,0,1,0,1
"GISSEL",0,7,0,1,7,0,1,0,1
"GIULIANO",7,0,1,0,7,1,0,1,0
"GIUSEPPINA",0,7,0,1,7,0,1,0,1
"GLENDY",0,3,0,1,3,0,1,0,1
"GLYN",4,2,.6666667,.3333333,6,0,0,0,0
"GOZDE",0,6,0,1,6,0,1,0,1
"GUL",1,4,.2,.8,5,0,1,0,0
"GWENN",0,6,0,1,6,0,1,0,1
"HABIBA",0,6,0,1,6,0,1,0,1
"HAIDER",6,0,1,0,6,1,0,1,0
"HANNIBAL",6,0,1,0,6,1,0,1,0
"HANNY",0,7,0,1,7,0,1,0,1
"HAYES",1,4,.2,.8,5,0,1,0,0
"HENDRIK",7,0,1,0,7,1,0,1,0
"HESTER",0,6,0,1,6,0,1,0,1
"HOLLAND",3,2,.6,.4,5,0,0,0,0
"HON",7,0,1,0,7,1,0,1,0
"HUAN",4,4,.5,.5,8,0,0,0,0
"HYEJIN",0,5,0,1,5,0,1,0,1
"IBRAHIMA",7,0,1,0,7,1,0,1,0
"IKENNA",6,0,1,0,6,1,0,1,0
"ILANIT",0,5,0,1,5,0,1,0,1
"ILYAS",9,0,1,0,9,1,0,1,0
"IMA",1,6,.1428571,.8571429,7,0,1,0,0
"INBAR",1,4,.2,.8,5,0,1,0,0
"INDIGO",1,4,.2,.8,5,0,1,0,0
"IQRA",0,5,0,1,5,0,1,0,1
"ITZIK",6,0,1,0,6,1,0,1,0
"IVIE",0,6,0,1,6,0,1,0,1
"IVONA",0,6,0,1,6,0,1,0,1
"IZA",0,5,0,1,5,0,1,0,1
"JADEN",6,1,.8571429,.1428571,7,1,0,0,0
"JAHMEL",9,0,1,0,9,1,0,1,0
"JALEN",7,0,1,0,7,1,0,1,0
"JALIL",9,0,1,0,9,1,0,1,0
"JAMEE",0,5,0,1,5,0,1,0,1
"JAMEELA",0,9,0,1,9,0,1,0,1
"JAMELIA",0,10,0,1,10,0,1,0,1
"JAMELLA",0,7,0,1,7,0,1,0,1
"JANN",1,4,.2,.8,5,0,1,0,0
"JANNET",0,6,0,1,6,0,1,0,1
"JAREL",7,0,1,0,7,1,0,1,0
"JATIN",6,0,1,0,6,1,0,1,0
"JEMIMA",0,8,0,1,8,0,1,0,1
"JENELL",0,4,0,1,4,0,1,0,1
"JENESSA",0,4,0,1,4,0,1,0,1
"JERMEL",7,0,1,0,7,1,0,1,0
"JERROD",4,0,1,0,4,1,0,1,0
"JESSAMYN",0,4,0,1,4,0,1,0,1
"JOHANE",0,5,0,1,5,0,1,0,1
"JOHNATHON",7,0,1,0,7,1,0,1,0
"JOLLY",3,3,.5,.5,6,0,0,0,0
"JONATAN",7,0,1,0,7,1,0,1,0
"JONO",5,0,1,0,5,1,0,1,0
"JOSEFA",0,8,0,1,8,0,1,0,1
"JOSIP",7,0,1,0,7,1,0,1,0
"JOZEF",6,0,1,0,6,1,0,1,0
"KADIA",0,5,0,1,5,0,1,0,1
"KALMAN",4,0,1,0,4,1,0,1,0
"KAMINI",0,7,0,1,7,0,1,0,1
"KAMRUL",4,0,1,0,4,1,0,1,0
"KARIE",0,5,0,1,5,0,1,0,1
"KARIMAH",0,7,0,1,7,0,1,0,1
"KARISMA",0,4,0,1,4,0,1,0,1
"KASEEM",6,0,1,0,6,1,0,1,0
"KATIRIA",0,7,0,1,7,0,1,0,1
"KATRICE",0,7,0,1,7,0,1,0,1
"KAYLIE",0,6,0,1,6,0,1,0,1
"KEHINDE",4,3,.5714286,.4285714,7,0,0,0,0
"KEIR",6,3,.6666667,.3333333,9,0,0,0,0
"KEMBA",1,5,.1666667,.8333333,6,0,1,0,0
"KENESHA",0,2,0,1,2,0,1,0,1
"KERIANNE",0,4,0,1,4,0,1,0,1
"KERRIANN",0,5,0,1,5,0,1,0,1
"KERYN",0,3,0,1,3,0,1,0,1
"KEYUR",10,0,1,0,10,1,0,1,0
"KIEL",8,0,1,0,8,1,0,1,0
"KILLIAN",4,1,.8,.2,5,1,0,0,0
"KIMMI",0,5,0,1,5,0,1,0,1
"KIRT",7,0,1,0,7,1,0,1,0
"KIRTI",2,3,.4,.6,5,0,0,0,0
"KIYA",0,7,0,1,7,0,1,0,1
"KUAN",5,0,1,0,5,1,0,1,0
"KYRON",7,0,1,0,7,1,0,1,0
"LAKIESHA",0,9,0,1,9,0,1,0,1
"LAMA",1,5,.1666667,.8333333,6,0,1,0,0
"LANETTE",0,5,0,1,5,0,1,0,1
"LANGSTON",7,0,1,0,7,1,0,1,0
"LANRE",7,0,1,0,7,1,0,1,0
"LATIF",7,0,1,0,7,1,0,1,0
"LAVONNE",0,7,0,1,7,0,1,0,1
"LEFTY",7,1,.875,.125,8,1,0,0,0
"LEM",5,0,1,0,5,1,0,1,0
"LEMAR",5,0,1,0,5,1,0,1,0
"LEMON",3,3,.5,.5,6,0,0,0,0
"LESIA",0,8,0,1,8,0,1,0,1
"LESLYN",0,6,0,1,6,0,1,0,1
"LEVAN",7,0,1,0,7,1,0,1,0
"LEYNA",0,6,0,1,6,0,1,0,1
"LIAN",1,4,.2,.8,5,0,1,0,0
"LILACH",0,7,0,1,7,0,1,0,1
"LISI",0,6,0,1,6,0,1,0,1
"LORENE",0,5,0,1,5,0,1,0,1
"LOUELLA",0,8,0,1,8,0,1,0,1
"LUCIENNE",0,7,0,1,7,0,1,0,1
"LY",3,4,.4285714,.5714286,7,0,0,0,0
"MADDALENA",0,6,0,1,6,0,1,0,1
"MAGDALENE",0,5,0,1,5,0,1,0,1
"MAHMOOD",6,0,1,0,6,1,0,1,0
"MAINE",5,1,.8333333,.1666667,6,1,0,0,0
"MAK",2,2,.5,.5,4,0,0,0,0
"MALENE",0,6,0,1,6,0,1,0,1
"MALKIE",0,6,0,1,6,0,1,0,1
"MANJIT",6,2,.75,.25,8,0,0,0,0
"MARCIAL",7,0,1,0,7,1,0,1,0
"MARGRÃ‰T",0,7,0,1,7,0,1,0,1
"MARINELA",0,8,0,1,8,0,1,0,1
"MARIOLA",0,6,0,1,6,0,1,0,1
"MARIT",0,5,0,1,5,0,1,0,1
"MARIUXI",0,8,0,1,8,0,1,0,1
"MARKETA",0,6,0,1,6,0,1,0,1
"MARU",2,5,.2857143,.7142857,7,0,0,0,0
"MARY-JANE",0,8,0,1,8,0,1,0,1
"MASAKI",7,0,1,0,7,1,0,1,0
"MASOOD",6,0,1,0,6,1,0,1,0
"MASUD",6,0,1,0,6,1,0,1,0
"MEGGAN",0,5,0,1,5,0,1,0,1
"MELA",0,6,0,1,6,0,1,0,1
"MELIDA",0,6,0,1,6,0,1,0,1
"MERISSA",0,5,0,1,5,0,1,0,1
"MERRYL",0,8,0,1,8,0,1,0,1
"MESUT",6,0,1,0,6,1,0,1,0
"METTE",0,3,0,1,3,0,1,0,1
"MIKAYLA",0,4,0,1,4,0,1,0,1
"MILEN",6,1,.8571429,.1428571,7,1,0,0,0
"MILK",3,2,.6,.4,5,0,0,0,0
"MIMOZA",0,7,0,1,7,0,1,0,1
"MINAKO",0,5,0,1,5,0,1,0,1
"MINI",1,5,.1666667,.8333333,6,0,1,0,0
"MINYOUNG",2,4,.3333333,.6666667,6,0,0,0,0
"MIRSADA",0,5,0,1,5,0,1,0,1
"MITZIE",0,9,0,1,9,0,1,0,1
"MOEZ",4,0,1,0,4,1,0,1,0
"MONALISA",0,6,0,1,6,0,1,0,1
"MONROE",3,2,.6,.4,5,0,0,0,0
"MORDECAI",5,1,.8333333,.1666667,6,1,0,0,0
"MORGEN",1,5,.1666667,.8333333,6,0,1,0,0
"MOUSTAPHA",7,0,1,0,7,1,0,1,0
"MYISHA",0,6,0,1,6,0,1,0,1
"NADIYA",0,5,0,1,5,0,1,0,1
"NAEEMAH",0,8,0,1,8,0,1,0,1
"NAISHA",0,8,0,1,8,0,1,0,1
"NAJLA",0,6,0,1,6,0,1,0,1
"NAOMIE",0,3,0,1,3,0,1,0,1
"NASRIN",0,8,0,1,8,0,1,0,1
"NATALLIA",0,5,0,1,5,0,1,0,1
"NATANYA",0,3,0,1,3,0,1,0,1
"NAUMAN",7,0,1,0,7,1,0,1,0
"NAYA",0,2,0,1,2,0,1,0,1
"NEKEISHA",0,9,0,1,9,0,1,0,1
"NESLIHAN",0,2,0,1,2,0,1,0,1
"NICA",0,5,0,1,5,0,1,0,1
"NICCOLE",0,8,0,1,8,0,1,0,1
"NIECY",0,7,0,1,7,0,1,0,1
"NIEVES",3,6,.3333333,.6666667,9,0,0,0,0
"NILAY",4,1,.8,.2,5,1,0,0,0
"NILES",7,0,1,0,7,1,0,1,0
"NIVIA",0,4,0,1,4,0,1,0,1
"NUNO",6,0,1,0,6,1,0,1,0
"NURY",0,6,0,1,6,0,1,0,1
"NYESHA",0,9,0,1,9,0,1,0,1
"NYLA",0,7,0,1,7,0,1,0,1
"NYOKA",0,6,0,1,6,0,1,0,1
"OBED",5,0,1,0,5,1,0,1,0
"OBINNA",7,0,1,0,7,1,0,1,0
"OFELIA",0,8,0,1,8,0,1,0,1
"OLAF",7,0,1,0,7,1,0,1,0
"OLIMPIA",0,6,0,1,6,0,1,0,1
"ONIEL",5,0,1,0,5,1,0,1,0
"OONA",0,4,0,1,4,0,1,0,1
"ORRIN",6,0,1,0,6,1,0,1,0
"PARAS",5,0,1,0,5,1,0,1,0
"PARMINDER",3,2,.6,.4,5,0,0,0,0
"PAWAN",7,1,.875,.125,8,1,0,0,0
"PETA-GAYE",0,4,0,1,4,0,1,0,1
"PIEDAD",0,6,0,1,6,0,1,0,1
"PIER",4,4,.5,.5,8,0,0,0,0
"PIXIE",0,6,0,1,6,0,1,0,1
"PO",4,3,.5714286,.4285714,7,0,0,0,0
"PORSCHE",1,6,.1428571,.8571429,7,0,1,0,0
"PRAVIN",9,0,1,0,9,1,0,1,0
"PREETHI",0,4,0,1,4,0,1,0,1
"PRICE",4,2,.6666667,.3333333,6,0,0,0,0
"PRZEMYSLAW",6,0,1,0,6,1,0,1,0
"PUNIT",8,0,1,0,8,1,0,1,0
"PURA",0,7,0,1,7,0,1,0,1
"QUANA",1,9,.1,.9,10,0,1,0,0
"QUANG",7,0,1,0,7,1,0,1,0
"QUEEN",0,5,0,1,5,0,1,0,1
"RACH",0,3,0,1,3,0,1,0,1
"RAHAT",4,0,1,0,4,1,0,1,0
"RAHEL",0,6,0,1,6,0,1,0,1
"RAMELL",7,0,1,0,7,1,0,1,0
"RAMEZ",7,0,1,0,7,1,0,1,0
"RAMOS",1,3,.25,.75,4,0,0,0,0
"RASHARD",7,0,1,0,7,1,0,1,0
"RASHEEDAH",0,6,0,1,6,0,1,0,1
"RAYNE",4,5,.4444444,.5555556,9,0,0,0,0
"RE",3,3,.5,.5,6,0,0,0,0
"REBEL",5,1,.8333333,.1666667,6,1,0,0,0
"REECE",4,2,.6666667,.3333333,6,0,0,0,0
"REMINGTON",4,0,1,0,4,1,0,1,0
"RENI",1,2,.3333333,.6666667,3,0,0,0,0
"RI",3,2,.6,.4,5,0,0,0,0
"RISHABH",7,0,1,0,7,1,0,1,0
"RIZ",2,1,.6666667,.3333333,3,0,0,0,0
"RODDY",8,0,1,0,8,1,0,1,0
"ROISIN",0,5,0,1,5,0,1,0,1
"ROLF",7,0,1,0,7,1,0,1,0
"ROMERO",6,1,.8571429,.1428571,7,1,0,0,0
"ROODY",8,0,1,0,8,1,0,1,0
"ROOPA",0,4,0,1,4,0,1,0,1
"RUEL",7,0,1,0,7,1,0,1,0
"SABRENA",0,8,0,1,8,0,1,0,1
"SACHI",1,6,.1428571,.8571429,7,0,1,0,0
"SAFIA",0,7,0,1,7,0,1,0,1
"SAJJAD",5,0,1,0,5,1,0,1,0
"SALEH",8,0,1,0,8,1,0,1,0
"SALIL",5,0,1,0,5,1,0,1,0
"SAMEERA",0,6,0,1,6,0,1,0,1
"SARWAR",6,0,1,0,6,1,0,1,0
"SATYA",3,4,.4285714,.5714286,7,0,0,0,0
"SEDAT",7,1,.875,.125,8,1,0,0,0
"SEE",2,1,.6666667,.3333333,3,0,0,0,0
"SERENITY",0,6,0,1,6,0,1,0,1
"SERRA",0,7,0,1,7,0,1,0,1
"SHAAN",6,1,.8571429,.1428571,7,1,0,0,0
"SHABNAM",0,6,0,1,6,0,1,0,1
"SHADE",0,8,0,1,8,0,1,0,1
"SHAHIDA",0,8,0,1,8,0,1,0,1
"SHAKILA",0,7,0,1,7,0,1,0,1
"SHAKIM",8,0,1,0,8,1,0,1,0
"SHALA",1,7,.125,.875,8,0,1,0,0
"SHAMEIKA",0,7,0,1,7,0,1,0,1
"SHANAZ",0,6,0,1,6,0,1,0,1
"SHANIA",0,7,0,1,7,0,1,0,1
"SHANTAY",0,8,0,1,8,0,1,0,1
"SHARIFF",7,0,1,0,7,1,0,1,0
"SHAUNDA",0,9,0,1,9,0,1,0,1
"SHAUNNA",0,8,0,1,8,0,1,0,1
"SHAVONE",0,3,0,1,3,0,1,0,1
"SHEINA",0,5,0,1,5,0,1,0,1
"SHENEQUA",0,8,0,1,8,0,1,0,1
"SHERELL",0,4,0,1,4,0,1,0,1
"SHERIDAN",0,4,0,1,4,0,1,0,1
"SHERRYANN",0,7,0,1,7,0,1,0,1
"SHEVONNE",0,5,0,1,5,0,1,0,1
"SHILOH",4,2,.6666667,.3333333,6,0,0,0,0
"SHIMUL",2,3,.4,.6,5,0,0,0,0
"SHING",5,0,1,0,5,1,0,1,0
"SHIRELLE",0,4,0,1,4,0,1,0,1
"SHOAIB",7,0,1,0,7,1,0,1,0
"SHOTTA",6,2,.75,.25,8,0,0,0,0
"SIDHARTH",2,0,1,0,2,1,0,1,0
"SIGNE",0,4,0,1,4,0,1,0,1
"SILVINA",0,6,0,1,6,0,1,0,1
"SINGH",5,0,1,0,5,1,0,1,0
"SION",6,0,1,0,6,1,0,1,0
"SMITHA",0,6,0,1,6,0,1,0,1
"SOCORRO",0,6,0,1,6,0,1,0,1
"SOHEL",8,0,1,0,8,1,0,1,0
"STEFF",0,5,0,1,5,0,1,0,1
"STELIOS",6,0,1,0,6,1,0,1,0
"STEVENSON",8,0,1,0,8,1,0,1,0
"STINA",0,6,0,1,6,0,1,0,1
"STONE",7,2,.7777778,.2222222,9,1,0,0,0
"SUAD",3,4,.4285714,.5714286,7,0,0,0,0
"SUJIT",6,0,1,0,6,1,0,1,0
"SUMA",0,5,0,1,5,0,1,0,1
"SURYA",2,2,.5,.5,4,0,0,0,0
"SUSHMA",0,5,0,1,5,0,1,0,1
"SYNTHIA",0,8,0,1,8,0,1,0,1
"SZE",3,2,.6,.4,5,0,0,0,0
"TABETHA",0,5,0,1,5,0,1,0,1
"TAIMUR",6,0,1,0,6,1,0,1,0
"TAKIA",0,6,0,1,6,0,1,0,1
"TAMERA",0,5,0,1,5,0,1,0,1
"TAMIEKA",0,7,0,1,7,0,1,0,1
"TANER",6,0,1,0,6,1,0,1,0
"TASHAWN",5,0,1,0,5,1,0,1,0
"TAT",4,0,1,0,4,1,0,1,0
"TAYE",5,1,.8333333,.1666667,6,1,0,0,0
"TEMITOPE",1,6,.1428571,.8571429,7,0,1,0,0
"TEN",3,2,.6,.4,5,0,0,0,0
"TERREL",6,1,.8571429,.1428571,7,1,0,0,0
"TERRIANN",0,5,0,1,5,0,1,0,1
"TETYANA",0,6,0,1,6,0,1,0,1
"TOBEY",2,5,.2857143,.7142857,7,0,0,0,0
"TOBIN",4,0,1,0,4,1,0,1,0
"TOLA",2,4,.3333333,.6666667,6,0,0,0,0
"TOPE",2,2,.5,.5,4,0,0,0,0
"TOR",5,1,.8333333,.1666667,6,1,0,0,0
"TREMAINE",8,0,1,0,8,1,0,1,0
"TREMAYNE",9,0,1,0,9,1,0,1,0
"TUDOR",7,0,1,0,7,1,0,1,0
"TULIO",5,0,1,0,5,1,0,1,0
"TWIN",4,1,.8,.2,5,1,0,0,0
"TZIPORA",0,3,0,1,3,0,1,0,1
"UTKU",6,0,1,0,6,1,0,1,0
"VANDA",0,7,0,1,7,0,1,0,1
"VANJA",2,3,.4,.6,5,0,0,0,0
"VANNA",0,7,0,1,7,0,1,0,1
"VERONA",0,8,0,1,8,0,1,0,1
"VIENNA",0,6,0,1,6,0,1,0,1
"VINA",0,6,0,1,6,0,1,0,1
"VINIT",6,0,1,0,6,1,0,1,0
"VINITA",0,7,0,1,7,0,1,0,1
"VIRAJ",7,0,1,0,7,1,0,1,0
"VISH",5,0,1,0,5,1,0,1,0
"WALLIS",1,4,.2,.8,5,0,1,0,0
"WALTON",4,0,1,0,4,1,0,1,0
"WILBERTO",7,0,1,0,7,1,0,1,0
"XIA",1,7,.125,.875,8,0,1,0,0
"YAACOV",3,0,1,0,3,1,0,1,0
"YALE",9,0,1,0,9,1,0,1,0
"YANNIS",5,0,1,0,5,1,0,1,0
"YAROSLAV",7,0,1,0,7,1,0,1,0
"YAVUZ",5,0,1,0,5,1,0,1,0
"YEFIM",8,0,1,0,8,1,0,1,0
"YENI",0,6,0,1,6,0,1,0,1
"YEVGENY",5,0,1,0,5,1,0,1,0
"YIFAN",4,1,.8,.2,5,1,0,0,0
"YILMAZ",6,0,1,0,6,1,0,1,0
"YOHANNY",1,8,.1111111,.8888889,9,0,1,0,0
"YOSUKE",7,0,1,0,7,1,0,1,0
"ZAHIR",9,0,1,0,9,1,0,1,0
"ZIVA",0,4,0,1,4,0,1,0,1
"ZULEYKA",0,8,0,1,8,0,1,0,1
"ABDOU",6,0,1,0,6,1,0,1,0
"ABHIJIT",2,0,1,0,2,1,0,1,0
"ABHILASH",9,0,1,0,9,1,0,1,0
"AD",4,3,.5714286,.4285714,7,0,0,0,0
"ADHAM",8,0,1,0,8,1,0,1,0
"ADIS",5,2,.7142857,.2857143,7,0,0,0,0
"ADISA",3,4,.4285714,.5714286,7,0,0,0,0
"AFSANA",0,5,0,1,5,0,1,0,1
"AFSHIN",4,0,1,0,4,1,0,1,0
"AGI",1,6,.1428571,.8571429,7,0,1,0,0
"AJAMU",6,0,1,0,6,1,0,1,0
"ALANE",1,8,.1111111,.8888889,9,0,1,0,0
"ALAYNA",0,4,0,1,4,0,1,0,1
"ALBEE",2,6,.25,.75,8,0,0,0,0
"ALEEM",5,0,1,0,5,1,0,1,0
"ALETHIA",0,4,0,1,4,0,1,0,1
"ALEXIE",5,1,.8333333,.1666667,6,1,0,0,0
"ALIOUNE",6,0,1,0,6,1,0,1,0
"AMAKA",0,4,0,1,4,0,1,0,1
"AMALIE",0,3,0,1,3,0,1,0,1
"AMENA",0,6,0,1,6,0,1,0,1
"AMINAH",0,4,0,1,4,0,1,0,1
"ANASTACIA",0,5,0,1,5,0,1,0,1
"ANASTASSIA",0,6,0,1,6,0,1,0,1
"ANDEE",1,4,.2,.8,5,0,1,0,0
"ANDRI",5,1,.8333333,.1666667,6,1,0,0,0
"ANEELA",0,4,0,1,4,0,1,0,1
"ANIELLO",4,0,1,0,4,1,0,1,0
"ANNEKA",0,2,0,1,2,0,1,0,1
"ANNEKE",0,3,0,1,3,0,1,0,1
"ANNET",0,6,0,1,6,0,1,0,1
"ANTONIS",8,0,1,0,8,1,0,1,0
"ANUSHKA",1,6,.1428571,.8571429,7,0,1,0,0
"ARGENTINA",0,5,0,1,5,0,1,0,1
"ARNE",5,0,1,0,5,1,0,1,0
"ARPAN",4,1,.8,.2,5,1,0,0,0
"ARPITA",0,5,0,1,5,0,1,0,1
"ARTY",5,1,.8333333,.1666667,6,1,0,0,0
"ASHANTE",0,7,0,1,7,0,1,0,1
"ATILLA",5,0,1,0,5,1,0,1,0
"ATSUSHI",7,0,1,0,7,1,0,1,0
"AUNT",1,4,.2,.8,5,0,1,0,0
"AZHAR",5,1,.8333333,.1666667,6,1,0,0,0
"AZI",1,2,.3333333,.6666667,3,0,0,0,0
"AZIM",6,0,1,0,6,1,0,1,0
"AZUCENA",1,7,.125,.875,8,0,1,0,0
"BAKARI",8,0,1,0,8,1,0,1,0
"BALA",6,1,.8571429,.1428571,7,1,0,0,0
"BASS",4,2,.6666667,.3333333,6,0,0,0,0
"BATUHAN",7,0,1,0,7,1,0,1,0
"BENEDETTO",5,0,1,0,5,1,0,1,0
"BERND",7,0,1,0,7,1,0,1,0
"BESA",0,2,0,1,2,0,1,0,1
"BETHANNE",0,7,0,1,7,0,1,0,1
"BIGGIE",8,0,1,0,8,1,0,1,0
"BIJAL",1,3,.25,.75,4,0,0,0,0
"BILJANA",0,5,0,1,5,0,1,0,1
"BISHOY",3,0,1,0,3,1,0,1,0
"BLAS",8,0,1,0,8,1,0,1,0
"BON",3,1,.75,.25,4,0,0,0,0
"BOWEN",5,0,1,0,5,1,0,1,0
"BRANDIS",2,2,.5,.5,4,0,0,0,0
"BREDA",0,4,0,1,4,0,1,0,1
"BREN",0,5,0,1,5,0,1,0,1
"BRIDGIT",0,4,0,1,4,0,1,0,1
"BRIENNE",0,5,0,1,5,0,1,0,1
"BUDI",8,0,1,0,8,1,0,1,0
"CADENCE",1,3,.25,.75,4,0,0,0,0
"CAMP",2,2,.5,.5,4,0,0,0,0
"CANER",5,0,1,0,5,1,0,1,0
"CAPRI",1,4,.2,.8,5,0,1,0,0
"CARLEIGH",0,3,0,1,3,0,1,0,1
"CARROL",1,6,.1428571,.8571429,7,0,1,0,0
"CASSIA",0,5,0,1,5,0,1,0,1
"CASTRO",1,3,.25,.75,4,0,0,0,0
"CATRIONA",0,6,0,1,6,0,1,0,1
"CEYDA",0,3,0,1,3,0,1,0,1
"CHAMP",7,0,1,0,7,1,0,1,0
"CHANNA",0,5,0,1,5,0,1,0,1
"CHARON",2,3,.4,.6,5,0,0,0,0
"CHAU",3,4,.4285714,.5714286,7,0,0,0,0
"CHERRYL",0,6,0,1,6,0,1,0,1
"CHERYLANN",0,6,0,1,6,0,1,0,1
"CHEWY",2,1,.6666667,.3333333,3,0,0,0,0
"CHINEDU",6,0,1,0,6,1,0,1,0
"CHRYSTIE",0,6,0,1,6,0,1,0,1
"CIA",0,3,0,1,3,0,1,0,1
"CIAN",5,0,1,0,5,1,0,1,0
"CLELIA",0,4,0,1,4,0,1,0,1
"DADA",5,2,.7142857,.2857143,7,0,0,0,0
"DAILY",6,2,.75,.25,8,0,0,0,0
"DAISHA",0,4,0,1,4,0,1,0,1
"DANDAN",1,4,.2,.8,5,0,1,0,0
"DANUTA",0,8,0,1,8,0,1,0,1
"DARI",1,2,.3333333,.6666667,3,0,0,0,0
"DARYN",1,3,.25,.75,4,0,0,0,0
"DAVIE",5,1,.8333333,.1666667,6,1,0,0,0
"DAWID",7,0,1,0,7,1,0,1,0
"DEION",5,1,.8333333,.1666667,6,1,0,0,0
"DELANEY",1,3,.25,.75,4,0,0,0,0
"DELE",5,1,.8333333,.1666667,6,1,0,0,0
"DELMA",0,6,0,1,6,0,1,0,1
"DENTON",6,0,1,0,6,1,0,1,0
"DEUCE",5,1,.8333333,.1666667,6,1,0,0,0
"DIDEM",0,5,0,1,5,0,1,0,1
"DIKLA",0,6,0,1,6,0,1,0,1
"DIN",8,0,1,0,8,1,0,1,0
"DITA",0,4,0,1,4,0,1,0,1
"DONNAMARIE",0,7,0,1,7,0,1,0,1
"DORINDA",0,5,0,1,5,0,1,0,1
"DOTTY",0,6,0,1,6,0,1,0,1
"DUWAYNE",8,0,1,0,8,1,0,1,0
"DVORA",0,2,0,1,2,0,1,0,1
"DYMOND",0,5,0,1,5,0,1,0,1
"EASON",4,1,.8,.2,5,1,0,0,0
"EDIT",0,4,0,1,4,0,1,0,1
"EHSAN",5,0,1,0,5,1,0,1,0
"EINAV",0,3,0,1,3,0,1,0,1
"ELLISON",5,1,.8333333,.1666667,6,1,0,0,0
"ELZA",0,4,0,1,4,0,1,0,1
"EMINE",0,3,0,1,3,0,1,0,1
"ENDER",7,0,1,0,7,1,0,1,0
"ENES",8,0,1,0,8,1,0,1,0
"ENNY",2,6,.25,.75,8,0,0,0,0
"ENVY",3,0,1,0,3,1,0,1,0
"EVGENIYA",0,6,0,1,6,0,1,0,1
"FAIZ",8,0,1,0,8,1,0,1,0
"FALON",0,5,0,1,5,0,1,0,1
"FARLEY",5,0,1,0,5,1,0,1,0
"FATMIR",7,0,1,0,7,1,0,1,0
"FLEX",4,0,1,0,4,1,0,1,0
"FLIP",6,1,.8571429,.1428571,7,1,0,0,0
"FRASER",7,0,1,0,7,1,0,1,0
"FREEMAN",5,0,1,0,5,1,0,1,0
"FUMI",3,3,.5,.5,6,0,0,0,0
"FUNDA",0,4,0,1,4,0,1,0,1
"FUNG",1,3,.25,.75,4,0,0,0,0
"GAGE",4,0,1,0,4,1,0,1,0
"GARVEY",5,1,.8333333,.1666667,6,1,0,0,0
"GASPER",7,0,1,0,7,1,0,1,0
"GAVI",4,1,.8,.2,5,1,0,0,0
"GBENGA",8,0,1,0,8,1,0,1,0
"GEMA",0,5,0,1,5,0,1,0,1
"GEORGIO",6,0,1,0,6,1,0,1,0
"GEORGIOS",3,0,1,0,3,1,0,1,0
"GEZIM",9,0,1,0,9,1,0,1,0
"GHISLAINE",0,8,0,1,8,0,1,0,1
"GI",2,5,.2857143,.7142857,7,0,0,0,0
"GIDGET",0,8,0,1,8,0,1,0,1
"GILI",4,0,1,0,4,1,0,1,0
"GINI",0,6,0,1,6,0,1,0,1
"GIZELLE",0,3,0,1,3,0,1,0,1
"GLENY",0,7,0,1,7,0,1,0,1
"GLORIMAR",0,4,0,1,4,0,1,0,1
"GONZALEZ",2,1,.6666667,.3333333,3,0,0,0,0
"GRAND",3,2,.6,.4,5,0,0,0,0
"GUSTAV",8,0,1,0,8,1,0,1,0
"GWYNNE",0,4,0,1,4,0,1,0,1
"GYASI",7,0,1,0,7,1,0,1,0
"HABEEB",6,0,1,0,6,1,0,1,0
"HAWA",0,5,0,1,5,0,1,0,1
"HELOISE",0,6,0,1,6,0,1,0,1
"HENDRICK",5,0,1,0,5,1,0,1,0
"HERSCHEL",4,0,1,0,4,1,0,1,0
"HIPOLITO",5,0,1,0,5,1,0,1,0
"HODA",1,3,.25,.75,4,0,0,0,0
"HOÃ€NG",6,2,.75,.25,8,0,0,0,0
"HUONG",0,5,0,1,5,0,1,0,1
"IFEOMA",0,7,0,1,7,0,1,0,1
"IFFAT",2,1,.6666667,.3333333,3,0,0,0,0
"IHSAN",3,1,.75,.25,4,0,0,0,0
"ILYANA",0,2,0,1,2,0,1,0,1
"IMMANUEL",2,0,1,0,2,1,0,1,0
"IRIT",0,5,0,1,5,0,1,0,1
"ISAAK",5,0,1,0,5,1,0,1,0
"ISIDORE",5,0,1,0,5,1,0,1,0
"IVELISE",0,3,0,1,3,0,1,0,1
"IVETA",0,6,0,1,6,0,1,0,1
"IVON",2,5,.2857143,.7142857,7,0,0,0,0
"JACY",1,5,.1666667,.8333333,6,0,1,0,0
"JAM",5,2,.7142857,.2857143,7,0,0,0,0
"JAMIEL",5,0,1,0,5,1,0,1,0
"JARAD",6,0,1,0,6,1,0,1,0
"JARELL",8,0,1,0,8,1,0,1,0
"JAROD",6,0,1,0,6,1,0,1,0
"JASMEET",3,5,.375,.625,8,0,0,0,0
"JASPAL",3,1,.75,.25,4,0,0,0,0
"JAX",4,3,.5714286,.4285714,7,0,0,0,0
"JAYESH",5,0,1,0,5,1,0,1,0
"JAYNA",0,5,0,1,5,0,1,0,1
"JAZZMIN",0,4,0,1,4,0,1,0,1
"JEANENE",0,3,0,1,3,0,1,0,1
"JEAN-FRANCOIS",5,0,1,0,5,1,0,1,0
"JENEL",0,8,0,1,8,0,1,0,1
"JERSON",9,0,1,0,9,1,0,1,0
"JEWELL",1,7,.125,.875,8,0,1,0,0
"JIDE",6,0,1,0,6,1,0,1,0
"JINHEE",0,3,0,1,3,0,1,0,1
"JISOO",3,0,1,0,3,1,0,1,0
"JIYEON",0,6,0,1,6,0,1,0,1
"JODIAN",0,7,0,1,7,0,1,0,1
"JOLEEN",0,6,0,1,6,0,1,0,1
"JON-MICHAEL",3,0,1,0,3,1,0,1,0
"JOSY",2,7,.2222222,.7777778,9,0,1,0,0
"JULEE",0,4,0,1,4,0,1,0,1
"JULIEANNE",0,3,0,1,3,0,1,0,1
"JULIENNE",0,3,0,1,3,0,1,0,1
"JUNGMIN",1,2,.3333333,.6666667,3,0,0,0,0
"KADIJAH",0,2,0,1,2,0,1,0,1
"KAKI",1,4,.2,.8,5,0,1,0,0
"KALLE",2,2,.5,.5,4,0,0,0,0
"KAMIKA",0,6,0,1,6,0,1,0,1
"KAREM",2,6,.25,.75,8,0,0,0,0
"KARLO",7,0,1,0,7,1,0,1,0
"KARLOS",7,0,1,0,7,1,0,1,0
"KASPER",6,0,1,0,6,1,0,1,0
"KATHE",0,5,0,1,5,0,1,0,1
"KATHERYN",0,6,0,1,6,0,1,0,1
"KAUSHAL",7,0,1,0,7,1,0,1,0
"KAUSHIK",7,0,1,0,7,1,0,1,0
"KAYAN",0,8,0,1,8,0,1,0,1
"KAZUMI",0,4,0,1,4,0,1,0,1
"KEDAR",8,0,1,0,8,1,0,1,0
"KEENA",0,3,0,1,3,0,1,0,1
"KELBY",5,2,.7142857,.2857143,7,0,0,0,0
"KENA",0,5,0,1,5,0,1,0,1
"KERRI-ANN",0,7,0,1,7,0,1,0,1
"KESTER",7,0,1,0,7,1,0,1,0
"KHADINE",0,7,0,1,7,0,1,0,1
"KHARY",4,0,1,0,4,1,0,1,0
"KIAH",1,2,.3333333,.6666667,3,0,0,0,0
"KIAN",3,1,.75,.25,4,0,0,0,0
"KOOL",5,1,.8333333,.1666667,6,1,0,0,0
"KORINA",0,4,0,1,4,0,1,0,1
"KWANG",5,1,.8333333,.1666667,6,1,0,0,0
"KYMBERLY",0,5,0,1,5,0,1,0,1
"KYO",5,0,1,0,5,1,0,1,0
"LAKEYA",0,6,0,1,6,0,1,0,1
"LALE",0,6,0,1,6,0,1,0,1
"LALI",0,6,0,1,6,0,1,0,1
"LANG",3,1,.75,.25,4,0,0,0,0
"LARKIN",2,3,.4,.6,5,0,0,0,0
"LASHAWNA",0,7,0,1,7,0,1,0,1
"LATARSHA",0,4,0,1,4,0,1,0,1
"LAURETTE",0,6,0,1,6,0,1,0,1
"LAURIN",0,4,0,1,4,0,1,0,1
"LAURY",0,6,0,1,6,0,1,0,1
"LAVELLE",3,4,.4285714,.5714286,7,0,0,0,0
"LEIDA",0,3,0,1,3,0,1,0,1
"LEKAN",8,0,1,0,8,1,0,1,0
"LENISE",0,4,0,1,4,0,1,0,1
"LERONE",5,0,1,0,5,1,0,1,0
"LESLI",0,5,0,1,5,0,1,0,1
"LIEN",0,5,0,1,5,0,1,0,1
"LIISA",0,3,0,1,3,0,1,0,1
"LIKA",0,4,0,1,4,0,1,0,1
"LIMA",1,4,.2,.8,5,0,1,0,0
"LINTON",7,0,1,0,7,1,0,1,0
"LISA-MARIE",0,6,0,1,6,0,1,0,1
"LISSETH",0,5,0,1,5,0,1,0,1
"LIVINGSTON",6,0,1,0,6,1,0,1,0
"LONA",0,3,0,1,3,0,1,0,1
"LORENZA",0,2,0,1,2,0,1,0,1
"LUCERO",1,6,.1428571,.8571429,7,0,1,0,0
"LUCIAN",8,0,1,0,8,1,0,1,0
"LUCRETIA",0,8,0,1,8,0,1,0,1
"MADALYN",0,5,0,1,5,0,1,0,1
"MAGDY",6,0,1,0,6,1,0,1,0
"MALIHA",0,3,0,1,3,0,1,0,1
"MANAL",0,8,0,1,8,0,1,0,1
"MAO",3,4,.4285714,.5714286,7,0,0,0,0
"MARAH",0,3,0,1,3,0,1,0,1
"MARAL",0,4,0,1,4,0,1,0,1
"MARGALIT",0,5,0,1,5,0,1,0,1
"MARISEL",0,10,0,1,10,0,1,0,1
"MARIVEL",0,7,0,1,7,0,1,0,1
"MARLINA",0,4,0,1,4,0,1,0,1
"MARTHE",1,2,.3333333,.6666667,3,0,0,0,0
"MARUF",4,0,1,0,4,1,0,1,0
"MATTI",5,3,.625,.375,8,0,0,0,0
"MAURI",3,4,.4285714,.5714286,7,0,0,0,0
"MAVERICK",7,0,1,0,7,1,0,1,0
"MAYUKO",0,7,0,1,7,0,1,0,1
"MEEGAN",0,3,0,1,3,0,1,0,1
"MEILING",0,8,0,1,8,0,1,0,1
"MELIZA",0,4,0,1,4,0,1,0,1
"MELTEM",0,8,0,1,8,0,1,0,1
"MERAL",0,5,0,1,5,0,1,0,1
"MERIAM",0,4,0,1,4,0,1,0,1
"MERIDETH",0,8,0,1,8,0,1,0,1
"MERRICK",5,0,1,0,5,1,0,1,0
"MICHAELLA",0,4,0,1,4,0,1,0,1
"MICHELINA",0,7,0,1,7,0,1,0,1
"MIDGE",0,7,0,1,7,0,1,0,1
"MIEKE",0,3,0,1,3,0,1,0,1
"MIKAL",4,1,.8,.2,5,1,0,0,0
"MIKKO",4,1,.8,.2,5,1,0,0,0
"MILY",0,4,0,1,4,0,1,0,1
"MIYOUNG",0,3,0,1,3,0,1,0,1
"MODESTO",9,0,1,0,9,1,0,1,0
"MOHD",9,0,1,0,9,1,0,1,0
"MOISHY",4,0,1,0,4,1,0,1,0
"MONIA",0,2,0,1,2,0,1,0,1
"MONTSERRAT",0,3,0,1,3,0,1,0,1
"MURAD",7,0,1,0,7,1,0,1,0
"NAFEEZA",0,5,0,1,5,0,1,0,1
"NAI",1,1,.5,.5,2,0,0,0,0
"NAIDA",0,7,0,1,7,0,1,0,1
"NAKEISHA",0,3,0,1,3,0,1,0,1
"NAMITA",0,4,0,1,4,0,1,0,1
"NARA",0,5,0,1,5,0,1,0,1
"NARCISA",0,8,0,1,8,0,1,0,1
"NARDIA",0,4,0,1,4,0,1,0,1
"NATA",2,2,.5,.5,4,0,0,0,0
"NATALE",6,0,1,0,6,1,0,1,0
"NATIVIDAD",0,9,0,1,9,0,1,0,1
"NAYDA",0,9,0,1,9,0,1,0,1
"NEERA",0,3,0,1,3,0,1,0,1
"NELIDA",0,8,0,1,8,0,1,0,1
"NENAD",6,0,1,0,6,1,0,1,0
"NICCI",0,7,0,1,7,0,1,0,1
"NICHOL",1,5,.1666667,.8333333,6,0,1,0,0
"NICOLLETTE",0,5,0,1,5,0,1,0,1
"NIJA",0,4,0,1,4,0,1,0,1
"NIJAH",1,5,.1666667,.8333333,6,0,1,0,0
"NISH",4,0,1,0,4,1,0,1,0
"NISSA",0,4,0,1,4,0,1,0,1
"NUPUR",0,5,0,1,5,0,1,0,1
"NYKIA",0,7,0,1,7,0,1,0,1
"ODED",4,0,1,0,4,1,0,1,0
"ODELL",7,1,.875,.125,8,1,0,0,0
"ODIE",4,1,.8,.2,5,1,0,0,0
"OLAMIDE",1,2,.3333333,.6666667,3,0,0,0,0
"OLUBUNMI",1,4,.2,.8,5,0,1,0,0
"OMA",0,6,0,1,6,0,1,0,1
"ON",3,2,.6,.4,5,0,0,0,0
"ONEAL",8,0,1,0,8,1,0,1,0
"ORAN",4,1,.8,.2,5,1,0,0,0
"ORLA",0,7,0,1,7,0,1,0,1
"OSNAT",0,6,0,1,6,0,1,0,1
"OUMAR",9,0,1,0,9,1,0,1,0
"OÄ_UZHAN",5,0,1,0,5,1,0,1,0
"PA",4,2,.6666667,.3333333,6,0,0,0,0
"PAMMY",0,6,0,1,6,0,1,0,1
"PAN",4,2,.6666667,.3333333,6,0,0,0,0
"PANTELIS",6,0,1,0,6,1,0,1,0
"PAO",1,3,.25,.75,4,0,0,0,0
"PARI",0,7,0,1,7,0,1,0,1
"PARRISH",5,0,1,0,5,1,0,1,0
"PATRIA",0,5,0,1,5,0,1,0,1
"PAULY",5,0,1,0,5,1,0,1,0
"PAZ",1,4,.2,.8,5,0,1,0,0
"PHEBE",0,5,0,1,5,0,1,0,1
"PHáº M",5,3,.625,.375,8,0,0,0,0
"PINI",5,0,1,0,5,1,0,1,0
"POLO",8,0,1,0,8,1,0,1,0
"POPI",1,6,.1428571,.8571429,7,0,1,0,0
"PORFIRIO",7,0,1,0,7,1,0,1,0
"PREDRAG",3,0,1,0,3,1,0,1,0
"PUNAM",0,5,0,1,5,0,1,0,1
"QUIN",1,2,.3333333,.6666667,3,0,0,0,0
"RAD",5,2,.7142857,.2857143,7,0,0,0,0
"RADEK",5,0,1,0,5,1,0,1,0
"RAFIQ",7,0,1,0,7,1,0,1,0
"RAHEEL",4,0,1,0,4,1,0,1,0
"RAINE",1,5,.1666667,.8333333,6,0,1,0,0
"RAINIER",6,0,1,0,6,1,0,1,0
"RAJNI",0,4,0,1,4,0,1,0,1
"RAMSAY",7,0,1,0,7,1,0,1,0
"RAMZI",4,0,1,0,4,1,0,1,0
"RANYA",0,3,0,1,3,0,1,0,1
"RASA",1,5,.1666667,.8333333,6,0,1,0,0
"REGI",4,1,.8,.2,5,1,0,0,0
"RENAN",6,1,.8571429,.1428571,7,1,0,0,0
"RENATE",0,6,0,1,6,0,1,0,1
"RENY",3,2,.6,.4,5,0,0,0,0
"REUT",0,2,0,1,2,0,1,0,1
"RIANA",0,5,0,1,5,0,1,0,1
"RICA",0,6,0,1,6,0,1,0,1
"RIDDHI",1,4,.2,.8,5,0,1,0,0
"RIP",8,0,1,0,8,1,0,1,0
"RIVKI",0,6,0,1,6,0,1,0,1
"ROBY",5,1,.8333333,.1666667,6,1,0,0,0
"ROMANO",6,0,1,0,6,1,0,1,0
"RONEL",5,0,1,0,5,1,0,1,0
"RONN",7,0,1,0,7,1,0,1,0
"RONNA",0,5,0,1,5,0,1,0,1
"ROSAMARIA",0,6,0,1,6,0,1,0,1
"ROSELLA",0,3,0,1,3,0,1,0,1
"ROSTISLAV",6,0,1,0,6,1,0,1,0
"ROXANE",0,5,0,1,5,0,1,0,1
"RY",2,0,1,0,2,1,0,1,0
"RYA",0,2,0,1,2,0,1,0,1
"RYDER",5,0,1,0,5,1,0,1,0
"SABBIR",2,0,1,0,2,1,0,1,0
"SABIN",8,0,1,0,8,1,0,1,0
"SABITA",0,2,0,1,2,0,1,0,1
"SADA",0,3,0,1,3,0,1,0,1
"SAFI",5,1,.8333333,.1666667,6,1,0,0,0
"SAIFUL",8,0,1,0,8,1,0,1,0
"SALEENA",0,5,0,1,5,0,1,0,1
"SALWA",0,4,0,1,4,0,1,0,1
"SAPAN",6,0,1,0,6,1,0,1,0
"SAU",0,4,0,1,4,0,1,0,1
"SAVE",2,3,.4,.6,5,0,0,0,0
"SAVI",1,4,.2,.8,5,0,1,0,0
"SCARLETTE",0,7,0,1,7,0,1,0,1
"SCOOTER",6,0,1,0,6,1,0,1,0
"SELEN",0,5,0,1,5,0,1,0,1
"SELENIA",0,5,0,1,5,0,1,0,1
"SELVIN",5,0,1,0,5,1,0,1,0
"SEONG",4,1,.8,.2,5,1,0,0,0
"SEQUOIA",0,3,0,1,3,0,1,0,1
"SEUN",1,4,.2,.8,5,0,1,0,0
"SEVERINE",0,2,0,1,2,0,1,0,1
"SHAHANA",0,5,0,1,5,0,1,0,1
"SHAHLA",0,5,0,1,5,0,1,0,1
"SHAKERA",0,5,0,1,5,0,1,0,1
"SHAKEYA",0,5,0,1,5,0,1,0,1
"SHALANDA",0,4,0,1,4,0,1,0,1
"SHALEEN",2,5,.2857143,.7142857,7,0,0,0,0
"SHAMARA",0,6,0,1,6,0,1,0,1
"SHAMECCA",0,6,0,1,6,0,1,0,1
"SHAMEER",6,0,1,0,6,1,0,1,0
"SHANAYA",0,9,0,1,9,0,1,0,1
"SHARADA",0,4,0,1,4,0,1,0,1
"SHARAE",0,6,0,1,6,0,1,0,1
"SHAREESE",0,7,0,1,7,0,1,0,1
"SHARELL",0,7,0,1,7,0,1,0,1
"SHARELLE",0,5,0,1,5,0,1,0,1
"SHARIKA",0,4,0,1,4,0,1,0,1
"SHAROD",7,0,1,0,7,1,0,1,0
"SHAWNEE",0,6,0,1,6,0,1,0,1
"SHAYAN",7,0,1,0,7,1,0,1,0
"SHENELL",0,4,0,1,4,0,1,0,1
"SHERAZ",6,0,1,0,6,1,0,1,0
"SHERINA",0,3,0,1,3,0,1,0,1
"SHERMA",0,6,0,1,6,0,1,0,1
"SHERYLL",0,4,0,1,4,0,1,0,1
"SHINOBU",0,3,0,1,3,0,1,0,1
"SHINYA",8,0,1,0,8,1,0,1,0
"SHIRLENE",0,6,0,1,6,0,1,0,1
"SHMULI",5,0,1,0,5,1,0,1,0
"SHMULY",5,0,1,0,5,1,0,1,0
"SHOBHA",0,5,0,1,5,0,1,0,1
"SIENA",0,2,0,1,2,0,1,0,1
"SIMMONE",0,7,0,1,7,0,1,0,1
"SIMMY",2,2,.5,.5,4,0,0,0,0
"SINCLAIR",4,1,.8,.2,5,1,0,0,0
"SMADAR",0,7,0,1,7,0,1,0,1
"SNEHAL",5,3,.625,.375,8,0,0,0,0
"SNOOPY",6,2,.75,.25,8,0,0,0,0
"SOE",3,3,.5,.5,6,0,0,0,0
"SOHAN",6,0,1,0,6,1,0,1,0
"SONIYA",0,6,0,1,6,0,1,0,1
"SOYINI",0,5,0,1,5,0,1,0,1
"SPYRO",4,0,1,0,4,1,0,1,0
"STAMATIS",4,0,1,0,4,1,0,1,0
"STARLIN",5,0,1,0,5,1,0,1,0
"STASIA",0,6,0,1,6,0,1,0,1
"STEFFANY",0,5,0,1,5,0,1,0,1
"STEVAN",7,0,1,0,7,1,0,1,0
"SUCHI",1,4,.2,.8,5,0,1,0,0
"SUDESH",8,0,1,0,8,1,0,1,0
"SULAY",0,5,0,1,5,0,1,0,1
"SULEIKA",0,4,0,1,4,0,1,0,1
"SUNGMIN",7,1,.875,.125,8,1,0,0,0
"SUZANN",0,4,0,1,4,0,1,0,1
"TAFARI",8,0,1,0,8,1,0,1,0
"TAMESHA",0,8,0,1,8,0,1,0,1
"TAMIA",0,6,0,1,6,0,1,0,1
"TARI",3,4,.4285714,.5714286,7,0,0,0,0
"TATIA",0,5,0,1,5,0,1,0,1
"TATSUYA",5,0,1,0,5,1,0,1,0
"TAYO",4,2,.6666667,.3333333,6,0,0,0,0
"TEMI",2,2,.5,.5,4,0,0,0,0
"TENIKA",0,6,0,1,6,0,1,0,1
"TERON",5,1,.8333333,.1666667,6,1,0,0,0
"TERRI-ANN",0,6,0,1,6,0,1,0,1
"TERRON",6,0,1,0,6,1,0,1,0
"TEX",4,1,.8,.2,5,1,0,0,0
"THANIA",0,4,0,1,4,0,1,0,1
"THEDA",0,7,0,1,7,0,1,0,1
"THOMASINA",0,7,0,1,7,0,1,0,1
"TIMEA",0,5,0,1,5,0,1,0,1
"TINGTING",0,7,0,1,7,0,1,0,1
"TOKUNBO",1,2,.3333333,.6666667,3,0,0,0,0
"TONIE",1,2,.3333333,.6666667,3,0,0,0,0
"TOWANA",0,9,0,1,9,0,1,0,1
"TRAMAINE",3,5,.375,.625,8,0,0,0,0
"TREE",3,2,.6,.4,5,0,0,0,0
"TYREEK",7,0,1,0,7,1,0,1,0
"TYREL",7,0,1,0,7,1,0,1,0
"TZIVIA",0,6,0,1,6,0,1,0,1
"UCHENNA",5,3,.625,.375,8,0,0,0,0
"ULRIKE",1,5,.1666667,.8333333,6,0,1,0,0
"UNI",1,4,.2,.8,5,0,1,0,0
"UZAIR",7,0,1,0,7,1,0,1,0
"VALESKA",0,4,0,1,4,0,1,0,1
"VAMSI",7,0,1,0,7,1,0,1,0
"VASILIY",6,0,1,0,6,1,0,1,0
"VENU",7,0,1,0,7,1,0,1,0
"VINAYAK",5,0,1,0,5,1,0,1,0
"VINH",6,0,1,0,6,1,0,1,0
"VINICIO",5,0,1,0,5,1,0,1,0
"VIOLETTE",0,6,0,1,6,0,1,0,1
"VIVIANNE",0,5,0,1,5,0,1,0,1
"VONDA",0,5,0,1,5,0,1,0,1
"WAH",8,0,1,0,8,1,0,1,0
"WALDO",9,0,1,0,9,1,0,1,0
"WASIM",3,0,1,0,3,1,0,1,0
"WILHELM",5,0,1,0,5,1,0,1,0
"WISSAM",6,0,1,0,6,1,0,1,0
"WOODROW",8,0,1,0,8,1,0,1,0
"WYNTER",0,4,0,1,4,0,1,0,1
"XIAN",1,2,.3333333,.6666667,3,0,0,0,0
"YAFIT",0,6,0,1,6,0,1,0,1
"YAMILA",0,4,0,1,4,0,1,0,1
"YANCY",5,1,.8333333,.1666667,6,1,0,0,0
"YARY",0,6,0,1,6,0,1,0,1
"YAÅ_AR",6,0,1,0,6,1,0,1,0
"YEHUDAH",6,0,1,0,6,1,0,1,0
"YITZI",3,0,1,0,3,1,0,1,0
"YOGA",3,2,.6,.4,5,0,0,0,0
"YOHEI",4,0,1,0,4,1,0,1,0
"YOLY",0,6,0,1,6,0,1,0,1
"YONAH",4,1,.8,.2,5,1,0,0,0
"YOOJIN",1,6,.1428571,.8571429,7,0,1,0,0
"YORI",3,2,.6,.4,5,0,0,0,0
"YUDY",0,5,0,1,5,0,1,0,1
"YUI",0,2,0,1,2,0,1,0,1
"YULY",1,4,.2,.8,5,0,1,0,0
"YVELISSE",0,7,0,1,7,0,1,0,1
"ZAIRE",4,3,.5714286,.4285714,7,0,0,0,0
"ZAKIR",6,0,1,0,6,1,0,1,0
"ZALIKA",0,5,0,1,5,0,1,0,1
"ZHE",5,1,.8333333,.1666667,6,1,0,0,0
"ZOFIA",0,7,0,1,7,0,1,0,1
"Ä°DIL",0,6,0,1,6,0,1,0,1
"AASHISH",4,0,1,0,4,1,0,1,0
"ABEY",7,0,1,0,7,1,0,1,0
"ABHA",0,5,0,1,5,0,1,0,1
"ABIODUN",2,2,.5,.5,4,0,0,0,0
"ADDIS",4,2,.6666667,.3333333,6,0,0,0,0
"ADEKUNLE",8,0,1,0,8,1,0,1,0
"ADEMOLA",7,0,1,0,7,1,0,1,0
"ADIR",5,0,1,0,5,1,0,1,0
"ADORA",0,5,0,1,5,0,1,0,1
"AJITH",9,0,1,0,9,1,0,1,0
"AKIA",0,6,0,1,6,0,1,0,1
"AKIHIRO",8,0,1,0,8,1,0,1,0
"AKSHAT",4,0,1,0,4,1,0,1,0
"ALARIC",7,0,1,0,7,1,0,1,0
"ALEENA",0,3,0,1,3,0,1,0,1
"ALEESHA",0,2,0,1,2,0,1,0,1
"ALGERNON",5,1,.8333333,.1666667,6,1,0,0,0
"ALIE",0,4,0,1,4,0,1,0,1
"ALISIA",0,7,0,1,7,0,1,0,1
"ALLYSSA",0,5,0,1,5,0,1,0,1
"ALTA",0,4,0,1,4,0,1,0,1
"AMAURI",6,0,1,0,6,1,0,1,0
"AMBREEN",0,2,0,1,2,0,1,0,1
"AMELA",0,4,0,1,4,0,1,0,1
"AMEYA",5,0,1,0,5,1,0,1,0
"ANAMIKA",0,7,0,1,7,0,1,0,1
"ANDE",4,2,.6666667,.3333333,6,0,0,0,0
"ANEESHA",0,4,0,1,4,0,1,0,1
"ANESSA",0,4,0,1,4,0,1,0,1
"ANGAD",3,0,1,0,3,1,0,1,0
"ANGI",0,2,0,1,2,0,1,0,1
"ANGY",0,2,0,1,2,0,1,0,1
"ANJULI",0,6,0,1,6,0,1,0,1
"ANMOL",1,1,.5,.5,2,0,0,0,0
"ANNE-SOPHIE",0,4,0,1,4,0,1,0,1
"ANUJA",0,3,0,1,3,0,1,0,1
"ANY",0,7,0,1,7,0,1,0,1
"AQUILA",1,6,.1428571,.8571429,7,0,1,0,0
"ARDITA",0,5,0,1,5,0,1,0,1
"ARIELE",0,4,0,1,4,0,1,0,1
"ARISTIDES",7,0,1,0,7,1,0,1,0
"ARLIN",1,3,.25,.75,4,0,0,0,0
"ARLYNE",0,6,0,1,6,0,1,0,1
"ARMEL",5,1,.8333333,.1666667,6,1,0,0,0
"ARTYOM",5,0,1,0,5,1,0,1,0
"ARYN",0,2,0,1,2,0,1,0,1
"ASHIK",5,0,1,0,5,1,0,1,0
"ASHIMA",0,6,0,1,6,0,1,0,1
"ASHLEI",0,5,0,1,5,0,1,0,1
"ASHUTOSH",8,0,1,0,8,1,0,1,0
"ASHY",2,1,.6666667,.3333333,3,0,0,0,0
"ATHANASIOS",6,0,1,0,6,1,0,1,0
"ATHINA",0,4,0,1,4,0,1,0,1
"AUDI",3,0,1,0,3,1,0,1,0
"AUGUSTIN",5,0,1,0,5,1,0,1,0
"AVIAD",8,0,1,0,8,1,0,1,0
"AVIN",5,0,1,0,5,1,0,1,0
"AVON",2,2,.5,.5,4,0,0,0,0
"AYAKA",0,5,0,1,5,0,1,0,1
"AYKUT",5,0,1,0,5,1,0,1,0
"AZAD",6,1,.8571429,.1428571,7,1,0,0,0
"AZAM",3,0,1,0,3,1,0,1,0
"BABAR",3,1,.75,.25,4,0,0,0,0
"BADER",3,1,.75,.25,4,0,0,0,0
"BARA",2,7,.2222222,.7777778,9,0,1,0,0
"BARTOSZ",3,0,1,0,3,1,0,1,0
"BASSAM",9,0,1,0,9,1,0,1,0
"BEI",1,5,.1666667,.8333333,6,0,1,0,0
"BEKA",2,4,.3333333,.6666667,6,0,0,0,0
"BELKYS",0,6,0,1,6,0,1,0,1
"BETTI",0,6,0,1,6,0,1,0,1
"BEX",0,3,0,1,3,0,1,0,1
"BIENVENIDO",6,0,1,0,6,1,0,1,0
"BIJAN",4,0,1,0,4,1,0,1,0
"BINTA",1,3,.25,.75,4,0,0,0,0
"BLESS",1,4,.2,.8,5,0,1,0,0
"BLESSING",2,3,.4,.6,5,0,0,0,0
"BLOSSOM",0,6,0,1,6,0,1,0,1
"BORAM",0,5,0,1,5,0,1,0,1
"BRAYDEN",7,0,1,0,7,1,0,1,0
"BREEZY",0,4,0,1,4,0,1,0,1
"BRIGITTA",0,6,0,1,6,0,1,0,1
"BRION",7,0,1,0,7,1,0,1,0
"BRITNI",0,4,0,1,4,0,1,0,1
"BUCKY",5,0,1,0,5,1,0,1,0
"BUJAR",4,0,1,0,4,1,0,1,0
"BURIM",5,0,1,0,5,1,0,1,0
"BYUNG",5,0,1,0,5,1,0,1,0
"CAMDEN",5,1,.8333333,.1666667,6,1,0,0,0
"CANSU",1,4,.2,.8,5,0,1,0,0
"CAPUCINE",0,5,0,1,5,0,1,0,1
"CARIE",1,3,.25,.75,4,0,0,0,0
"CAROLEE",0,7,0,1,7,0,1,0,1
"CAROLYNN",0,5,0,1,5,0,1,0,1
"CAS",5,2,.7142857,.2857143,7,0,0,0,0
"CASIE",0,7,0,1,7,0,1,0,1
"CASSIUS",7,0,1,0,7,1,0,1,0
"CATHARINA",0,5,0,1,5,0,1,0,1
"CATIA",1,5,.1666667,.8333333,6,0,1,0,0
"CATY",0,6,0,1,6,0,1,0,1
"CHANY",1,1,.5,.5,2,0,0,0,0
"CHARICE",0,5,0,1,5,0,1,0,1
"CHAVEZ",6,0,1,0,6,1,0,1,0
"CHAYANNE",4,1,.8,.2,5,1,0,0,0
"CHAZZ",5,0,1,0,5,1,0,1,0
"CHERESE",0,2,0,1,2,0,1,0,1
"CHI-CHI",2,5,.2857143,.7142857,7,0,0,0,0
"CHIKE",7,0,1,0,7,1,0,1,0
"CHILL",3,1,.75,.25,4,0,0,0,0
"CHIU",3,2,.6,.4,5,0,0,0,0
"CHRISTIANNE",0,4,0,1,4,0,1,0,1
"CHUCKIE",5,1,.8333333,.1666667,6,1,0,0,0
"CINDIE",0,2,0,1,2,0,1,0,1
"CLEMENCE",0,3,0,1,3,0,1,0,1
"CLETUS",8,0,1,0,8,1,0,1,0
"CLIF",7,0,1,0,7,1,0,1,0
"CLIO",0,2,0,1,2,0,1,0,1
"CLOTILDE",0,5,0,1,5,0,1,0,1
"CORBETT",4,0,1,0,4,1,0,1,0
"CORNEL",6,0,1,0,6,1,0,1,0
"CORWIN",6,0,1,0,6,1,0,1,0
"CRISS",3,1,.75,.25,4,0,0,0,0
"CULTURE",5,1,.8333333,.1666667,6,1,0,0,0
"DALIBOR",6,0,1,0,6,1,0,1,0
"DAMAN",5,1,.8333333,.1666667,6,1,0,0,0
"DAMARYS",0,4,0,1,4,0,1,0,1
"DAMI",5,0,1,0,5,1,0,1,0
"DAMONE",8,0,1,0,8,1,0,1,0
"DANESSA",0,7,0,1,7,0,1,0,1
"DANIJEL",6,0,1,0,6,1,0,1,0
"DANN",5,0,1,0,5,1,0,1,0
"DAR",3,1,.75,.25,4,0,0,0,0
"DAREK",4,0,1,0,4,1,0,1,0
"DARION",7,1,.875,.125,8,1,0,0,0
"DARYLL",7,0,1,0,7,1,0,1,0
"DEBRAH",0,5,0,1,5,0,1,0,1
"DEJI",5,0,1,0,5,1,0,1,0
"DELFINA",0,3,0,1,3,0,1,0,1
"DELVIN",5,0,1,0,5,1,0,1,0
"DENESE",0,5,0,1,5,0,1,0,1
"DEO",5,0,1,0,5,1,0,1,0
"DERIK",6,0,1,0,6,1,0,1,0
"DESTINEE",0,2,0,1,2,0,1,0,1
"DEVINA",0,6,0,1,6,0,1,0,1
"DEX",5,0,1,0,5,1,0,1,0
"DHARA",0,6,0,1,6,0,1,0,1
"DHEERAJ",6,0,1,0,6,1,0,1,0
"DHIRAJ",2,0,1,0,2,1,0,1,0
"DIL",7,0,1,0,7,1,0,1,0
"DIO",4,2,.6666667,.3333333,6,0,0,0,0
"DIPTI",0,3,0,1,3,0,1,0,1
"DMYTRO",8,0,1,0,8,1,0,1,0
"DRAGOS",7,0,1,0,7,1,0,1,0
"DUDU",8,1,.8888889,.1111111,9,1,0,0,0
"DWAINE",8,0,1,0,8,1,0,1,0
"DWANE",4,0,1,0,4,1,0,1,0
"DYANE",1,2,.3333333,.6666667,3,0,0,0,0
"EBONE",0,3,0,1,3,0,1,0,1
"EBONEE",0,5,0,1,5,0,1,0,1
"EDOARDO",4,0,1,0,4,1,0,1,0
"EHUD",5,0,1,0,5,1,0,1,0
"EIMEAR",0,5,0,1,5,0,1,0,1
"ELDAR",5,1,.8333333,.1666667,6,1,0,0,0
"ELEANORE",0,5,0,1,5,0,1,0,1
"ELEKTRA",1,5,.1666667,.8333333,6,0,1,0,0
"ELEONOR",0,7,0,1,7,0,1,0,1
"ELIANNA",0,3,0,1,3,0,1,0,1
"ELIYAHU",3,0,1,0,3,1,0,1,0
"ELLERY",5,1,.8333333,.1666667,6,1,0,0,0
"ELYSIA",0,2,0,1,2,0,1,0,1
"EMINA",0,3,0,1,3,0,1,0,1
"EPIPHANY",0,3,0,1,3,0,1,0,1
"ERCAN",7,0,1,0,7,1,0,1,0
"ERIS",3,2,.6,.4,5,0,0,0,0
"ERMA",0,5,0,1,5,0,1,0,1
"ERYKA",0,6,0,1,6,0,1,0,1
"ESPEZY",9,0,1,0,9,1,0,1,0
"EUGEN",4,0,1,0,4,1,0,1,0
"EUNJI",0,3,0,1,3,0,1,0,1
"EVELINE",0,6,0,1,6,0,1,0,1
"EZ",5,1,.8333333,.1666667,6,1,0,0,0
"FACUNDO",4,0,1,0,4,1,0,1,0
"FAI",2,1,.6666667,.3333333,3,0,0,0,0
"FAIYAZ",4,0,1,0,4,1,0,1,0
"FARIA",0,4,0,1,4,0,1,0,1
"FARZAD",6,0,1,0,6,1,0,1,0
"FATOS",4,2,.6666667,.3333333,6,0,0,0,0
"FAYSAL",5,0,1,0,5,1,0,1,0
"FELIKS",5,0,1,0,5,1,0,1,0
"FER",2,1,.6666667,.3333333,3,0,0,0,0
"FIDELIA",0,6,0,1,6,0,1,0,1
"FINEST",6,1,.8571429,.1428571,7,1,0,0,0
"FIORDALIZA",0,7,0,1,7,0,1,0,1
"FIORE",3,3,.5,.5,6,0,0,0,0
"FLYNN",6,0,1,0,6,1,0,1,0
"FOTIS",5,0,1,0,5,1,0,1,0
"FRAIDY",0,3,0,1,3,0,1,0,1
"FRANCY",1,6,.1428571,.8571429,7,0,1,0,0
"FREDERIQUE",0,4,0,1,4,0,1,0,1
"GABBIE",0,4,0,1,4,0,1,0,1
"GAGANDEEP",4,2,.6666667,.3333333,6,0,0,0,0
"GAZI",4,0,1,0,4,1,0,1,0
"GEM",1,2,.3333333,.6666667,3,0,0,0,0
"GENIA",0,6,0,1,6,0,1,0,1
"GENINE",0,6,0,1,6,0,1,0,1
"GERRIT",3,0,1,0,3,1,0,1,0
"GESSICA",0,5,0,1,5,0,1,0,1
"GHADA",0,3,0,1,3,0,1,0,1
"GIDON",5,0,1,0,5,1,0,1,0
"GIOIA",0,2,0,1,2,0,1,0,1
"GIOVANA",0,6,0,1,6,0,1,0,1
"GLENNYS",0,2,0,1,2,0,1,0,1
"GOKCE",3,2,.6,.4,5,0,0,0,0
"GOPI",6,0,1,0,6,1,0,1,0
"GRACEANN",0,5,0,1,5,0,1,0,1
"GRECIA",0,4,0,1,4,0,1,0,1
"GROVER",4,0,1,0,4,1,0,1,0
"GUCCI",5,1,.8333333,.1666667,6,1,0,0,0
"GUNJAN",4,3,.5714286,.4285714,7,0,0,0,0
"GURINDER",3,1,.75,.25,4,0,0,0,0
"GUSTAVE",7,0,1,0,7,1,0,1,0
"HALLY",1,2,.3333333,.6666667,3,0,0,0,0
"HALUK",4,0,1,0,4,1,0,1,0
"HAMDI",5,0,1,0,5,1,0,1,0
"HAMED",4,0,1,0,4,1,0,1,0
"HANAKO",0,4,0,1,4,0,1,0,1
"HANH",0,4,0,1,4,0,1,0,1
"HANNE",0,5,0,1,5,0,1,0,1
"HARMAN",2,2,.5,.5,4,0,0,0,0
"HEC",3,1,.75,.25,4,0,0,0,0
"HEEJUNG",0,4,0,1,4,0,1,0,1
"HEENA",0,5,0,1,5,0,1,0,1
"HERMINIO",7,0,1,0,7,1,0,1,0
"HILTON",7,0,1,0,7,1,0,1,0
"HINDA",0,5,0,1,5,0,1,0,1
"HIROKI",7,0,1,0,7,1,0,1,0
"HIROYUKI",7,0,1,0,7,1,0,1,0
"HOLGER",6,0,1,0,6,1,0,1,0
"HOLIDAY",3,2,.6,.4,5,0,0,0,0
"HOLY",2,1,.6666667,.3333333,3,0,0,0,0
"HOOD",6,1,.8571429,.1428571,7,1,0,0,0
"HOPETON",6,0,1,0,6,1,0,1,0
"HORTENSIA",0,6,0,1,6,0,1,0,1
"HUDA",0,4,0,1,4,0,1,0,1
"HUE",7,2,.7777778,.2222222,9,1,0,0,0
"HUEY",5,1,.8333333,.1666667,6,1,0,0,0
"HUMPHREY",4,0,1,0,4,1,0,1,0
"HUMZA",6,0,1,0,6,1,0,1,0
"HY",6,0,1,0,6,1,0,1,0
"HYUNJOO",0,6,0,1,6,0,1,0,1
"IEISHA",0,4,0,1,4,0,1,0,1
"IFY",0,3,0,1,3,0,1,0,1
"IHAB",7,0,1,0,7,1,0,1,0
"ILA",0,2,0,1,2,0,1,0,1
"ILISA",0,2,0,1,2,0,1,0,1
"ILKA",0,6,0,1,6,0,1,0,1
"ILKER",4,0,1,0,4,1,0,1,0
"IMOGEN",0,6,0,1,6,0,1,0,1
"INDI",1,5,.1666667,.8333333,6,0,1,0,0
"IRINE",0,3,0,1,3,0,1,0,1
"ISAK",4,0,1,0,4,1,0,1,0
"ISELA",0,6,0,1,6,0,1,0,1
"IWAN",6,0,1,0,6,1,0,1,0
"IZZIE",1,3,.25,.75,4,0,0,0,0
"JACEY",0,4,0,1,4,0,1,0,1
"JACINTO",5,0,1,0,5,1,0,1,0
"JAJA",5,2,.7142857,.2857143,7,0,0,0,0
"JAME",7,1,.875,.125,8,1,0,0,0
"JAMEELAH",0,5,0,1,5,0,1,0,1
"JAMEZ",5,0,1,0,5,1,0,1,0
"JAMIKA",0,5,0,1,5,0,1,0,1
"JANIECE",0,6,0,1,6,0,1,0,1
"JANUSZ",8,0,1,0,8,1,0,1,0
"JAYDE",2,2,.5,.5,4,0,0,0,0
"JAYLENE",0,3,0,1,3,0,1,0,1
"JE",3,2,.6,.4,5,0,0,0,0
"JEAN-MARIE",0,5,0,1,5,0,1,0,1
"JEM",0,2,0,1,2,0,1,0,1
"JENEEN",0,3,0,1,3,0,1,0,1
"JENIECE",0,5,0,1,5,0,1,0,1
"JENNEFER",0,7,0,1,7,0,1,0,1
"JERSEY",1,3,.25,.75,4,0,0,0,0
"JESIKA",0,4,0,1,4,0,1,0,1
"JHONATAN",7,0,1,0,7,1,0,1,0
"JIHAE",0,6,0,1,6,0,1,0,1
"JIHEE",0,6,0,1,6,0,1,0,1
"JILIAN",0,4,0,1,4,0,1,0,1
"JINAL",4,2,.6666667,.3333333,6,0,0,0,0
"JINNA",0,6,0,1,6,0,1,0,1
"JITENDRA",7,0,1,0,7,1,0,1,0
"JOBY",1,1,.5,.5,2,0,0,0,0
"JODY-ANN",0,5,0,1,5,0,1,0,1
"JOERG",3,0,1,0,3,1,0,1,0
"JOLANDA",0,8,0,1,8,0,1,0,1
"JOLI",0,3,0,1,3,0,1,0,1
"JOMARIE",0,4,0,1,4,0,1,0,1
"JONNIE",5,0,1,0,5,1,0,1,0
"JONY",8,0,1,0,8,1,0,1,0
"JORDON",6,0,1,0,6,1,0,1,0
"JOSIANE",0,4,0,1,4,0,1,0,1
"JUERGEN",6,0,1,0,6,1,0,1,0
"JULIANO",6,0,1,0,6,1,0,1,0
"JURI",2,2,.5,.5,4,0,0,0,0
"JUSTUS",6,1,.8571429,.1428571,7,1,0,0,0
"JUSTYN",5,0,1,0,5,1,0,1,0
"KAFI",1,5,.1666667,.8333333,6,0,1,0,0
"KAITLYNN",0,7,0,1,7,0,1,0,1
"KALA",0,2,0,1,2,0,1,0,1
"KALEN",3,1,.75,.25,4,0,0,0,0
"KALLY",0,6,0,1,6,0,1,0,1
"KANWAL",1,3,.25,.75,4,0,0,0,0
"KARLIE",0,4,0,1,4,0,1,0,1
"KARLYN",1,4,.2,.8,5,0,1,0,0
"KAROLIN",0,5,0,1,5,0,1,0,1
"KASTRIOT",5,0,1,0,5,1,0,1,0
"KAZUE",0,5,0,1,5,0,1,0,1
"KEANE",6,1,.8571429,.1428571,7,1,0,0,0
"KEANNA",0,5,0,1,5,0,1,0,1
"KEELEY",0,3,0,1,3,0,1,0,1
"KEIANA",0,5,0,1,5,0,1,0,1
"KEINO",5,0,1,0,5,1,0,1,0
"KELLAN",5,2,.7142857,.2857143,7,0,0,0,0
"KELLIANN",0,3,0,1,3,0,1,0,1
"KELLYANNE",0,5,0,1,5,0,1,0,1
"KENNA",0,5,0,1,5,0,1,0,1
"KERISHA",0,6,0,1,6,0,1,0,1
"KESH",2,2,.5,.5,4,0,0,0,0
"KETSIA",0,6,0,1,6,0,1,0,1
"KEYA",0,6,0,1,6,0,1,0,1
"KEYANA",0,5,0,1,5,0,1,0,1
"KHALIA",0,6,0,1,6,0,1,0,1
"KIERON",2,1,.6666667,.3333333,3,0,0,0,0
"KIMONE",0,5,0,1,5,0,1,0,1
"KINA",0,4,0,1,4,0,1,0,1
"KINGSTON",4,1,.8,.2,5,1,0,0,0
"KIRIL",6,0,1,0,6,1,0,1,0
"KIRKLAND",5,1,.8333333,.1666667,6,1,0,0,0
"KIRSTIE",0,4,0,1,4,0,1,0,1
"KIVA",0,4,0,1,4,0,1,0,1
"KNIGHT",7,1,.875,.125,8,1,0,0,0
"KODY",4,1,.8,.2,5,1,0,0,0
"KONG",6,1,.8571429,.1428571,7,1,0,0,0
"KORTNEY",0,6,0,1,6,0,1,0,1
"KRESHNIK",7,0,1,0,7,1,0,1,0
"KRYSTINE",0,2,0,1,2,0,1,0,1
"KUSHTRIM",8,0,1,0,8,1,0,1,0
"KYA",0,4,0,1,4,0,1,0,1
"KYLEE",0,4,0,1,4,0,1,0,1
"KYU",5,0,1,0,5,1,0,1,0
"LAMONTE",5,0,1,0,5,1,0,1,0
"LANNA",0,5,0,1,5,0,1,0,1
"LARYSA",0,6,0,1,6,0,1,0,1
"LAVAR",4,0,1,0,4,1,0,1,0
"LAVINA",0,3,0,1,3,0,1,0,1
"LENARD",6,0,1,0,6,1,0,1,0
"LENWORTH",7,0,1,0,7,1,0,1,0
"LEOLA",0,5,0,1,5,0,1,0,1
"LETA",0,7,0,1,7,0,1,0,1
"LIBIA",0,6,0,1,6,0,1,0,1
"LILAH",0,4,0,1,4,0,1,0,1
"LINDSY",0,5,0,1,5,0,1,0,1
"LINSEY",0,3,0,1,3,0,1,0,1
"LINWOOD",5,0,1,0,5,1,0,1,0
"LISSETT",0,8,0,1,8,0,1,0,1
"LIVING",3,0,1,0,3,1,0,1,0
"LORENZ",4,0,1,0,4,1,0,1,0
"LOVELY",0,7,0,1,7,0,1,0,1
"LUBNA",0,2,0,1,2,0,1,0,1
"LUX",0,5,0,1,5,0,1,0,1
"LYLA",0,4,0,1,4,0,1,0,1
"LYUBA",0,4,0,1,4,0,1,0,1
"MACIEK",6,0,1,0,6,1,0,1,0
"MADOKA",0,3,0,1,3,0,1,0,1
"MAGEN",1,5,.1666667,.8333333,6,0,1,0,0
"MAGS",0,2,0,1,2,0,1,0,1
"MAHIR",5,0,1,0,5,1,0,1,0
"MAIRE",0,5,0,1,5,0,1,0,1
"MALAK",0,3,0,1,3,0,1,0,1
"MALEEK",5,0,1,0,5,1,0,1,0
"MALKI",1,4,.2,.8,5,0,1,0,0
"MALLIKA",0,3,0,1,3,0,1,0,1
"MALLORIE",0,4,0,1,4,0,1,0,1
"MALLY",1,4,.2,.8,5,0,1,0,0
"MANAN",3,0,1,0,3,1,0,1,0
"MANASI",0,3,0,1,3,0,1,0,1
"MARALYN",0,7,0,1,7,0,1,0,1
"MARCE",0,5,0,1,5,0,1,0,1
"MARCELINA",0,7,0,1,7,0,1,0,1
"MARCELINE",0,3,0,1,3,0,1,0,1
"MARIBELL",0,5,0,1,5,0,1,0,1
"MARICAR",0,2,0,1,2,0,1,0,1
"MARICRUZ",0,4,0,1,4,0,1,0,1
"MARIE-LOUISE",0,4,0,1,4,0,1,0,1
"MARIETTE",0,3,0,1,3,0,1,0,1
"MARIVIC",0,6,0,1,6,0,1,0,1
"MARKIE",5,2,.7142857,.2857143,7,0,0,0,0
"MARKOS",7,0,1,0,7,1,0,1,0
"MARLOWE",3,3,.5,.5,6,0,0,0,0
"MARTIAL",5,0,1,0,5,1,0,1,0
"MARTINO",2,1,.6666667,.3333333,3,0,0,0,0
"MARVELOUS",6,1,.8571429,.1428571,7,1,0,0,0
"MARVIA",0,5,0,1,5,0,1,0,1
"MARY-KATE",0,4,0,1,4,0,1,0,1
"MATINA",0,4,0,1,4,0,1,0,1
"MATS",5,0,1,0,5,1,0,1,0
"MAXI",3,3,.5,.5,6,0,0,0,0
"MAYDA",0,4,0,1,4,0,1,0,1
"MAYLIN",0,6,0,1,6,0,1,0,1
"MECHELLE",0,5,0,1,5,0,1,0,1
"MEEKA",0,6,0,1,6,0,1,0,1
"MEENU",0,2,0,1,2,0,1,0,1
"MEISHA",0,6,0,1,6,0,1,0,1
"MELVA",0,6,0,1,6,0,1,0,1
"MELVINA",0,5,0,1,5,0,1,0,1
"MERA",1,4,.2,.8,5,0,1,0,0
"MERYEM",0,5,0,1,5,0,1,0,1
"META",1,3,.25,.75,4,0,0,0,0
"MIGNON",0,5,0,1,5,0,1,0,1
"MIISZ",0,7,0,1,7,0,1,0,1
"MILISSA",0,5,0,1,5,0,1,0,1
"MILLI",1,5,.1666667,.8333333,6,0,1,0,0
"MINAH",0,3,0,1,3,0,1,0,1
"MINAS",4,0,1,0,4,1,0,1,0
"MISHEL",2,2,.5,.5,4,0,0,0,0
"MITUL",4,0,1,0,4,1,0,1,0
"MOISH",3,0,1,0,3,1,0,1,0
"MOO",6,1,.8571429,.1428571,7,1,0,0,0
"MOOSE",5,2,.7142857,.2857143,7,0,0,0,0
"MORENA",1,3,.25,.75,4,0,0,0,0
"MORTY",8,0,1,0,8,1,0,1,0
"MOUNIR",6,0,1,0,6,1,0,1,0
"MUKUND",6,0,1,0,6,1,0,1,0
"MURIELLE",0,6,0,1,6,0,1,0,1
"MYRLENE",0,7,0,1,7,0,1,0,1
"NAA",0,7,0,1,7,0,1,0,1
"NADIYAH",0,7,0,1,7,0,1,0,1
"NAHID",0,6,0,1,6,0,1,0,1
"NAHUM",6,0,1,0,6,1,0,1,0
"NAJI",3,2,.6,.4,5,0,0,0,0
"NAKUL",2,0,1,0,2,1,0,1,0
"NALIN",7,0,1,0,7,1,0,1,0
"NARAE",0,5,0,1,5,0,1,0,1
"NASHA",0,6,0,1,6,0,1,0,1
"NASIM",2,2,.5,.5,4,0,0,0,0
"NATASHIA",0,5,0,1,5,0,1,0,1
"NATY",1,4,.2,.8,5,0,1,0,0
"NAV",5,0,1,0,5,1,0,1,0
"NAVNEET",1,2,.3333333,.6666667,3,0,0,0,0
"NAZAR",3,0,1,0,3,1,0,1,0
"NAZIM",3,0,1,0,3,1,0,1,0
"NAZIR",6,0,1,0,6,1,0,1,0
"NAZLI",0,4,0,1,4,0,1,0,1
"NDEYE",0,7,0,1,7,0,1,0,1
"NEDIM",4,0,1,0,4,1,0,1,0
"NELLA",1,5,.1666667,.8333333,6,0,1,0,0
"NETTIE",0,8,0,1,8,0,1,0,1
"NEVA",0,6,0,1,6,0,1,0,1
"NGAWANG",4,1,.8,.2,5,1,0,0,0
"NICKEISHA",0,3,0,1,3,0,1,0,1
"NICOLO",6,0,1,0,6,1,0,1,0
"NIEMA",0,2,0,1,2,0,1,0,1
"NIKEISHA",0,5,0,1,5,0,1,0,1
"NIKEYA",0,4,0,1,4,0,1,0,1
"NIKOL",0,6,0,1,6,0,1,0,1
"NIKOLINA",0,4,0,1,4,0,1,0,1
"NILKA",0,7,0,1,7,0,1,0,1
"NIMESH",6,0,1,0,6,1,0,1,0
"NISHI",0,2,0,1,2,0,1,0,1
"NITHIN",3,0,1,0,3,1,0,1,0
"NOBLE",5,1,.8333333,.1666667,6,1,0,0,0
"NOBUKO",0,4,0,1,4,0,1,0,1
"NOEMIE",0,4,0,1,4,0,1,0,1
"NOHA",0,4,0,1,4,0,1,0,1
"NORI",2,4,.3333333,.6666667,6,0,0,0,0
"NORKA",0,8,0,1,8,0,1,0,1
"NOUR",4,2,.6666667,.3333333,6,0,0,0,0
"NURUL",2,3,.4,.6,5,0,0,0,0
"ODILE",0,5,0,1,5,0,1,0,1
"OJ",4,1,.8,.2,5,1,0,0,0
"OLIVERA",0,3,0,1,3,0,1,0,1
"OMI",2,4,.3333333,.6666667,6,0,0,0,0
"OMOLARA",1,5,.1666667,.8333333,6,0,1,0,0
"OREO",3,2,.6,.4,5,0,0,0,0
"ORLEE",0,6,0,1,6,0,1,0,1
"OUSSAMA",5,0,1,0,5,1,0,1,0
"OZGE",0,5,0,1,5,0,1,0,1
"PAPE",6,0,1,0,6,1,0,1,0
"PARTHA",5,1,.8333333,.1666667,6,1,0,0,0
"PAVLINA",0,4,0,1,4,0,1,0,1
"PERRIN",2,3,.4,.6,5,0,0,0,0
"PETULA",0,6,0,1,6,0,1,0,1
"PHILLIPA",0,4,0,1,4,0,1,0,1
"PIERLUIGI",5,0,1,0,5,1,0,1,0
"PINO",3,1,.75,.25,4,0,0,0,0
"PITO",6,0,1,0,6,1,0,1,0
"PLAY",3,2,.6,.4,5,0,0,0,0
"POOKIE",1,4,.2,.8,5,0,1,0,0
"POWER",5,1,.8333333,.1666667,6,1,0,0,0
"PRACHI",0,6,0,1,6,0,1,0,1
"PRANAY",5,0,1,0,5,1,0,1,0
"PRIMA",0,4,0,1,4,0,1,0,1
"PRIYANK",4,0,1,0,4,1,0,1,0
"PROMISE",2,2,.5,.5,4,0,0,0,0
"PRZEMEK",5,0,1,0,5,1,0,1,0
"QUANISHA",0,4,0,1,4,0,1,0,1
"RACHANA",0,3,0,1,3,0,1,0,1
"RADMILA",0,3,0,1,3,0,1,0,1
"RAEGAN",0,4,0,1,4,0,1,0,1
"RAF",7,0,1,0,7,1,0,1,0
"RAFAELINA",0,6,0,1,6,0,1,0,1
"RAFE",3,1,.75,.25,4,0,0,0,0
"RAHIEM",7,0,1,0,7,1,0,1,0
"RAI",2,4,.3333333,.6666667,6,0,0,0,0
"RAIHAN",4,0,1,0,4,1,0,1,0
"RAINY",0,4,0,1,4,0,1,0,1
"RALEIGH",2,1,.6666667,.3333333,3,0,0,0,0
"RALUCA",0,3,0,1,3,0,1,0,1
"RAMAZAN",6,0,1,0,6,1,0,1,0
"RANDA",0,4,0,1,4,0,1,0,1
"REBEKA",0,5,0,1,5,0,1,0,1
"REDD",2,2,.5,.5,4,0,0,0,0
"REKA",0,3,0,1,3,0,1,0,1
"RENARD",7,0,1,0,7,1,0,1,0
"REUEL",6,0,1,0,6,1,0,1,0
"RICCI",3,4,.4285714,.5714286,7,0,0,0,0
"RIEKO",0,5,0,1,5,0,1,0,1
"ROAN",5,0,1,0,5,1,0,1,0
"RODRIGUE",5,0,1,0,5,1,0,1,0
"ROEY",4,0,1,0,4,1,0,1,0
"RONEE",1,3,.25,.75,4,0,0,0,0
"RONETTE",0,5,0,1,5,0,1,0,1
"RUBENS",6,0,1,0,6,1,0,1,0
"RULA",0,4,0,1,4,0,1,0,1
"RUSHABH",3,0,1,0,3,1,0,1,0
"RUSSIAN",4,3,.5714286,.4285714,7,0,0,0,0
"RYOTA",7,0,1,0,7,1,0,1,0
"RYU",8,0,1,0,8,1,0,1,0
"SAGI",5,0,1,0,5,1,0,1,0
"SAJ",4,0,1,0,4,1,0,1,0
"SALENA",0,5,0,1,5,0,1,0,1
"SALISHA",0,4,0,1,4,0,1,0,1
"SANIYA",1,5,.1666667,.8333333,6,0,1,0,0
"SARAN",1,5,.1666667,.8333333,6,0,1,0,0
"SARANDA",0,5,0,1,5,0,1,0,1
"SARENA",0,2,0,1,2,0,1,0,1
"SAYA",0,3,0,1,3,0,1,0,1
"SAYEED",3,1,.75,.25,4,0,0,0,0
"SEBNEM",0,3,0,1,3,0,1,0,1
"SEENA",0,4,0,1,4,0,1,0,1
"SELLY",1,3,.25,.75,4,0,0,0,0
"SEM",5,0,1,0,5,1,0,1,0
"SEMRA",0,3,0,1,3,0,1,0,1
"SENECA",5,2,.7142857,.2857143,7,0,0,0,0
"SHADIA",0,7,0,1,7,0,1,0,1
"SHADMAN",3,0,1,0,3,1,0,1,0
"SHAHEED",4,0,1,0,4,1,0,1,0
"SHAK",2,0,1,0,2,1,0,1,0
"SHANEA",0,8,0,1,8,0,1,0,1
"SHANESE",0,5,0,1,5,0,1,0,1
"SHANIE",0,5,0,1,5,0,1,0,1
"SHANIKQUA",0,8,0,1,8,0,1,0,1
"SHANNEN",0,3,0,1,3,0,1,0,1
"SHANNY",0,3,0,1,3,0,1,0,1
"SHANSHAN",1,4,.2,.8,5,0,1,0,0
"SHANTANU",6,0,1,0,6,1,0,1,0
"SHARINA",0,5,0,1,5,0,1,0,1
"SHASHANK",7,0,1,0,7,1,0,1,0
"SHAUNTAY",0,6,0,1,6,0,1,0,1
"SHAWNDELL",3,1,.75,.25,4,0,0,0,0
"SHAYA",2,1,.6666667,.3333333,3,0,0,0,0
"SHEILAH",0,8,0,1,8,0,1,0,1
"SHENA",0,2,0,1,2,0,1,0,1
"SHENIKA",0,8,0,1,8,0,1,0,1
"SHER",1,4,.2,.8,5,0,1,0,0
"SHERIDA",0,3,0,1,3,0,1,0,1
"SHERILYN",0,2,0,1,2,0,1,0,1
"SHERITA",0,4,0,1,4,0,1,0,1
"SHERONDA",0,2,0,1,2,0,1,0,1
"SHERVIN",5,0,1,0,5,1,0,1,0
"SHIMA",0,5,0,1,5,0,1,0,1
"SHINE",2,3,.4,.6,5,0,0,0,0
"SHIRL",0,4,0,1,4,0,1,0,1
"SHITAL",0,4,0,1,4,0,1,0,1
"SHIVONNE",0,4,0,1,4,0,1,0,1
"SHLOMIT",0,6,0,1,6,0,1,0,1
"SHMULIK",5,0,1,0,5,1,0,1,0
"SHOWTIME",6,0,1,0,6,1,0,1,0
"SHUANG",0,6,0,1,6,0,1,0,1
"SHUO",1,3,.25,.75,4,0,0,0,0
"SIGI",0,7,0,1,7,0,1,0,1
"SIMBA",6,0,1,0,6,1,0,1,0
"SIRENA",0,6,0,1,6,0,1,0,1
"SLAVIK",4,0,1,0,4,1,0,1,0
"SLICK",6,1,.8571429,.1428571,7,1,0,0,0
"SMALL",4,0,1,0,4,1,0,1,0
"SOHAIB",3,0,1,0,3,1,0,1,0
"SOON",3,1,.75,.25,4,0,0,0,0
"SOULA",0,5,0,1,5,0,1,0,1
"SOUMYA",1,3,.25,.75,4,0,0,0,0
"SOURABH",4,0,1,0,4,1,0,1,0
"SPENSER",4,1,.8,.2,5,1,0,0,0
"SRIDHAR",6,0,1,0,6,1,0,1,0
"STACEYANN",0,6,0,1,6,0,1,0,1
"STAFFORD",5,0,1,0,5,1,0,1,0
"STEFFON",6,0,1,0,6,1,0,1,0
"STEW",4,0,1,0,4,1,0,1,0
"SUBRINA",0,7,0,1,7,0,1,0,1
"SUDEEP",3,0,1,0,3,1,0,1,0
"SUDHA",1,6,.1428571,.8571429,7,0,1,0,0
"SUEANN",0,5,0,1,5,0,1,0,1
"SUELA",0,5,0,1,5,0,1,0,1
"SUI",1,5,.1666667,.8333333,6,0,1,0,0
"SUJAN",8,0,1,0,8,1,0,1,0
"SUMI",0,5,0,1,5,0,1,0,1
"SUNITHA",0,5,0,1,5,0,1,0,1
"SUNYOUNG",0,3,0,1,3,0,1,0,1
"SUSANN",0,5,0,1,5,0,1,0,1
"SUSHANT",5,0,1,0,5,1,0,1,0
"SUSMITA",0,4,0,1,4,0,1,0,1
"SYDELL",0,5,0,1,5,0,1,0,1
"SZILVIA",0,7,0,1,7,0,1,0,1
"TA",2,1,.6666667,.3333333,3,0,0,0,0
"TAH",6,1,.8571429,.1428571,7,1,0,0,0
"TAJUANA",0,4,0,1,4,0,1,0,1
"TAKIYA",0,5,0,1,5,0,1,0,1
"TALLY",0,2,0,1,2,0,1,0,1
"TANEKA",0,4,0,1,4,0,1,0,1
"TARIKA",0,6,0,1,6,0,1,0,1
"TARRELL",6,0,1,0,6,1,0,1,0
"TASHAUNA",0,6,0,1,6,0,1,0,1
"TASO",5,0,1,0,5,1,0,1,0
"TAYFUN",3,0,1,0,3,1,0,1,0
"TEJ",5,0,1,0,5,1,0,1,0
"TENE",0,7,0,1,7,0,1,0,1
"TERESSA",0,4,0,1,4,0,1,0,1
"TEREZA",0,6,0,1,6,0,1,0,1
"TESFA",6,0,1,0,6,1,0,1,0
"THAYER",1,1,.5,.5,2,0,0,0,0
"THIERNO",5,0,1,0,5,1,0,1,0
"TIARRA",0,5,0,1,5,0,1,0,1
"TINISHA",0,5,0,1,5,0,1,0,1
"TISA",0,2,0,1,2,0,1,0,1
"TOBE",3,1,.75,.25,4,0,0,0,0
"TOLU",1,3,.25,.75,4,0,0,0,0
"TOLULOPE",3,1,.75,.25,4,0,0,0,0
"TOMEKA",0,5,0,1,5,0,1,0,1
"TORRY",3,2,.6,.4,5,0,0,0,0
"TORSTEN",4,0,1,0,4,1,0,1,0
"TRAVON",8,0,1,0,8,1,0,1,0
"TRESHA",0,5,0,1,5,0,1,0,1
"TRINIDAD",0,6,0,1,6,0,1,0,1
"TRISTON",5,0,1,0,5,1,0,1,0
"TSHERING",1,2,.3333333,.6666667,3,0,0,0,0
"TUNG",2,1,.6666667,.3333333,3,0,0,0,0
"TUNÃ‡",2,0,1,0,2,1,0,1,0
"TYRESE",5,1,.8333333,.1666667,6,1,0,0,0
"UFUK",7,0,1,0,7,1,0,1,0
"ULA",0,5,0,1,5,0,1,0,1
"ULLA",0,2,0,1,2,0,1,0,1
"URVASHI",0,6,0,1,6,0,1,0,1
"USHER",4,0,1,0,4,1,0,1,0
"UZI",6,1,.8571429,.1428571,7,1,0,0,0
"VANE",0,5,0,1,5,0,1,0,1
"VANI",0,4,0,1,4,0,1,0,1
"VANYA",2,3,.4,.6,5,0,0,0,0
"VIDHI",0,3,0,1,3,0,1,0,1
"VIMAL",6,0,1,0,6,1,0,1,0
"VINCY",0,3,0,1,3,0,1,0,1
"VINSON",7,0,1,0,7,1,0,1,0
"VY",1,6,.1428571,.8571429,7,0,1,0,0
"WEBSTER",7,1,.875,.125,8,1,0,0,0
"WEIWEI",0,5,0,1,5,0,1,0,1
"WELDON",5,0,1,0,5,1,0,1,0
"WENDIE",0,7,0,1,7,0,1,0,1
"WENG",4,3,.5714286,.4285714,7,0,0,0,0
"WHITLEY",0,3,0,1,3,0,1,0,1
"WILDER",6,0,1,0,6,1,0,1,0
"WINSON",7,0,1,0,7,1,0,1,0
"XENA",0,6,0,1,6,0,1,0,1
"XUAN",3,2,.6,.4,5,0,0,0,0
"YAIRA",0,4,0,1,4,0,1,0,1
"YALCIN",4,0,1,0,4,1,0,1,0
"YAMI",0,5,0,1,5,0,1,0,1
"YEHUDIT",0,4,0,1,4,0,1,0,1
"YEON",5,1,.8333333,.1666667,6,1,0,0,0
"YIANNI",6,0,1,0,6,1,0,1,0
"YIFAT",0,4,0,1,4,0,1,0,1
"YOANN",7,0,1,0,7,1,0,1,0
"YOKI",1,3,.25,.75,4,0,0,0,0
"YOLI",0,3,0,1,3,0,1,0,1
"YON",4,0,1,0,4,1,0,1,0
"YONATHAN",5,0,1,0,5,1,0,1,0
"YOSSIE",4,1,.8,.2,5,1,0,0,0
"YOTAM",6,0,1,0,6,1,0,1,0
"YOUJIN",0,6,0,1,6,0,1,0,1
"YUJI",6,0,1,0,6,1,0,1,0
"YUTA",5,0,1,0,5,1,0,1,0
"YVAN",4,0,1,0,4,1,0,1,0
"ZABRINA",0,3,0,1,3,0,1,0,1
"ZALMY",4,0,1,0,4,1,0,1,0
"ZAZA",3,3,.5,.5,6,0,0,0,0
"ZEB",5,0,1,0,5,1,0,1,0
"ZLATA",0,4,0,1,4,0,1,0,1
"ZOHAIB",6,0,1,0,6,1,0,1,0
"ZOLA",2,3,.4,.6,5,0,0,0,0
"ZORA",0,5,0,1,5,0,1,0,1
"ZORINA",0,2,0,1,2,0,1,0,1
"ZULLY",0,5,0,1,5,0,1,0,1
"ZUZANNA",0,4,0,1,4,0,1,0,1
"ABA",1,3,.25,.75,4,0,0,0,0
"ABEER",0,2,0,1,2,0,1,0,1
"ABOU",5,0,1,0,5,1,0,1,0
"ABRAR",2,0,1,0,2,1,0,1,0
"ADALGISA",0,6,0,1,6,0,1,0,1
"ADELLE",0,4,0,1,4,0,1,0,1
"ADENIYI",3,0,1,0,3,1,0,1,0
"ADEYEMI",5,1,.8333333,.1666667,6,1,0,0,0
"ADIN",3,0,1,0,3,1,0,1,0
"ADJOA",0,6,0,1,6,0,1,0,1
"AFTON",0,6,0,1,6,0,1,0,1
"AG",4,2,.6666667,.3333333,6,0,0,0,0
"AGNESE",0,6,0,1,6,0,1,0,1
"AGOSTINO",6,0,1,0,6,1,0,1,0
"AINA",0,5,0,1,5,0,1,0,1
"AIR",2,0,1,0,2,1,0,1,0
"AKIS",6,0,1,0,6,1,0,1,0
"ALAINE",0,5,0,1,5,0,1,0,1
"ALBIN",5,1,.8333333,.1666667,6,1,0,0,0
"ALEJO",3,0,1,0,3,1,0,1,0
"ALESHIA",0,5,0,1,5,0,1,0,1
"ALESSA",0,3,0,1,3,0,1,0,1
"ALEXANDR",6,0,1,0,6,1,0,1,0
"ALEXSANDRA",0,4,0,1,4,0,1,0,1
"ALIAH",0,4,0,1,4,0,1,0,1
"ALICAN",4,0,1,0,4,1,0,1,0
"ALICEN",0,4,0,1,4,0,1,0,1
"ALIZE",0,5,0,1,5,0,1,0,1
"ALTIN",6,0,1,0,6,1,0,1,0
"ALYSSIA",0,5,0,1,5,0,1,0,1
"AMALA",1,3,.25,.75,4,0,0,0,0
"AMALFI",0,4,0,1,4,0,1,0,1
"AMARDEEP",3,1,.75,.25,4,0,0,0,0
"AMAURIS",4,0,1,0,4,1,0,1,0
"AMAYA",0,2,0,1,2,0,1,0,1
"AMEERA",0,5,0,1,5,0,1,0,1
"AMES",2,2,.5,.5,4,0,0,0,0
"AMIEL",2,1,.6666667,.3333333,3,0,0,0,0
"AMILA",3,2,.6,.4,5,0,0,0,0
"AMITY",0,2,0,1,2,0,1,0,1
"AMNON",6,0,1,0,6,1,0,1,0
"AMORY",2,1,.6666667,.3333333,3,0,0,0,0
"AMRA",0,2,0,1,2,0,1,0,1
"ANABELL",0,4,0,1,4,0,1,0,1
"ANABELLA",0,6,0,1,6,0,1,0,1
"ANAYA",0,6,0,1,6,0,1,0,1
"ANDRIS",2,1,.6666667,.3333333,3,0,0,0,0
"ANGEE",0,2,0,1,2,0,1,0,1
"ANGELY",0,3,0,1,3,0,1,0,1
"ANIE",0,3,0,1,3,0,1,0,1
"ANIKET",5,0,1,0,5,1,0,1,0
"ANIRUDDHA",7,0,1,0,7,1,0,1,0
"ANITHA",0,6,0,1,6,0,1,0,1
"ANJANIE",0,5,0,1,5,0,1,0,1
"ANNEL",1,4,.2,.8,5,0,1,0,0
"ANSHU",1,4,.2,.8,5,0,1,0,0
"ARBÃ‹R",4,0,1,0,4,1,0,1,0
"ARELI",0,4,0,1,4,0,1,0,1
"ARELY",0,6,0,1,6,0,1,0,1
"ARIANNY",0,5,0,1,5,0,1,0,1
"ARISA",0,6,0,1,6,0,1,0,1
"ARJAN",3,0,1,0,3,1,0,1,0
"ARNAB",4,0,1,0,4,1,0,1,0
"ARNO",6,0,1,0,6,1,0,1,0
"ARNULFO",7,0,1,0,7,1,0,1,0
"ASHLING",0,2,0,1,2,0,1,0,1
"ASHWINI",1,6,.1428571,.8571429,7,0,1,0,0
"ASK",3,3,.5,.5,6,0,0,0,0
"ASLAM",7,0,1,0,7,1,0,1,0
"ATTICUS",4,0,1,0,4,1,0,1,0
"AUDRINA",0,6,0,1,6,0,1,0,1
"AURELIEN",4,0,1,0,4,1,0,1,0
"AVIA",0,3,0,1,3,0,1,0,1
"AVIVIT",0,2,0,1,2,0,1,0,1
"AVNEET",3,1,.75,.25,4,0,0,0,0
"AVROHOM",6,0,1,0,6,1,0,1,0
"AYAZ",3,0,1,0,3,1,0,1,0
"AZADEH",0,2,0,1,2,0,1,0,1
"AZALIA",0,2,0,1,2,0,1,0,1
"AZUSA",0,2,0,1,2,0,1,0,1
"BACK",4,1,.8,.2,5,1,0,0,0
"BAHA",5,0,1,0,5,1,0,1,0
"BAJAN",1,3,.25,.75,4,0,0,0,0
"BASIT",3,0,1,0,3,1,0,1,0
"BASTIAN",4,1,.8,.2,5,1,0,0,0
"BEATE",0,5,0,1,5,0,1,0,1
"BEKIR",5,0,1,0,5,1,0,1,0
"BENY",3,2,.6,.4,5,0,0,0,0
"BERNY",5,0,1,0,5,1,0,1,0
"BETHANIA",0,6,0,1,6,0,1,0,1
"BEVON",4,0,1,0,4,1,0,1,0
"BHARATH",5,0,1,0,5,1,0,1,0
"BINOY",4,0,1,0,4,1,0,1,0
"BKLYN",3,1,.75,.25,4,0,0,0,0
"BLADIMIR",5,0,1,0,5,1,0,1,0
"BLESSY",0,3,0,1,3,0,1,0,1
"BOZENA",0,7,0,1,7,0,1,0,1
"BRAHIM",5,1,.8333333,.1666667,6,1,0,0,0
"BRITANY",0,5,0,1,5,0,1,0,1
"BRITTANIE",0,3,0,1,3,0,1,0,1
"BRITTNEE",0,4,0,1,4,0,1,0,1
"BRITTNI",0,7,0,1,7,0,1,0,1
"BRONSON",4,0,1,0,4,1,0,1,0
"BRY",1,3,.25,.75,4,0,0,0,0
"BRYNNE",0,2,0,1,2,0,1,0,1
"CABRERA",4,1,.8,.2,5,1,0,0,0
"CADY",0,2,0,1,2,0,1,0,1
"CAILIN",0,3,0,1,3,0,1,0,1
"CAIO",5,0,1,0,5,1,0,1,0
"CALE",6,0,1,0,6,1,0,1,0
"CALLUM",6,0,1,0,6,1,0,1,0
"CAMARA",1,6,.1428571,.8571429,7,0,1,0,0
"CAMRON",5,0,1,0,5,1,0,1,0
"CANDIA",0,3,0,1,3,0,1,0,1
"CANDYCE",0,3,0,1,3,0,1,0,1
"CANNY",1,2,.3333333,.6666667,3,0,0,0,0
"CAPO",5,0,1,0,5,1,0,1,0
"CAPONE",4,1,.8,.2,5,1,0,0,0
"CARMELLE",0,4,0,1,4,0,1,0,1
"CAROLL",0,5,0,1,5,0,1,0,1
"CASSAUNDRA",0,4,0,1,4,0,1,0,1
"CATRICE",0,8,0,1,8,0,1,0,1
"CE",1,2,.3333333,.6666667,3,0,0,0,0
"CEIL",0,5,0,1,5,0,1,0,1
"CERISSA",0,6,0,1,6,0,1,0,1
"CESARINA",0,3,0,1,3,0,1,0,1
"CEYLAN",2,2,.5,.5,4,0,0,0,0
"CHAE",1,1,.5,.5,2,0,0,0,0
"CHANTALE",0,5,0,1,5,0,1,0,1
"CHANTEE",0,6,0,1,6,0,1,0,1
"CHARBEL",2,0,1,0,2,1,0,1,0
"CHELLY",0,5,0,1,5,0,1,0,1
"CHERICE",0,4,0,1,4,0,1,0,1
"CHERRIE",0,7,0,1,7,0,1,0,1
"CHERRYANN",0,7,0,1,7,0,1,0,1
"CHERYLE",0,2,0,1,2,0,1,0,1
"CHESKA",0,2,0,1,2,0,1,0,1
"CHESKY",3,0,1,0,3,1,0,1,0
"CHIE",0,3,0,1,3,0,1,0,1
"CHIHIRO",0,5,0,1,5,0,1,0,1
"CHILLY",4,0,1,0,4,1,0,1,0
"CHIMERE",0,4,0,1,4,0,1,0,1
"CHRISSI",0,4,0,1,4,0,1,0,1
"CHRISTEEN",0,5,0,1,5,0,1,0,1
"CHRISTIAAN",4,0,1,0,4,1,0,1,0
"CHYNNA",0,4,0,1,4,0,1,0,1
"CID",4,2,.6666667,.3333333,6,0,0,0,0
"CITIZEN",2,1,.6666667,.3333333,3,0,0,0,0
"CLARI",0,5,0,1,5,0,1,0,1
"CLARITA",0,5,0,1,5,0,1,0,1
"CLASSIC",5,1,.8333333,.1666667,6,1,0,0,0
"COFFEE",2,3,.4,.6,5,0,0,0,0
"COLLIS",3,0,1,0,3,1,0,1,0
"COMFORT",0,3,0,1,3,0,1,0,1
"CONRADO",5,0,1,0,5,1,0,1,0
"CONWAY",4,0,1,0,4,1,0,1,0
"CORINTHIA",0,7,0,1,7,0,1,0,1
"COURTNAY",0,2,0,1,2,0,1,0,1
"CREATIVE",1,1,.5,.5,2,0,0,0,0
"CREIGHTON",3,2,.6,.4,5,0,0,0,0
"CRISTIANE",1,1,.5,.5,2,0,0,0,0
"CRISTIE",0,5,0,1,5,0,1,0,1
"CRYSTA",0,4,0,1,4,0,1,0,1
"CSILLA",0,4,0,1,4,0,1,0,1
"DALIZA",0,2,0,1,2,0,1,0,1
"DAME",4,0,1,0,4,1,0,1,0
"DARNELLE",0,5,0,1,5,0,1,0,1
"DAVION",5,0,1,0,5,1,0,1,0
"DAWUD",7,0,1,0,7,1,0,1,0
"DAYAN",1,3,.25,.75,4,0,0,0,0
"DAYANARA",0,4,0,1,4,0,1,0,1
"DAYANNA",0,5,0,1,5,0,1,0,1
"DEANN",0,5,0,1,5,0,1,0,1
"DEBO",5,0,1,0,5,1,0,1,0
"DEEPTHI",0,6,0,1,6,0,1,0,1
"DEMITRI",6,0,1,0,6,1,0,1,0
"DEQUAN",8,0,1,0,8,1,0,1,0
"DESEAN",3,0,1,0,3,1,0,1,0
"DESHA",1,2,.3333333,.6666667,3,0,0,0,0
"DEVINDRA",4,0,1,0,4,1,0,1,0
"DEVLIN",2,1,.6666667,.3333333,3,0,0,0,0
"DEVONA",0,6,0,1,6,0,1,0,1
"DEVRIM",2,0,1,0,2,1,0,1,0
"DICKSON",4,0,1,0,4,1,0,1,0
"DIJANA",0,2,0,1,2,0,1,0,1
"DIOGO",4,0,1,0,4,1,0,1,0
"DIOMEDES",4,0,1,0,4,1,0,1,0
"DIPAK",6,0,1,0,6,1,0,1,0
"DIPALI",0,5,0,1,5,0,1,0,1
"DIZZY",3,0,1,0,3,1,0,1,0
"DONETTE",0,6,0,1,6,0,1,0,1
"DONNA-MARIE",0,5,0,1,5,0,1,0,1
"DONTAE",4,0,1,0,4,1,0,1,0
"DORAN",6,0,1,0,6,1,0,1,0
"DORIN",3,3,.5,.5,6,0,0,0,0
"DORRIE",0,2,0,1,2,0,1,0,1
"DORSEY",5,2,.7142857,.2857143,7,0,0,0,0
"DORUK",2,0,1,0,2,1,0,1,0
"DRAMA",4,2,.6666667,.3333333,6,0,0,0,0
"DUC",4,0,1,0,4,1,0,1,0
"DYNA",0,3,0,1,3,0,1,0,1
"EASTON",5,0,1,0,5,1,0,1,0
"EB",1,1,.5,.5,2,0,0,0,0
"EBBY",0,3,0,1,3,0,1,0,1
"EDUARDA",0,5,0,1,5,0,1,0,1
"EDWARDO",3,0,1,0,3,1,0,1,0
"EDWIGE",1,2,.3333333,.6666667,3,0,0,0,0
"ELDON",6,0,1,0,6,1,0,1,0
"ELEANA",0,7,0,1,7,0,1,0,1
"ELEN",1,5,.1666667,.8333333,6,0,1,0,0
"ELIZ",0,5,0,1,5,0,1,0,1
"ELLENA",0,4,0,1,4,0,1,0,1
"EMELINE",0,3,0,1,3,0,1,0,1
"EMME",0,2,0,1,2,0,1,0,1
"ENDY",5,0,1,0,5,1,0,1,0
"ENRICA",0,4,0,1,4,0,1,0,1
"ERA",1,5,.1666667,.8333333,6,0,1,0,0
"ERAY",4,0,1,0,4,1,0,1,0
"ERION",5,0,1,0,5,1,0,1,0
"ERVING",3,0,1,0,3,1,0,1,0
"ERWAN",4,1,.8,.2,5,1,0,0,0
"ESME",0,3,0,1,3,0,1,0,1
"ESTEFANI",0,4,0,1,4,0,1,0,1
"EULA",0,5,0,1,5,0,1,0,1
"EUNSUN",0,6,0,1,6,0,1,0,1
"EUSEBIO",6,0,1,0,6,1,0,1,0
"EVANGELINA",0,3,0,1,3,0,1,0,1
"EVERETTE",4,1,.8,.2,5,1,0,0,0
"EVIS",0,3,0,1,3,0,1,0,1
"FAROUK",3,0,1,0,3,1,0,1,0
"FAUSTINO",7,0,1,0,7,1,0,1,0
"FEDOR",3,0,1,0,3,1,0,1,0
"FELTON",5,0,1,0,5,1,0,1,0
"FERGAL",4,0,1,0,4,1,0,1,0
"FERNANDEZ",3,2,.6,.4,5,0,0,0,0
"FINA",0,3,0,1,3,0,1,0,1
"FLAWLESS",2,4,.3333333,.6666667,6,0,0,0,0
"FLORES",2,1,.6666667,.3333333,3,0,0,0,0
"FLORINDA",0,4,0,1,4,0,1,0,1
"FLUFFY",2,4,.3333333,.6666667,6,0,0,0,0
"FOLASHADE",0,2,0,1,2,0,1,0,1
"FORBES",6,0,1,0,6,1,0,1,0
"FRANCI",0,4,0,1,4,0,1,0,1
"FRANCINA",0,4,0,1,4,0,1,0,1
"FRIEDRICH",3,0,1,0,3,1,0,1,0
"FU",6,0,1,0,6,1,0,1,0
"FUAT",7,0,1,0,7,1,0,1,0
"FURQAN",5,0,1,0,5,1,0,1,0
"GADI",4,0,1,0,4,1,0,1,0
"GAMALIEL",5,0,1,0,5,1,0,1,0
"GARDNER",1,1,.5,.5,2,0,0,0,0
"GAREN",2,0,1,0,2,1,0,1,0
"GARNETT",6,1,.8571429,.1428571,7,1,0,0,0
"GAYATRI",0,5,0,1,5,0,1,0,1
"GE",4,0,1,0,4,1,0,1,0
"GEETHA",0,5,0,1,5,0,1,0,1
"GEISHA",0,6,0,1,6,0,1,0,1
"GENC",3,0,1,0,3,1,0,1,0
"GEOVANNA",0,2,0,1,2,0,1,0,1
"GERASIMOS",4,0,1,0,4,1,0,1,0
"GERMANIA",0,5,0,1,5,0,1,0,1
"GHASSAN",5,0,1,0,5,1,0,1,0
"GHULAM",7,0,1,0,7,1,0,1,0
"GIANCARLOS",6,1,.8571429,.1428571,7,1,0,0,0
"GIANINA",0,4,0,1,4,0,1,0,1
"GIOVANI",4,1,.8,.2,5,1,0,0,0
"GLENNIS",0,3,0,1,3,0,1,0,1
"GLORIBEL",0,5,0,1,5,0,1,0,1
"GOGO",4,3,.5714286,.4285714,7,0,0,0,0
"GOLD",3,0,1,0,3,1,0,1,0
"GOMEZ",3,0,1,0,3,1,0,1,0
"GRANVILLE",7,0,1,0,7,1,0,1,0
"GREENE",1,4,.2,.8,5,0,1,0,0
"GREGOIRE",5,0,1,0,5,1,0,1,0
"GUERLINE",0,5,0,1,5,0,1,0,1
"GUILLERMINA",0,5,0,1,5,0,1,0,1
"GYPSY",0,3,0,1,3,0,1,0,1
"HAFIZ",5,0,1,0,5,1,0,1,0
"HAIRO",5,0,1,0,5,1,0,1,0
"HANIF",6,0,1,0,6,1,0,1,0
"HANSEN",3,1,.75,.25,4,0,0,0,0
"HARA",1,3,.25,.75,4,0,0,0,0
"HARRI",4,2,.6666667,.3333333,6,0,0,0,0
"HASEEB",3,0,1,0,3,1,0,1,0
"HATEM",6,0,1,0,6,1,0,1,0
"HATICE",0,6,0,1,6,0,1,0,1
"HAYLEE",0,5,0,1,5,0,1,0,1
"HE",5,1,.8333333,.1666667,6,1,0,0,0
"HEDI",2,3,.4,.6,5,0,0,0,0
"HEINZ",3,1,.75,.25,4,0,0,0,0
"HELIO",7,0,1,0,7,1,0,1,0
"HEMAL",5,1,.8333333,.1666667,6,1,0,0,0
"HERBY",8,0,1,0,8,1,0,1,0
"HERCULES",7,0,1,0,7,1,0,1,0
"HERNANDEZ",2,3,.4,.6,5,0,0,0,0
"HERSH",7,0,1,0,7,1,0,1,0
"HERSHEL",5,0,1,0,5,1,0,1,0
"HIKARU",3,2,.6,.4,5,0,0,0,0
"HILDY",1,6,.1428571,.8571429,7,0,1,0,0
"HING",6,1,.8571429,.1428571,7,1,0,0,0
"HIRAL",0,2,0,1,2,0,1,0,1
"HOGAN",5,0,1,0,5,1,0,1,0
"HOMA",0,5,0,1,5,0,1,0,1
"HOSSEIN",5,0,1,0,5,1,0,1,0
"HOUSE",1,3,.25,.75,4,0,0,0,0
"HOUSTON",5,0,1,0,5,1,0,1,0
"HRISTO",5,0,1,0,5,1,0,1,0
"HSIN",1,2,.3333333,.6666667,3,0,0,0,0
"HUMAYUN",7,0,1,0,7,1,0,1,0
"IANA",0,2,0,1,2,0,1,0,1
"IBIS",3,1,.75,.25,4,0,0,0,0
"IGNATIUS",6,0,1,0,6,1,0,1,0
"IKRAM",0,4,0,1,4,0,1,0,1
"INDY",1,3,.25,.75,4,0,0,0,0
"INGRIS",0,3,0,1,3,0,1,0,1
"IOANNA",0,6,0,1,6,0,1,0,1
"IONA",0,7,0,1,7,0,1,0,1
"IRAM",0,4,0,1,4,0,1,0,1
"ISHRAT",0,4,0,1,4,0,1,0,1
"ISIDRO",4,0,1,0,4,1,0,1,0
"ISRAT",0,6,0,1,6,0,1,0,1
"ISSY",1,3,.25,.75,4,0,0,0,0
"ISTVAN",5,0,1,0,5,1,0,1,0
"IVANO",4,0,1,0,4,1,0,1,0
"IYANA",0,4,0,1,4,0,1,0,1
"JABBAR",5,0,1,0,5,1,0,1,0
"JACINTH",1,5,.1666667,.8333333,6,0,1,0,0
"JAEHO",3,0,1,0,3,1,0,1,0
"JAESON",5,0,1,0,5,1,0,1,0
"JAK",5,0,1,0,5,1,0,1,0
"JALEEL",5,0,1,0,5,1,0,1,0
"JAMAICA",1,1,.5,.5,2,0,0,0,0
"JAMARR",5,0,1,0,5,1,0,1,0
"JAMIESON",2,1,.6666667,.3333333,3,0,0,0,0
"JAMY",3,1,.75,.25,4,0,0,0,0
"JANAI",0,5,0,1,5,0,1,0,1
"JANAYA",0,2,0,1,2,0,1,0,1
"JANEA",0,4,0,1,4,0,1,0,1
"JANELLA",0,4,0,1,4,0,1,0,1
"JANIRA",0,4,0,1,4,0,1,0,1
"JANISE",0,8,0,1,8,0,1,0,1
"JANNELLE",0,6,0,1,6,0,1,0,1
"JASWINDER",2,1,.6666667,.3333333,3,0,0,0,0
"JAYCE",1,2,.3333333,.6666667,3,0,0,0,0
"JAYLA",0,4,0,1,4,0,1,0,1
"JAZMYN",0,2,0,1,2,0,1,0,1
"JEANELLE",0,6,0,1,6,0,1,0,1
"JEANNY",0,4,0,1,4,0,1,0,1
"JEET",6,0,1,0,6,1,0,1,0
"JEISON",5,0,1,0,5,1,0,1,0
"JENE",2,2,.5,.5,4,0,0,0,0
"JENKINS",1,1,.5,.5,2,0,0,0,0
"JENNIPHER",0,5,0,1,5,0,1,0,1
"JENSON",5,0,1,0,5,1,0,1,0
"JEREMIAS",6,0,1,0,6,1,0,1,0
"JERROLD",4,0,1,0,4,1,0,1,0
"JESI",0,3,0,1,3,0,1,0,1
"JESSALYN",0,3,0,1,3,0,1,0,1
"JESSYCA",0,6,0,1,6,0,1,0,1
"JETHRO",5,0,1,0,5,1,0,1,0
"JHEANELL",0,3,0,1,3,0,1,0,1
"JHONATHAN",7,0,1,0,7,1,0,1,0
"JHONY",7,0,1,0,7,1,0,1,0
"JIALI",0,4,0,1,4,0,1,0,1
"JIGNESH",8,0,1,0,8,1,0,1,0
"JIHAD",4,0,1,0,4,1,0,1,0
"JIMIN",1,2,.3333333,.6666667,3,0,0,0,0
"JINELLE",0,7,0,1,7,0,1,0,1
"JINNIE",0,6,0,1,6,0,1,0,1
"JINWOO",4,0,1,0,4,1,0,1,0
"JOANE",0,7,0,1,7,0,1,0,1
"JOFFRE",6,1,.8571429,.1428571,7,1,0,0,0
"JOLINE",0,7,0,1,7,0,1,0,1
"JORDY",2,0,1,0,2,1,0,1,0
"JOS",6,0,1,0,6,1,0,1,0
"JOSEY",1,4,.2,.8,5,0,1,0,0
"JOSSIE",1,4,.2,.8,5,0,1,0,0
"JOVANNI",3,0,1,0,3,1,0,1,0
"JOVON",4,0,1,0,4,1,0,1,0
"JUANCHO",4,0,1,0,4,1,0,1,0
"JUD",4,2,.6666667,.3333333,6,0,0,0,0
"JULIETH",0,2,0,1,2,0,1,0,1
"JULIETTA",0,3,0,1,3,0,1,0,1
"JUSTEN",4,0,1,0,4,1,0,1,0
"JUSTINO",7,0,1,0,7,1,0,1,0
"KADI",0,2,0,1,2,0,1,0,1
"KALIA",0,3,0,1,3,0,1,0,1
"KALIMAH",2,6,.25,.75,8,0,0,0,0
"KAMA",1,2,.3333333,.6666667,3,0,0,0,0
"KAMALI",1,2,.3333333,.6666667,3,0,0,0,0
"KANCHAN",0,2,0,1,2,0,1,0,1
"KANDIS",0,6,0,1,6,0,1,0,1
"KAR",3,1,.75,.25,4,0,0,0,0
"KARREN",1,5,.1666667,.8333333,6,0,1,0,0
"KASHAWN",3,2,.6,.4,5,0,0,0,0
"KATERINE",0,5,0,1,5,0,1,0,1
"KATHLYN",0,3,0,1,3,0,1,0,1
"KATIUSKA",0,5,0,1,5,0,1,0,1
"KATRINE",0,5,0,1,5,0,1,0,1
"KAVIN",5,0,1,0,5,1,0,1,0
"KAYANN",0,5,0,1,5,0,1,0,1
"KAYCEE",0,3,0,1,3,0,1,0,1
"KAYDEE",2,2,.5,.5,4,0,0,0,0
"KAYLAH",0,2,0,1,2,0,1,0,1
"KAZIM",5,0,1,0,5,1,0,1,0
"KELCEY",3,3,.5,.5,6,0,0,0,0
"KENDY",2,2,.5,.5,4,0,0,0,0
"KENTA",5,1,.8333333,.1666667,6,1,0,0,0
"KEYVAN",4,0,1,0,4,1,0,1,0
"KHRYSTYNA",0,2,0,1,2,0,1,0,1
"KIDD",4,1,.8,.2,5,1,0,0,0
"KIMBERLI",0,2,0,1,2,0,1,0,1
"KINDRA",0,3,0,1,3,0,1,0,1
"KIRSY",0,4,0,1,4,0,1,0,1
"KIYANA",0,4,0,1,4,0,1,0,1
"KNOWLEDGE",4,0,1,0,4,1,0,1,0
"KON",2,0,1,0,2,1,0,1,0
"KOUROSH",3,0,1,0,3,1,0,1,0
"KRAIG",3,0,1,0,3,1,0,1,0
"KRAMER",5,1,.8333333,.1666667,6,1,0,0,0
"KRISHNAN",5,0,1,0,5,1,0,1,0
"KRIZIA",0,5,0,1,5,0,1,0,1
"KRUNAL",6,0,1,0,6,1,0,1,0
"KRYSTI",0,3,0,1,3,0,1,0,1
"LABINOT",6,0,1,0,6,1,0,1,0
"LACI",0,5,0,1,5,0,1,0,1
"LADI",3,1,.75,.25,4,0,0,0,0
"LADONNA",0,6,0,1,6,0,1,0,1
"LAINA",0,3,0,1,3,0,1,0,1
"LAINEY",0,3,0,1,3,0,1,0,1
"LALO",5,0,1,0,5,1,0,1,0
"LAMEL",4,0,1,0,4,1,0,1,0
"LANDO",4,0,1,0,4,1,0,1,0
"LANEY",0,2,0,1,2,0,1,0,1
"LANIECE",0,4,0,1,4,0,1,0,1
"LANIER",3,2,.6,.4,5,0,0,0,0
"LASHA",2,3,.4,.6,5,0,0,0,0
"LASHAWNDA",0,3,0,1,3,0,1,0,1
"LASHON",0,8,0,1,8,0,1,0,1
"LATICIA",0,6,0,1,6,0,1,0,1
"LAURO",7,0,1,0,7,1,0,1,0
"LAVETTE",0,2,0,1,2,0,1,0,1
"LAYTON",6,0,1,0,6,1,0,1,0
"LAZARUS",4,1,.8,.2,5,1,0,0,0
"LEBA",1,3,.25,.75,4,0,0,0,0
"LEEANNA",0,2,0,1,2,0,1,0,1
"LEELEE",0,2,0,1,2,0,1,0,1
"LEEOR",3,1,.75,.25,4,0,0,0,0
"LEIBY",4,2,.6666667,.3333333,6,0,0,0,0
"LEMUEL",6,0,1,0,6,1,0,1,0
"LENETTE",0,6,0,1,6,0,1,0,1
"LEVIN",4,0,1,0,4,1,0,1,0
"LEXX",1,1,.5,.5,2,0,0,0,0
"LIESL",0,5,0,1,5,0,1,0,1
"LIRAZ",0,4,0,1,4,0,1,0,1
"LITO",6,0,1,0,6,1,0,1,0
"LIVIO",6,0,1,0,6,1,0,1,0
"LOBSANG",6,0,1,0,6,1,0,1,0
"LOK",3,2,.6,.4,5,0,0,0,0
"LONE",4,1,.8,.2,5,1,0,0,0
"LORETO",1,3,.25,.75,4,0,0,0,0
"LORIANNE",0,4,0,1,4,0,1,0,1
"LORINE",0,6,0,1,6,0,1,0,1
"LORRY",0,4,0,1,4,0,1,0,1
"LOTUS",0,7,0,1,7,0,1,0,1
"LOUANNE",0,5,0,1,5,0,1,0,1
"LUDIVINE",0,5,0,1,5,0,1,0,1
"LYNELL",1,4,.2,.8,5,0,1,0,0
"MAARTEN",6,0,1,0,6,1,0,1,0
"MADHURI",0,4,0,1,4,0,1,0,1
"MAHEEN",1,4,.2,.8,5,0,1,0,0
"MAHSA",1,4,.2,.8,5,0,1,0,0
"MAIJA",0,2,0,1,2,0,1,0,1
"MAIN",2,1,.6666667,.3333333,3,0,0,0,0
"MAJED",6,0,1,0,6,1,0,1,0
"MALIEK",4,0,1,0,4,1,0,1,0
"MALIKAH",0,2,0,1,2,0,1,0,1
"MALU",0,7,0,1,7,0,1,0,1
"MANANA",0,4,0,1,4,0,1,0,1
"MARGI",0,6,0,1,6,0,1,0,1
"MARIE-LAURE",0,2,0,1,2,0,1,0,1
"MARKELLA",0,4,0,1,4,0,1,0,1
"MARO",1,2,.3333333,.6666667,3,0,0,0,0
"MARYANNA",0,3,0,1,3,0,1,0,1
"MARY-ELLEN",0,3,0,1,3,0,1,0,1
"MARYGRACE",0,3,0,1,3,0,1,0,1
"MARYLYNN",0,3,0,1,3,0,1,0,1
"MASIEL",0,5,0,1,5,0,1,0,1
"MASUM",6,0,1,0,6,1,0,1,0
"MATEUS",5,0,1,0,5,1,0,1,0
"MATTIAS",4,0,1,0,4,1,0,1,0
"MAZHAR",3,0,1,0,3,1,0,1,0
"MCKENNA",0,5,0,1,5,0,1,0,1
"MEAN",3,2,.6,.4,5,0,0,0,0
"MEE",2,3,.4,.6,5,0,0,0,0
"MEESHA",0,4,0,1,4,0,1,0,1
"MEETA",0,4,0,1,4,0,1,0,1
"MEHWISH",0,5,0,1,5,0,1,0,1
"MELICIA",0,4,0,1,4,0,1,0,1
"MELITZA",0,5,0,1,5,0,1,0,1
"MELL",3,2,.6,.4,5,0,0,0,0
"MERLENE",0,6,0,1,6,0,1,0,1
"MERV",5,1,.8333333,.1666667,6,1,0,0,0
"MESSIAH",5,0,1,0,5,1,0,1,0
"MIAN",4,0,1,0,4,1,0,1,0
"MICHE",1,3,.25,.75,4,0,0,0,0
"MICHIEL",7,0,1,0,7,1,0,1,0
"MICHY",0,2,0,1,2,0,1,0,1
"MICOLE",0,4,0,1,4,0,1,0,1
"MIJIN",0,3,0,1,3,0,1,0,1
"MIK",4,0,1,0,4,1,0,1,0
"MIL",4,1,.8,.2,5,1,0,0,0
"MILDA",0,3,0,1,3,0,1,0,1
"MINHEE",0,3,0,1,3,0,1,0,1
"MIQUEL",2,0,1,0,2,1,0,1,0
"MIRKA",0,2,0,1,2,0,1,0,1
"MIRO",4,0,1,0,4,1,0,1,0
"MIRON",3,0,1,0,3,1,0,1,0
"MISTAH",2,1,.6666667,.3333333,3,0,0,0,0
"MITALI",0,5,0,1,5,0,1,0,1
"MITHUN",2,1,.6666667,.3333333,3,0,0,0,0
"MITSUKO",0,3,0,1,3,0,1,0,1
"MOISE",3,0,1,0,3,1,0,1,0
"MOMOKO",0,4,0,1,4,0,1,0,1
"MONIR",4,0,1,0,4,1,0,1,0
"MONTI",4,2,.6666667,.3333333,6,0,0,0,0
"MOODY",3,2,.6,.4,5,0,0,0,0
"MOOKIE",4,1,.8,.2,5,1,0,0,0
"MORALES",1,1,.5,.5,2,0,0,0,0
"MOTOKO",0,4,0,1,4,0,1,0,1
"MRINAL",4,1,.8,.2,5,1,0,0,0
"MUBARAK",5,0,1,0,5,1,0,1,0
"MUHAMMET",2,0,1,0,2,1,0,1,0
"MUNECA",0,4,0,1,4,0,1,0,1
"MUNIRA",0,4,0,1,4,0,1,0,1
"MUTTY",2,1,.6666667,.3333333,3,0,0,0,0
"NADIRAH",0,4,0,1,4,0,1,0,1
"NAHIDA",0,3,0,1,3,0,1,0,1
"NAHLA",0,5,0,1,5,0,1,0,1
"NAJ",4,2,.6666667,.3333333,6,0,0,0,0
"NANAKO",0,3,0,1,3,0,1,0,1
"NARCISO",6,0,1,0,6,1,0,1,0
"NARINE",3,1,.75,.25,4,0,0,0,0
"NASTASIA",0,4,0,1,4,0,1,0,1
"NATALIJA",0,4,0,1,4,0,1,0,1
"NATHIFA",0,4,0,1,4,0,1,0,1
"NAUDIA",0,6,0,1,6,0,1,0,1
"NAVINDRA",4,0,1,0,4,1,0,1,0
"NEELY",0,3,0,1,3,0,1,0,1
"NEEMA",2,1,.6666667,.3333333,3,0,0,0,0
"NEF",2,4,.3333333,.6666667,6,0,0,0,0
"NELSY",0,7,0,1,7,0,1,0,1
"NERMIN",1,3,.25,.75,4,0,0,0,0
"NES",3,2,.6,.4,5,0,0,0,0
"NEVADA",0,3,0,1,3,0,1,0,1
"NEYDA",0,5,0,1,5,0,1,0,1
"NEYSA",0,3,0,1,3,0,1,0,1
"NGAI",4,1,.8,.2,5,1,0,0,0
"NICHOLETTE",0,4,0,1,4,0,1,0,1
"NICOLINA",0,6,0,1,6,0,1,0,1
"NIGER",0,5,0,1,5,0,1,0,1
"NIKE",1,2,.3333333,.6666667,3,0,0,0,0
"NIKKIE",0,4,0,1,4,0,1,0,1
"NIKOLAUS",4,0,1,0,4,1,0,1,0
"NINETTE",0,5,0,1,5,0,1,0,1
"NIRALI",0,4,0,1,4,0,1,0,1
"NIYATI",0,3,0,1,3,0,1,0,1
"NIZAR",4,0,1,0,4,1,0,1,0
"NJERI",0,3,0,1,3,0,1,0,1
"NKOSI",6,0,1,0,6,1,0,1,0
"NOUMAN",4,0,1,0,4,1,0,1,0
"NUNU",1,4,.2,.8,5,0,1,0,0
"NYEMA",0,3,0,1,3,0,1,0,1
"NYRON",3,0,1,0,3,1,0,1,0
"NZINGA",0,3,0,1,3,0,1,0,1
"OKTAY",6,0,1,0,6,1,0,1,0
"OLANDO",7,0,1,0,7,1,0,1,0
"OLAYINKA",1,2,.3333333,.6666667,3,0,0,0,0
"OLD",1,2,.3333333,.6666667,3,0,0,0,0
"OLUMIDE",3,0,1,0,3,1,0,1,0
"OLUSEGUN",3,1,.75,.25,4,0,0,0,0
"OMESH",4,0,1,0,4,1,0,1,0
"ONA",0,2,0,1,2,0,1,0,1
"OPEN",3,4,.4285714,.5714286,7,0,0,0,0
"ORESTES",6,0,1,0,6,1,0,1,0
"OVIDIU",2,0,1,0,2,1,0,1,0
"PADMINI",0,3,0,1,3,0,1,0,1
"PAVLO",7,0,1,0,7,1,0,1,0
"PAYAM",5,0,1,0,5,1,0,1,0
"PEE",3,2,.6,.4,5,0,0,0,0
"PEPPE",4,0,1,0,4,1,0,1,0
"PERCIVAL",4,0,1,0,4,1,0,1,0
"PERNILLA",0,4,0,1,4,0,1,0,1
"PHI",2,2,.5,.5,4,0,0,0,0
"PHILLIPS",2,3,.4,.6,5,0,0,0,0
"PIERINA",0,3,0,1,3,0,1,0,1
"PIP",1,3,.25,.75,4,0,0,0,0
"POPPA",5,0,1,0,5,1,0,1,0
"PRASANNA",6,0,1,0,6,1,0,1,0
"PRIA",1,4,.2,.8,5,0,1,0,0
"PROVIDENCIA",0,5,0,1,5,0,1,0,1
"QIANG",5,1,.8333333,.1666667,6,1,0,0,0
"QIAO",3,3,.5,.5,6,0,0,0,0
"QUANDA",0,4,0,1,4,0,1,0,1
"QUEENY",0,5,0,1,5,0,1,0,1
"QUIANNA",0,6,0,1,6,0,1,0,1
"RAJI",1,1,.5,.5,2,0,0,0,0
"RAMIZ",4,0,1,0,4,1,0,1,0
"RAPHAELLE",0,2,0,1,2,0,1,0,1
"RASEL",4,0,1,0,4,1,0,1,0
"RASHON",6,0,1,0,6,1,0,1,0
"RAV",4,0,1,0,4,1,0,1,0
"RAYMUND",4,0,1,0,4,1,0,1,0
"RAZI",4,0,1,0,4,1,0,1,0
"REAZ",3,0,1,0,3,1,0,1,0
"REBECKA",0,3,0,1,3,0,1,0,1
"REMON",6,0,1,0,6,1,0,1,0
"RENAT",5,0,1,0,5,1,0,1,0
"RENUKA",0,3,0,1,3,0,1,0,1
"REZWAN",4,0,1,0,4,1,0,1,0
"RINI",0,4,0,1,4,0,1,0,1
"RIPON",4,1,.8,.2,5,1,0,0,0
"RISE",2,2,.5,.5,4,0,0,0,0
"RIVKAH",0,3,0,1,3,0,1,0,1
"RIVKIE",0,4,0,1,4,0,1,0,1
"ROBERTSON",2,0,1,0,2,1,0,1,0
"ROBSON",7,0,1,0,7,1,0,1,0
"RODRICK",3,0,1,0,3,1,0,1,0
"ROEL",5,0,1,0,5,1,0,1,0
"ROMANE",2,2,.5,.5,4,0,0,0,0
"ROMULO",5,0,1,0,5,1,0,1,0
"RONICA",0,6,0,1,6,0,1,0,1
"RONNEL",2,1,.6666667,.3333333,3,0,0,0,0
"ROQUE",6,0,1,0,6,1,0,1,0
"ROSARY",0,6,0,1,6,0,1,0,1
"ROSELY",0,6,0,1,6,0,1,0,1
"ROSSANNA",0,2,0,1,2,0,1,0,1
"ROYSTON",5,0,1,0,5,1,0,1,0
"RUHUL",5,1,.8333333,.1666667,6,1,0,0,0
"RUMANA",0,5,0,1,5,0,1,0,1
"RUSHI",5,0,1,0,5,1,0,1,0
"RUSTAM",6,0,1,0,6,1,0,1,0
"RUTA",0,4,0,1,4,0,1,0,1
"SA",0,4,0,1,4,0,1,0,1
"SAAR",3,0,1,0,3,1,0,1,0
"SABEEN",0,3,0,1,3,0,1,0,1
"SABRA",0,4,0,1,4,0,1,0,1
"SABRI",4,0,1,0,4,1,0,1,0
"SAGIT",0,3,0,1,3,0,1,0,1
"SALI",3,2,.6,.4,5,0,0,0,0
"SALVO",6,0,1,0,6,1,0,1,0
"SAMAD",3,0,1,0,3,1,0,1,0
"SAMAH",0,2,0,1,2,0,1,0,1
"SAMMANTHA",0,4,0,1,4,0,1,0,1
"SANNY",3,2,.6,.4,5,0,0,0,0
"SANTY",2,1,.6666667,.3333333,3,0,0,0,0
"SAQUAN",5,0,1,0,5,1,0,1,0
"SARMAD",3,0,1,0,3,1,0,1,0
"SARY",0,5,0,1,5,0,1,0,1
"SAT",4,2,.6666667,.3333333,6,0,0,0,0
"SATORU",2,0,1,0,2,1,0,1,0
"SAUD",6,0,1,0,6,1,0,1,0
"SAULO",5,0,1,0,5,1,0,1,0
"SAVAGE",5,0,1,0,5,1,0,1,0
"SAVANNA",0,4,0,1,4,0,1,0,1
"SAYED",6,0,1,0,6,1,0,1,0
"SEA",2,1,.6666667,.3333333,3,0,0,0,0
"SEASON",1,3,.25,.75,4,0,0,0,0
"SEIF",5,0,1,0,5,1,0,1,0
"SEMA",0,4,0,1,4,0,1,0,1
"SENADA",0,7,0,1,7,0,1,0,1
"SERAP",0,3,0,1,3,0,1,0,1
"SHABAZZ",5,1,.8333333,.1666667,6,1,0,0,0
"SHAHAB",4,0,1,0,4,1,0,1,0
"SHAIN",6,0,1,0,6,1,0,1,0
"SHAJI",5,0,1,0,5,1,0,1,0
"SHALIMAR",1,3,.25,.75,4,0,0,0,0
"SHAMARI",4,2,.6666667,.3333333,6,0,0,0,0
"SHAMIK",3,0,1,0,3,1,0,1,0
"SHAMIRA",0,4,0,1,4,0,1,0,1
"SHANEEN",0,3,0,1,3,0,1,0,1
"SHANNAH",0,3,0,1,3,0,1,0,1
"SHANTIE",0,4,0,1,4,0,1,0,1
"SHAREE",0,8,0,1,8,0,1,0,1
"SHAREENA",0,6,0,1,6,0,1,0,1
"SHAREN",0,5,0,1,5,0,1,0,1
"SHARIE",0,5,0,1,5,0,1,0,1
"SHARINE",0,6,0,1,6,0,1,0,1
"SHARIQ",2,0,1,0,2,1,0,1,0
"SHARMEEN",0,3,0,1,3,0,1,0,1
"SHARRI",0,4,0,1,4,0,1,0,1
"SHATARA",0,4,0,1,4,0,1,0,1
"SHATIA",0,4,0,1,4,0,1,0,1
"SHATISHA",0,6,0,1,6,0,1,0,1
"SHAW",4,1,.8,.2,5,1,0,0,0
"SHAWNTAY",0,6,0,1,6,0,1,0,1
"SHE",0,6,0,1,6,0,1,0,1
"SHEN",1,1,.5,.5,2,0,0,0,0
"SHENAE",0,5,0,1,5,0,1,0,1
"SHERICA",0,7,0,1,7,0,1,0,1
"SHERISSE",0,4,0,1,4,0,1,0,1
"SHERROD",4,1,.8,.2,5,1,0,0,0
"SHEYLA",0,3,0,1,3,0,1,0,1
"SHIBU",4,0,1,0,4,1,0,1,0
"SHIH",3,1,.75,.25,4,0,0,0,0
"SHIMRIT",0,5,0,1,5,0,1,0,1
"SHIVON",2,4,.3333333,.6666667,6,0,0,0,0
"SHOBA",0,4,0,1,4,0,1,0,1
"SHOHEI",5,0,1,0,5,1,0,1,0
"SHONTAY",0,4,0,1,4,0,1,0,1
"SHUVO",4,0,1,0,4,1,0,1,0
"SIGFREDO",5,0,1,0,5,1,0,1,0
"SIGMUND",7,0,1,0,7,1,0,1,0
"SILA",1,3,.25,.75,4,0,0,0,0
"SILVESTRE",7,0,1,0,7,1,0,1,0
"SIMPSON",3,1,.75,.25,4,0,0,0,0
"SKENDER",6,0,1,0,6,1,0,1,0
"SLEEPY",3,1,.75,.25,4,0,0,0,0
"SMOOTH",5,0,1,0,5,1,0,1,0
"SNEAKER",5,1,.8333333,.1666667,6,1,0,0,0
"SOBIA",0,4,0,1,4,0,1,0,1
"SOLE",2,4,.3333333,.6666667,6,0,0,0,0
"SOOMIN",0,2,0,1,2,0,1,0,1
"SOOYEON",0,5,0,1,5,0,1,0,1
"SOUFIANE",5,0,1,0,5,1,0,1,0
"SOULEYMANE",5,0,1,0,5,1,0,1,0
"SOURAV",6,0,1,0,6,1,0,1,0
"SPENCE",2,1,.6666667,.3333333,3,0,0,0,0
"SRIKANTH",6,0,1,0,6,1,0,1,0
"STACE",1,4,.2,.8,5,0,1,0,0
"STEFFIE",0,3,0,1,3,0,1,0,1
"STEFFY",0,2,0,1,2,0,1,0,1
"STEFON",6,0,1,0,6,1,0,1,0
"STELA",0,6,0,1,6,0,1,0,1
"SUBASH",5,0,1,0,5,1,0,1,0
"SUK",4,2,.6666667,.3333333,6,0,0,0,0
"SULY",1,6,.1428571,.8571429,7,0,1,0,0
"SUMAYA",0,2,0,1,2,0,1,0,1
"SUNI",0,3,0,1,3,0,1,0,1
"SUREN",2,0,1,0,2,1,0,1,0
"SURENDRA",6,0,1,0,6,1,0,1,0
"SUZE",0,5,0,1,5,0,1,0,1
"SYDELLE",0,7,0,1,7,0,1,0,1
"SYLVAN",4,0,1,0,4,1,0,1,0
"TACO",6,0,1,0,6,1,0,1,0
"TAIESHA",0,3,0,1,3,0,1,0,1
"TAJI",4,2,.6666667,.3333333,6,0,0,0,0
"TAKAHIRO",5,0,1,0,5,1,0,1,0
"TAKEISHA",0,4,0,1,4,0,1,0,1
"TAKEYA",0,4,0,1,4,0,1,0,1
"TAKU",3,1,.75,.25,4,0,0,0,0
"TAKUYA",8,0,1,0,8,1,0,1,0
"TALIAH",0,5,0,1,5,0,1,0,1
"TALIB",5,0,1,0,5,1,0,1,0
"TALITA",0,5,0,1,5,0,1,0,1
"TAMARAH",0,2,0,1,2,0,1,0,1
"TANISHIA",0,6,0,1,6,0,1,0,1
"TASHAWNA",0,6,0,1,6,0,1,0,1
"TASHEEMA",0,5,0,1,5,0,1,0,1
"TASHIKA",0,6,0,1,6,0,1,0,1
"TASNEEM",1,4,.2,.8,5,0,1,0,0
"TASOS",4,0,1,0,4,1,0,1,0
"TATA",2,5,.2857143,.7142857,7,0,0,0,0
"TEGAN",1,6,.1428571,.8571429,7,0,1,0,0
"TEK",3,1,.75,.25,4,0,0,0,0
"TENA",0,4,0,1,4,0,1,0,1
"TEVON",6,0,1,0,6,1,0,1,0
"THANDI",0,5,0,1,5,0,1,0,1
"THEMIS",4,0,1,0,4,1,0,1,0
"THEOPHILUS",7,0,1,0,7,1,0,1,0
"THU",2,1,.6666667,.3333333,3,0,0,0,0
"THUY",0,5,0,1,5,0,1,0,1
"TIERA",0,4,0,1,4,0,1,0,1
"TIFFANEY",0,4,0,1,4,0,1,0,1
"TIJANA",0,4,0,1,4,0,1,0,1
"TIKA",0,4,0,1,4,0,1,0,1
"TILL",4,0,1,0,4,1,0,1,0
"TIMA",0,3,0,1,3,0,1,0,1
"TIMOTHEE",4,0,1,0,4,1,0,1,0
"TIPHAINE",1,1,.5,.5,2,0,0,0,0
"TIRA",0,4,0,1,4,0,1,0,1
"TISHAWN",3,4,.4285714,.5714286,7,0,0,0,0
"TOMA",2,1,.6666667,.3333333,3,0,0,0,0
"TOMIKA",0,5,0,1,5,0,1,0,1
"TON",2,0,1,0,2,1,0,1,0
"TONNY",6,0,1,0,6,1,0,1,0
"TOPAZ",2,4,.3333333,.6666667,6,0,0,0,0
"TORIA",0,6,0,1,6,0,1,0,1
"TOSH",4,0,1,0,4,1,0,1,0
"TOULA",0,6,0,1,6,0,1,0,1
"TOURE",3,1,.75,.25,4,0,0,0,0
"TRINH",3,2,.6,.4,5,0,0,0,0
"TRISTEN",3,2,.6,.4,5,0,0,0,0
"TRISTIAN",6,1,.8571429,.1428571,7,1,0,0,0
"TRUMAN",8,0,1,0,8,1,0,1,0
"TUGBA",0,2,0,1,2,0,1,0,1
"TULLY",4,1,.8,.2,5,1,0,0,0
"TUNA",7,0,1,0,7,1,0,1,0
"TUNISIA",0,5,0,1,5,0,1,0,1
"UDAYAN",4,0,1,0,4,1,0,1,0
"UMI",2,2,.5,.5,4,0,0,0,0
"USAMA",5,0,1,0,5,1,0,1,0
"VANNESSA",0,6,0,1,6,0,1,0,1
"VEDAT",6,0,1,0,6,1,0,1,0
"VEDRAN",3,0,1,0,3,1,0,1,0
"VERNICE",0,4,0,1,4,0,1,0,1
"VIA",0,2,0,1,2,0,1,0,1
"VIANNEY",0,4,0,1,4,0,1,0,1
"VICTOIRE",0,4,0,1,4,0,1,0,1
"VIET",4,1,.8,.2,5,1,0,0,0
"VIJAYA",0,3,0,1,3,0,1,0,1
"VIKTORIJA",0,4,0,1,4,0,1,0,1
"VINICIUS",5,0,1,0,5,1,0,1,0
"VIOLAINE",0,4,0,1,4,0,1,0,1
"VIP",5,3,.625,.375,8,0,0,0,0
"VISAR",5,0,1,0,5,1,0,1,0
"VIVIENE",0,5,0,1,5,0,1,0,1
"VOLKER",4,0,1,0,4,1,0,1,0
"VOLODYMYR",8,0,1,0,8,1,0,1,0
"VU",5,1,.8333333,.1666667,6,1,0,0,0
"VYACHESLAV",3,0,1,0,3,1,0,1,0
"WAFA",0,3,0,1,3,0,1,0,1
"WERONIKA",0,2,0,1,2,0,1,0,1
"WILFRIDO",7,0,1,0,7,1,0,1,0
"WIOLETTA",0,6,0,1,6,0,1,0,1
"WOLE",5,0,1,0,5,1,0,1,0
"XIAOYAN",0,3,0,1,3,0,1,0,1
"YAHIRA",0,5,0,1,5,0,1,0,1
"YALI",1,5,.1666667,.8333333,6,0,1,0,0
"YAMILETH",0,6,0,1,6,0,1,0,1
"YANETH",0,3,0,1,3,0,1,0,1
"YANIRIS",0,6,0,1,6,0,1,0,1
"YANIS",3,2,.6,.4,5,0,0,0,0
"YARIV",3,0,1,0,3,1,0,1,0
"YASSIN",6,0,1,0,6,1,0,1,0
"YEIMY",0,3,0,1,3,0,1,0,1
"YEISON",4,0,1,0,4,1,0,1,0
"YEJIN",0,8,0,1,8,0,1,0,1
"YENIFER",0,6,0,1,6,0,1,0,1
"YESICA",0,3,0,1,3,0,1,0,1
"YESIM",0,3,0,1,3,0,1,0,1
"YESSY",0,5,0,1,5,0,1,0,1
"YIANNIS",6,0,1,0,6,1,0,1,0
"YIM",1,3,.25,.75,4,0,0,0,0
"YINA",0,5,0,1,5,0,1,0,1
"YOGITA",0,6,0,1,6,0,1,0,1
"YOMAYRA",0,6,0,1,6,0,1,0,1
"YOURI",4,0,1,0,4,1,0,1,0
"YOUSUF",4,0,1,0,4,1,0,1,0
"YUDA",4,0,1,0,4,1,0,1,0
"YUJIN",1,4,.2,.8,5,0,1,0,0
"YUUKI",4,2,.6666667,.3333333,6,0,0,0,0
"ZAMAN",4,0,1,0,4,1,0,1,0
"ZEHAVA",0,5,0,1,5,0,1,0,1
"ZELJKO",6,0,1,0,6,1,0,1,0
"ZEVI",4,0,1,0,4,1,0,1,0
"ZHAN",2,1,.6666667,.3333333,3,0,0,0,0
"ZOBEIDA",0,3,0,1,3,0,1,0,1
"ZSUZSANNA",0,7,0,1,7,0,1,0,1
"ZUBIN",5,0,1,0,5,1,0,1,0
"ABBA",6,0,1,0,6,1,0,1,0
"ABDULAZIZ",5,0,1,0,5,1,0,1,0
"ABDULRAHMAN",5,0,1,0,5,1,0,1,0
"ABDUR",5,0,1,0,5,1,0,1,0
"ABELARDO",5,0,1,0,5,1,0,1,0
"ABRA",0,2,0,1,2,0,1,0,1
"ABUBAKAR",5,0,1,0,5,1,0,1,0
"ADAIR",0,4,0,1,4,0,1,0,1
"ADANA",0,4,0,1,4,0,1,0,1
"ADEBOLA",0,3,0,1,3,0,1,0,1
"ADEDAYO",3,1,.75,.25,4,0,0,0,0
"ADEN",0,2,0,1,2,0,1,0,1
"ADIEL",6,0,1,0,6,1,0,1,0
"ADIT",3,1,.75,.25,4,0,0,0,0
"ADLER",4,0,1,0,4,1,0,1,0
"ADRIENE",1,5,.1666667,.8333333,6,0,1,0,0
"AFFAN",3,0,1,0,3,1,0,1,0
"AFRIM",3,0,1,0,3,1,0,1,0
"AHYOUNG",0,4,0,1,4,0,1,0,1
"AILSA",0,4,0,1,4,0,1,0,1
"AINE",0,4,0,1,4,0,1,0,1
"AINSWORTH",6,0,1,0,6,1,0,1,0
"AKARI",0,3,0,1,3,0,1,0,1
"AKEISHA",0,2,0,1,2,0,1,0,1
"ALBI",6,0,1,0,6,1,0,1,0
"ALBION",6,0,1,0,6,1,0,1,0
"ALDA",0,4,0,1,4,0,1,0,1
"ALDONA",0,3,0,1,3,0,1,0,1
"ALEAH",0,4,0,1,4,0,1,0,1
"ALEEN",0,5,0,1,5,0,1,0,1
"ALEISHA",0,3,0,1,3,0,1,0,1
"ALEV",0,3,0,1,3,0,1,0,1
"ALEXSA",0,5,0,1,5,0,1,0,1
"ALFONSINA",0,5,0,1,5,0,1,0,1
"ALFREDA",0,4,0,1,4,0,1,0,1
"ALIKI",0,2,0,1,2,0,1,0,1
"ALIM",3,0,1,0,3,1,0,1,0
"ALIS",0,2,0,1,2,0,1,0,1
"ALIXANDRA",0,3,0,1,3,0,1,0,1
"ALMIR",4,0,1,0,4,1,0,1,0
"ALMOG",2,1,.6666667,.3333333,3,0,0,0,0
"ALPANA",0,4,0,1,4,0,1,0,1
"ALPESH",6,0,1,0,6,1,0,1,0
"ALWIN",3,0,1,0,3,1,0,1,0
"ALYX",1,2,.3333333,.6666667,3,0,0,0,0
"AMADI",2,2,.5,.5,4,0,0,0,0
"AMADOR",4,0,1,0,4,1,0,1,0
"AMARJIT",4,0,1,0,4,1,0,1,0
"AMETHYST",0,2,0,1,2,0,1,0,1
"AMGAD",3,0,1,0,3,1,0,1,0
"AMIEE",0,4,0,1,4,0,1,0,1
"AMIL",3,0,1,0,3,1,0,1,0
"AMMON",3,0,1,0,3,1,0,1,0
"ANALI",0,4,0,1,4,0,1,0,1
"ANDREANA",0,2,0,1,2,0,1,0,1
"ANDRENE",0,7,0,1,7,0,1,0,1
"ANDRU",5,0,1,0,5,1,0,1,0
"ANESHA",0,6,0,1,6,0,1,0,1
"ANETTA",0,2,0,1,2,0,1,0,1
"ANEUDY",4,0,1,0,4,1,0,1,0
"ANGELENE",0,5,0,1,5,0,1,0,1
"ANIKO",0,3,0,1,3,0,1,0,1
"ANIQA",0,4,0,1,4,0,1,0,1
"ANJANETTE",0,5,0,1,5,0,1,0,1
"ANJEL",1,3,.25,.75,4,0,0,0,0
"ANKE",0,3,0,1,3,0,1,0,1
"ANNA-LISA",0,2,0,1,2,0,1,0,1
"ANNERIS",0,4,0,1,4,0,1,0,1
"ANNIA",0,6,0,1,6,0,1,0,1
"ANNU",0,3,0,1,3,0,1,0,1
"ANSELM",6,0,1,0,6,1,0,1,0
"ANSELMO",6,0,1,0,6,1,0,1,0
"ANSHUMAN",4,0,1,0,4,1,0,1,0
"ANSLEY",0,4,0,1,4,0,1,0,1
"ANTJE",0,5,0,1,5,0,1,0,1
"ANTONIOS",2,0,1,0,2,1,0,1,0
"ANUM",0,3,0,1,3,0,1,0,1
"AQSA",0,3,0,1,3,0,1,0,1
"AREK",5,0,1,0,5,1,0,1,0
"AREN",2,1,.6666667,.3333333,3,0,0,0,0
"ARIADNE",0,2,0,1,2,0,1,0,1
"ARISTIDE",2,0,1,0,2,1,0,1,0
"ARLENY",1,3,.25,.75,4,0,0,0,0
"ARLINDA",0,4,0,1,4,0,1,0,1
"ARMAAN",3,0,1,0,3,1,0,1,0
"ARTIST",2,3,.4,.6,5,0,0,0,0
"ARTO",6,0,1,0,6,1,0,1,0
"ARYA",3,0,1,0,3,1,0,1,0
"ASAMI",0,2,0,1,2,0,1,0,1
"ASHELY",1,3,.25,.75,4,0,0,0,0
"ASHIQ",5,0,1,0,5,1,0,1,0
"ASHU",1,2,.3333333,.6666667,3,0,0,0,0
"ASTRIT",4,0,1,0,4,1,0,1,0
"ATIA",0,2,0,1,2,0,1,0,1
"ATIT",4,0,1,0,4,1,0,1,0
"ATTILIO",6,0,1,0,6,1,0,1,0
"AUDRY",1,6,.1428571,.8571429,7,0,1,0,0
"AUGUSTE",5,0,1,0,5,1,0,1,0
"AUNDRE",4,0,1,0,4,1,0,1,0
"AUREL",2,0,1,0,2,1,0,1,0
"AVRAM",3,0,1,0,3,1,0,1,0
"AVROM",2,0,1,0,2,1,0,1,0
"AVTAR",4,0,1,0,4,1,0,1,0
"AYAL",4,0,1,0,4,1,0,1,0
"AYAN",1,1,.5,.5,2,0,0,0,0
"AYANO",0,3,0,1,3,0,1,0,1
"AYLEEN",0,2,0,1,2,0,1,0,1
"AYODEJI",4,0,1,0,4,1,0,1,0
"AYTAC",3,0,1,0,3,1,0,1,0
"AYTEKIN",4,0,1,0,4,1,0,1,0
"AZURE",0,3,0,1,3,0,1,0,1
"BABIE",1,4,.2,.8,5,0,1,0,0
"BADR",5,0,1,0,5,1,0,1,0
"BAH",5,1,.8333333,.1666667,6,1,0,0,0
"BANKS",6,0,1,0,6,1,0,1,0
"BARNARD",1,2,.3333333,.6666667,3,0,0,0,0
"BARNETT",5,1,.8333333,.1666667,6,1,0,0,0
"BARTLEY",1,1,.5,.5,2,0,0,0,0
"BASAK",0,4,0,1,4,0,1,0,1
"BASMA",0,5,0,1,5,0,1,0,1
"BATIA",0,5,0,1,5,0,1,0,1
"BAY",3,2,.6,.4,5,0,0,0,0
"BEANIE",1,2,.3333333,.6666667,3,0,0,0,0
"BELGICA",0,3,0,1,3,0,1,0,1
"BELMA",0,4,0,1,4,0,1,0,1
"BENEDICTA",0,5,0,1,5,0,1,0,1
"BENEDICTE",0,4,0,1,4,0,1,0,1
"BENN",5,0,1,0,5,1,0,1,0
"BENNET",3,0,1,0,3,1,0,1,0
"BENNI",3,0,1,0,3,1,0,1,0
"BENNO",4,0,1,0,4,1,0,1,0
"BERAT",3,1,.75,.25,4,0,0,0,0
"BEREL",2,0,1,0,2,1,0,1,0
"BERRIN",0,5,0,1,5,0,1,0,1
"BERTIN",4,0,1,0,4,1,0,1,0
"BEVAN",4,0,1,0,4,1,0,1,0
"BEYONCE",0,5,0,1,5,0,1,0,1
"BEYOND",3,0,1,0,3,1,0,1,0
"BIG",4,0,1,0,4,1,0,1,0
"BIJOU",0,4,0,1,4,0,1,0,1
"BIL",3,1,.75,.25,4,0,0,0,0
"BIM",4,0,1,0,4,1,0,1,0
"BINYOMIN",6,0,1,0,6,1,0,1,0
"BIREN",3,0,1,0,3,1,0,1,0
"BISHNU",4,0,1,0,4,1,0,1,0
"BISI",0,4,0,1,4,0,1,0,1
"BISMARK",4,0,1,0,4,1,0,1,0
"BIZ",3,2,.6,.4,5,0,0,0,0
"BIZZY",4,0,1,0,4,1,0,1,0
"BLEDI",2,0,1,0,2,1,0,1,0
"BOJANA",0,3,0,1,3,0,1,0,1
"BOND",2,1,.6666667,.3333333,3,0,0,0,0
"BOOM",1,2,.3333333,.6666667,3,0,0,0,0
"BORI",1,1,.5,.5,2,0,0,0,0
"BORISLAV",4,0,1,0,4,1,0,1,0
"BOUBACAR",5,0,1,0,5,1,0,1,0
"BOYCE",4,2,.6666667,.3333333,6,0,0,0,0
"BOYD",4,0,1,0,4,1,0,1,0
"BRANKA",0,4,0,1,4,0,1,0,1
"BRANNON",3,0,1,0,3,1,0,1,0
"BRAZIL",2,2,.5,.5,4,0,0,0,0
"BRENNEN",1,1,.5,.5,2,0,0,0,0
"BRINDA",0,2,0,1,2,0,1,0,1
"BRUNI",0,2,0,1,2,0,1,0,1
"BRYANNE",0,2,0,1,2,0,1,0,1
"BRYNA",0,2,0,1,2,0,1,0,1
"BUFFALO",5,1,.8333333,.1666667,6,1,0,0,0
"BURÃ‡IN",0,2,0,1,2,0,1,0,1
"CAI",1,3,.25,.75,4,0,0,0,0
"CALANDRA",0,6,0,1,6,0,1,0,1
"CALIN",2,1,.6666667,.3333333,3,0,0,0,0
"CALLA",0,2,0,1,2,0,1,0,1
"CALVERT",2,0,1,0,2,1,0,1,0
"CAMEO",1,3,.25,.75,4,0,0,0,0
"CAMILLIA",0,4,0,1,4,0,1,0,1
"CANDISE",0,3,0,1,3,0,1,0,1
"CANDRA",0,3,0,1,3,0,1,0,1
"CANNON",4,0,1,0,4,1,0,1,0
"CAR",1,2,.3333333,.6666667,3,0,0,0,0
"CARIBBEAN",4,1,.8,.2,5,1,0,0,0
"CARITO",0,3,0,1,3,0,1,0,1
"CARLOTA",0,4,0,1,4,0,1,0,1
"CARMENCITA",0,6,0,1,6,0,1,0,1
"CARMIN",1,2,.3333333,.6666667,3,0,0,0,0
"CARREN",1,3,.25,.75,4,0,0,0,0
"CASSEY",0,4,0,1,4,0,1,0,1
"CATHAL",5,0,1,0,5,1,0,1,0
"CATTY",0,2,0,1,2,0,1,0,1
"CAVIN",2,0,1,0,2,1,0,1,0
"CETIN",3,0,1,0,3,1,0,1,0
"CHADD",4,0,1,0,4,1,0,1,0
"CHANDRIKA",1,3,.25,.75,4,0,0,0,0
"CHANICE",0,6,0,1,6,0,1,0,1
"CHARLETTE",0,4,0,1,4,0,1,0,1
"CHARLI",1,1,.5,.5,2,0,0,0,0
"CHAYALA",0,4,0,1,4,0,1,0,1
"CHEIKH",4,0,1,0,4,1,0,1,0
"CHELY",0,5,0,1,5,0,1,0,1
"CHERYLL",0,3,0,1,3,0,1,0,1
"CHESLEY",3,0,1,0,3,1,0,1,0
"CHEVELLE",0,4,0,1,4,0,1,0,1
"CHICKIE",0,6,0,1,6,0,1,0,1
"CHIEN",3,2,.6,.4,5,0,0,0,0
"CHIKAKO",0,3,0,1,3,0,1,0,1
"CHISATO",0,5,0,1,5,0,1,0,1
"CHOWDHURY",4,0,1,0,4,1,0,1,0
"CHRISANN",0,4,0,1,4,0,1,0,1
"CHRISTYN",0,2,0,1,2,0,1,0,1
"CHUKWUMA",5,0,1,0,5,1,0,1,0
"CLAUDINA",0,6,0,1,6,0,1,0,1
"CLOÃ‹",0,4,0,1,4,0,1,0,1
"COACH",2,1,.6666667,.3333333,3,0,0,0,0
"COMPTON",5,0,1,0,5,1,0,1,0
"CONG",4,1,.8,.2,5,1,0,0,0
"CORAZON",0,5,0,1,5,0,1,0,1
"CORMAC",4,0,1,0,4,1,0,1,0
"COSMIN",4,0,1,0,4,1,0,1,0
"CRASH",3,1,.75,.25,4,0,0,0,0
"CREE",1,3,.25,.75,4,0,0,0,0
"CSABA",3,1,.75,.25,4,0,0,0,0
"CYNDY",0,2,0,1,2,0,1,0,1
"CYRILLE",3,0,1,0,3,1,0,1,0
"DALAL",0,3,0,1,3,0,1,0,1
"DALYA",0,4,0,1,4,0,1,0,1
"DAMARA",0,4,0,1,4,0,1,0,1
"DAMARY",0,5,0,1,5,0,1,0,1
"DAMEN",4,0,1,0,4,1,0,1,0
"DANG",4,1,.8,.2,5,1,0,0,0
"DANIELS",2,2,.5,.5,4,0,0,0,0
"DANIQUE",0,3,0,1,3,0,1,0,1
"DANKA",0,3,0,1,3,0,1,0,1
"DANO",4,0,1,0,4,1,0,1,0
"DARRAH",0,3,0,1,3,0,1,0,1
"DAVIA",0,2,0,1,2,0,1,0,1
"DAVIAN",4,1,.8,.2,5,1,0,0,0
"DAVINDER",1,1,.5,.5,2,0,0,0,0
"DAYSHA",0,5,0,1,5,0,1,0,1
"DECHEN",1,2,.3333333,.6666667,3,0,0,0,0
"DEJON",3,0,1,0,3,1,0,1,0
"DELFIN",3,0,1,0,3,1,0,1,0
"DELISA",0,3,0,1,3,0,1,0,1
"DELLON",3,0,1,0,3,1,0,1,0
"DEMAR",4,0,1,0,4,1,0,1,0
"DEMETRIO",4,0,1,0,4,1,0,1,0
"DENIECE",0,4,0,1,4,0,1,0,1
"DERIN",1,5,.1666667,.8333333,6,0,1,0,0
"DERRY",3,1,.75,.25,4,0,0,0,0
"DESHON",5,1,.8333333,.1666667,6,1,0,0,0
"DEVONTE",6,1,.8571429,.1428571,7,1,0,0,0
"DHIREN",6,0,1,0,6,1,0,1,0
"DICKIE",2,0,1,0,2,1,0,1,0
"DIETRICH",2,1,.6666667,.3333333,3,0,0,0,0
"DILAN",3,1,.75,.25,4,0,0,0,0
"DILARA",0,2,0,1,2,0,1,0,1
"DILIA",0,3,0,1,3,0,1,0,1
"DINORA",0,5,0,1,5,0,1,0,1
"DIPA",0,2,0,1,2,0,1,0,1
"DIYA",0,2,0,1,2,0,1,0,1
"DOE",3,2,.6,.4,5,0,0,0,0
"DOLCE",2,2,.5,.5,4,0,0,0,0
"DOLLAR",6,0,1,0,6,1,0,1,0
"DOMI",1,2,.3333333,.6666667,3,0,0,0,0
"DOMINICAN",2,3,.4,.6,5,0,0,0,0
"DONAVIN",6,0,1,0,6,1,0,1,0
"DORETTA",0,5,0,1,5,0,1,0,1
"DORIA",0,3,0,1,3,0,1,0,1
"DORIANNE",0,4,0,1,4,0,1,0,1
"DRAY",5,0,1,0,5,1,0,1,0
"DUJON",6,0,1,0,6,1,0,1,0
"DUN",4,0,1,0,4,1,0,1,0
"DUNG",3,1,.75,.25,4,0,0,0,0
"DUVAL",3,1,.75,.25,4,0,0,0,0
"DVIR",5,0,1,0,5,1,0,1,0
"DYMPHNA",0,3,0,1,3,0,1,0,1
"DYNASTY",0,3,0,1,3,0,1,0,1
"EAN",5,1,.8333333,.1666667,6,1,0,0,0
"EAST",2,0,1,0,2,1,0,1,0
"EDDA",0,4,0,1,4,0,1,0,1
"EDGE",7,0,1,0,7,1,0,1,0
"EDRIC",5,0,1,0,5,1,0,1,0
"EFI",3,0,1,0,3,1,0,1,0
"EFREM",4,0,1,0,4,1,0,1,0
"EGE",5,0,1,0,5,1,0,1,0
"EILENE",0,4,0,1,4,0,1,0,1
"EION",4,0,1,0,4,1,0,1,0
"EIRIK",2,0,1,0,2,1,0,1,0
"EJAZ",4,0,1,0,4,1,0,1,0
"EKREM",4,0,1,0,4,1,0,1,0
"ELEAZAR",3,0,1,0,3,1,0,1,0
"ELECTRA",0,4,0,1,4,0,1,0,1
"ELGIN",3,0,1,0,3,1,0,1,0
"ELIAN",2,1,.6666667,.3333333,3,0,0,0,0
"ELIHU",5,0,1,0,5,1,0,1,0
"ELMIRA",0,4,0,1,4,0,1,0,1
"ELROY",3,0,1,0,3,1,0,1,0
"ELVINA",0,2,0,1,2,0,1,0,1
"ELVIR",4,0,1,0,4,1,0,1,0
"ELYCE",0,4,0,1,4,0,1,0,1
"EMESE",0,3,0,1,3,0,1,0,1
"EMMITT",4,0,1,0,4,1,0,1,0
"EMON",3,1,.75,.25,4,0,0,0,0
"ENIKO",0,3,0,1,3,0,1,0,1
"ENILDA",0,5,0,1,5,0,1,0,1
"ENJOLI",0,7,0,1,7,0,1,0,1
"ENOS",4,0,1,0,4,1,0,1,0
"ERIDANIA",0,3,0,1,3,0,1,0,1
"ERROLL",2,0,1,0,2,1,0,1,0
"ES",2,0,1,0,2,1,0,1,0
"ESAU",3,0,1,0,3,1,0,1,0
"ESLAM",4,1,.8,.2,5,1,0,0,0
"ESMA",0,5,0,1,5,0,1,0,1
"ESOSA",3,1,.75,.25,4,0,0,0,0
"ETTIE",0,3,0,1,3,0,1,0,1
"EUNA",0,4,0,1,4,0,1,0,1
"EUNHYE",0,6,0,1,6,0,1,0,1
"EUNJOO",0,5,0,1,5,0,1,0,1
"EUSTACE",4,0,1,0,4,1,0,1,0
"EVANGELIST",3,4,.4285714,.5714286,7,0,0,0,0
"EXTRA",4,2,.6666667,.3333333,6,0,0,0,0
"EZGI",0,3,0,1,3,0,1,0,1
"FADIA",0,4,0,1,4,0,1,0,1
"FANTASIA",0,2,0,1,2,0,1,0,1
"FANY",0,5,0,1,5,0,1,0,1
"FARIBA",0,2,0,1,2,0,1,0,1
"FARJANA",0,3,0,1,3,0,1,0,1
"FARRELL",4,1,.8,.2,5,1,0,0,0
"FAWAD",3,0,1,0,3,1,0,1,0
"FAYTH",0,2,0,1,2,0,1,0,1
"FAZAL",6,0,1,0,6,1,0,1,0
"FELI",1,1,.5,.5,2,0,0,0,0
"FELISE",0,6,0,1,6,0,1,0,1
"FERGUS",5,0,1,0,5,1,0,1,0
"FIA",0,6,0,1,6,0,1,0,1
"FIL",3,0,1,0,3,1,0,1,0
"FILIPPA",0,3,0,1,3,0,1,0,1
"FIRAS",3,0,1,0,3,1,0,1,0
"FLAMUR",2,0,1,0,2,1,0,1,0
"FLASH",4,2,.6666667,.3333333,6,0,0,0,0
"FLAT",5,2,.7142857,.2857143,7,0,0,0,0
"FLORITA",0,4,0,1,4,0,1,0,1
"FOLA",1,1,.5,.5,2,0,0,0,0
"FOUZIA",0,3,0,1,3,0,1,0,1
"FREDI",2,1,.6666667,.3333333,3,0,0,0,0
"FROILAN",4,0,1,0,4,1,0,1,0
"GANNON",2,1,.6666667,.3333333,3,0,0,0,0
"GASPAR",6,0,1,0,6,1,0,1,0
"GAURANG",4,0,1,0,4,1,0,1,0
"GENELLE",0,5,0,1,5,0,1,0,1
"GENTI",5,0,1,0,5,1,0,1,0
"GENTIAN",3,0,1,0,3,1,0,1,0
"GEORGEANN",0,4,0,1,4,0,1,0,1
"GEOVANY",5,0,1,0,5,1,0,1,0
"GER",5,1,.8333333,.1666667,6,1,0,0,0
"GEROME",7,0,1,0,7,1,0,1,0
"GHAZI",4,0,1,0,4,1,0,1,0
"GIFT",1,2,.3333333,.6666667,3,0,0,0,0
"GILIAN",0,4,0,1,4,0,1,0,1
"GINELLE",0,2,0,1,2,0,1,0,1
"GINNETTE",0,2,0,1,2,0,1,0,1
"GIORGI",3,0,1,0,3,1,0,1,0
"GIORGOS",5,0,1,0,5,1,0,1,0
"GLASS",2,2,.5,.5,4,0,0,0,0
"GLENDALY",0,3,0,1,3,0,1,0,1
"GLENROY",6,0,1,0,6,1,0,1,0
"GLORI",0,5,0,1,5,0,1,0,1
"GMAN",4,0,1,0,4,1,0,1,0
"GONG",3,2,.6,.4,5,0,0,0,0
"GORDANA",0,6,0,1,6,0,1,0,1
"GOSHA",3,0,1,0,3,1,0,1,0
"GRACEANNE",0,6,0,1,6,0,1,0,1
"GRICEL",0,6,0,1,6,0,1,0,1
"GRIFFITH",2,1,.6666667,.3333333,3,0,0,0,0
"GRIGORY",3,0,1,0,3,1,0,1,0
"GRISSEL",0,4,0,1,4,0,1,0,1
"GRUPO",2,0,1,0,2,1,0,1,0
"GUANG",5,0,1,0,5,1,0,1,0
"GUERDA",0,7,0,1,7,0,1,0,1
"GUISEPPE",5,0,1,0,5,1,0,1,0
"GULCIN",0,2,0,1,2,0,1,0,1
"GUNTHER",5,0,1,0,5,1,0,1,0
"GUZMAN",2,2,.5,.5,4,0,0,0,0
"GWYNN",0,2,0,1,2,0,1,0,1
"GÃ–RKEM",5,0,1,0,5,1,0,1,0
"GÃœLAY",0,3,0,1,3,0,1,0,1
"HAIG",4,0,1,0,4,1,0,1,0
"HAIR",1,3,.25,.75,4,0,0,0,0
"HALF",2,1,.6666667,.3333333,3,0,0,0,0
"HAMPTON",5,0,1,0,5,1,0,1,0
"HANNES",2,0,1,0,2,1,0,1,0
"HARSHAD",3,0,1,0,3,1,0,1,0
"HART",3,1,.75,.25,4,0,0,0,0
"HASINA",0,5,0,1,5,0,1,0,1
"HAU",3,1,.75,.25,4,0,0,0,0
"HAYNES",2,1,.6666667,.3333333,3,0,0,0,0
"HEMALI",0,3,0,1,3,0,1,0,1
"HENDERSON",3,0,1,0,3,1,0,1,0
"HENRIETTE",0,2,0,1,2,0,1,0,1
"HERMINE",0,3,0,1,3,0,1,0,1
"HILARIE",0,2,0,1,2,0,1,0,1
"HIN",6,0,1,0,6,1,0,1,0
"HIND",0,3,0,1,3,0,1,0,1
"HOLLYWOOD",5,0,1,0,5,1,0,1,0
"HOOMAN",3,0,1,0,3,1,0,1,0
"HOON",4,2,.6666667,.3333333,6,0,0,0,0
"HORATIO",5,0,1,0,5,1,0,1,0
"HORST",5,0,1,0,5,1,0,1,0
"HWANG",4,0,1,0,4,1,0,1,0
"HYMIE",7,0,1,0,7,1,0,1,0
"HYOJIN",0,5,0,1,5,0,1,0,1
"HYUNJUNG",0,2,0,1,2,0,1,0,1
"IFEANYI",4,0,1,0,4,1,0,1,0
"INDERJIT",2,1,.6666667,.3333333,3,0,0,0,0
"INDU",0,5,0,1,5,0,1,0,1
"INTI",1,1,.5,.5,2,0,0,0,0
"IONE",0,3,0,1,3,0,1,0,1
"IRAKLI",4,0,1,0,4,1,0,1,0
"IRINI",0,2,0,1,2,0,1,0,1
"IRON",4,1,.8,.2,5,1,0,0,0
"ISABELL",0,2,0,1,2,0,1,0,1
"ISAI",3,0,1,0,3,1,0,1,0
"ISATU",0,4,0,1,4,0,1,0,1
"ISSAM",2,0,1,0,2,1,0,1,0
"ITZEL",0,3,0,1,3,0,1,0,1
"ITZHAK",4,0,1,0,4,1,0,1,0
"IVANIA",0,4,0,1,4,0,1,0,1
"IVEY",0,2,0,1,2,0,1,0,1
"JACLYNN",0,3,0,1,3,0,1,0,1
"JACOBO",3,1,.75,.25,4,0,0,0,0
"JACQULYN",0,4,0,1,4,0,1,0,1
"JAGDEEP",4,0,1,0,4,1,0,1,0
"JAHAYRA",0,5,0,1,5,0,1,0,1
"JAHMAR",4,0,1,0,4,1,0,1,0
"JAIDA",0,3,0,1,3,0,1,0,1
"JAIDEEP",2,0,1,0,2,1,0,1,0
"JAKI",1,3,.25,.75,4,0,0,0,0
"JAMALL",4,0,1,0,4,1,0,1,0
"JAMIELEE",0,5,0,1,5,0,1,0,1
"JANAK",4,0,1,0,4,1,0,1,0
"JANKI",0,2,0,1,2,0,1,0,1
"JANNATUL",0,2,0,1,2,0,1,0,1
"JANNETH",0,3,0,1,3,0,1,0,1
"JANUS",3,1,.75,.25,4,0,0,0,0
"JANY",0,7,0,1,7,0,1,0,1
"JAREN",3,1,.75,.25,4,0,0,0,0
"JARREL",2,0,1,0,2,1,0,1,0
"JARRELL",4,0,1,0,4,1,0,1,0
"JASMYNE",0,3,0,1,3,0,1,0,1
"JAYCEE",3,2,.6,.4,5,0,0,0,0
"JAYMES",4,1,.8,.2,5,1,0,0,0
"JAYQUAN",6,0,1,0,6,1,0,1,0
"JEAN-CHRISTOPHE",4,0,1,0,4,1,0,1,0
"JEAN-PHILIPPE",4,0,1,0,4,1,0,1,0
"JEFERSON",5,0,1,0,5,1,0,1,0
"JEFFY",6,0,1,0,6,1,0,1,0
"JELISA",0,2,0,1,2,0,1,0,1
"JENAI",1,2,.3333333,.6666667,3,0,0,0,0
"JENAY",0,5,0,1,5,0,1,0,1
"JENCY",0,4,0,1,4,0,1,0,1
"JENDAYI",0,4,0,1,4,0,1,0,1
"JERARD",7,0,1,0,7,1,0,1,0
"JEREMI",5,0,1,0,5,1,0,1,0
"JERICO",5,0,1,0,5,1,0,1,0
"JERIN",4,1,.8,.2,5,1,0,0,0
"JEROD",2,0,1,0,2,1,0,1,0
"JEROEN",4,0,1,0,4,1,0,1,0
"JERONIMO",4,0,1,0,4,1,0,1,0
"JERRICA",0,3,0,1,3,0,1,0,1
"JETT",4,0,1,0,4,1,0,1,0
"JEY",4,2,.6666667,.3333333,6,0,0,0,0
"JHOANA",0,2,0,1,2,0,1,0,1
"JHOANNA",0,5,0,1,5,0,1,0,1
"JIBIN",4,0,1,0,4,1,0,1,0
"JIGME",3,1,.75,.25,4,0,0,0,0
"JIJI",0,3,0,1,3,0,1,0,1
"JIL",0,4,0,1,4,0,1,0,1
"JINAH",0,5,0,1,5,0,1,0,1
"JINU",1,1,.5,.5,2,0,0,0,0
"JINX",1,3,.25,.75,4,0,0,0,0
"JISUN",0,5,0,1,5,0,1,0,1
"JIYOON",0,5,0,1,5,0,1,0,1
"JIYUN",0,3,0,1,3,0,1,0,1
"JODIANN",0,4,0,1,4,0,1,0,1
"JOELL",2,3,.4,.6,5,0,0,0,0
"JOESPH",3,0,1,0,3,1,0,1,0
"JOHANNAH",0,2,0,1,2,0,1,0,1
"JOHNA",1,3,.25,.75,4,0,0,0,0
"JOLIN",0,5,0,1,5,0,1,0,1
"JORDANNA",0,3,0,1,3,0,1,0,1
"JORI",0,2,0,1,2,0,1,0,1
"JOSANNE",0,5,0,1,5,0,1,0,1
"JOSELINE",0,4,0,1,4,0,1,0,1
"JOSIAS",5,1,.8333333,.1666667,6,1,0,0,0
"JOVEN",5,0,1,0,5,1,0,1,0
"JOVY",1,2,.3333333,.6666667,3,0,0,0,0
"JUBIN",3,1,.75,.25,4,0,0,0,0
"JUEL",2,2,.5,.5,4,0,0,0,0
"JULENE",0,6,0,1,6,0,1,0,1
"JULZ",1,3,.25,.75,4,0,0,0,0
"JUNI",2,2,.5,.5,4,0,0,0,0
"JUNJI",3,0,1,0,3,1,0,1,0
"JUS",3,1,.75,.25,4,0,0,0,0
"JUTTA",0,4,0,1,4,0,1,0,1
"JUYOUNG",0,4,0,1,4,0,1,0,1
"JW",2,0,1,0,2,1,0,1,0
"KADRI",4,0,1,0,4,1,0,1,0
"KAILIN",0,3,0,1,3,0,1,0,1
"KAILYN",0,5,0,1,5,0,1,0,1
"KALEIGH",0,3,0,1,3,0,1,0,1
"KALEY",0,2,0,1,2,0,1,0,1
"KAMEN",6,0,1,0,6,1,0,1,0
"KARENE",0,4,0,1,4,0,1,0,1
"KARLEEN",0,2,0,1,2,0,1,0,1
"KARRI",0,4,0,1,4,0,1,0,1
"KARRIEM",5,0,1,0,5,1,0,1,0
"KARUNA",0,5,0,1,5,0,1,0,1
"KAS",3,1,.75,.25,4,0,0,0,0
"KATINKA",0,4,0,1,4,0,1,0,1
"KATRENA",0,5,0,1,5,0,1,0,1
"KATT",0,3,0,1,3,0,1,0,1
"KAVEH",4,0,1,0,4,1,0,1,0
"KAYVON",3,0,1,0,3,1,0,1,0
"KEA",0,2,0,1,2,0,1,0,1
"KEAN",2,0,1,0,2,1,0,1,0
"KEANA",0,3,0,1,3,0,1,0,1
"KEISUKE",5,0,1,0,5,1,0,1,0
"KELISHA",0,5,0,1,5,0,1,0,1
"KELLE",0,4,0,1,4,0,1,0,1
"KELSY",0,3,0,1,3,0,1,0,1
"KENESHIA",0,3,0,1,3,0,1,0,1
"KENI",4,0,1,0,4,1,0,1,0
"KENNEY",5,0,1,0,5,1,0,1,0
"KENNIS",2,1,.6666667,.3333333,3,0,0,0,0
"KENSON",5,0,1,0,5,1,0,1,0
"KENZA",0,3,0,1,3,0,1,0,1
"KERI-ANN",0,4,0,1,4,0,1,0,1
"KEVAUGHN",4,0,1,0,4,1,0,1,0
"KHALEEL",6,0,1,0,6,1,0,1,0
"KHALIDA",0,5,0,1,5,0,1,0,1
"KHALIFA",4,2,.6666667,.3333333,6,0,0,0,0
"KHUSHBU",0,2,0,1,2,0,1,0,1
"KIANNA",0,5,0,1,5,0,1,0,1
"KIEREN",1,2,.3333333,.6666667,3,0,0,0,0
"KIERRA",0,7,0,1,7,0,1,0,1
"KILLA",3,0,1,0,3,1,0,1,0
"KIMORA",1,2,.3333333,.6666667,3,0,0,0,0
"KINJAL",0,2,0,1,2,0,1,0,1
"KINO",3,0,1,0,3,1,0,1,0
"KINSEY",2,2,.5,.5,4,0,0,0,0
"KITT",1,3,.25,.75,4,0,0,0,0
"KIYOSHI",4,1,.8,.2,5,1,0,0,0
"KLEIN",3,0,1,0,3,1,0,1,0
"KOBIE",3,0,1,0,3,1,0,1,0
"KOICHI",4,0,1,0,4,1,0,1,0
"KOKI",3,1,.75,.25,4,0,0,0,0
"KORA",0,3,0,1,3,0,1,0,1
"KORIE",3,1,.75,.25,4,0,0,0,0
"KOSUKE",7,0,1,0,7,1,0,1,0
"KOTARO",6,0,1,0,6,1,0,1,0
"KRISHAN",4,0,1,0,4,1,0,1,0
"KRISS",2,3,.4,.6,5,0,0,0,0
"KRISSA",0,3,0,1,3,0,1,0,1
"KRISTOF",6,0,1,0,6,1,0,1,0
"KUBILAY",5,1,.8333333,.1666667,6,1,0,0,0
"KUI",2,1,.6666667,.3333333,3,0,0,0,0
"KUNI",1,4,.2,.8,5,0,1,0,0
"KYNDRA",0,2,0,1,2,0,1,0,1
"LACIE",0,2,0,1,2,0,1,0,1
"LAIRD",3,0,1,0,3,1,0,1,0
"LAKE",2,1,.6666667,.3333333,3,0,0,0,0
"LAMISHA",0,4,0,1,4,0,1,0,1
"LARIZA",0,6,0,1,6,0,1,0,1
"LASHAY",0,4,0,1,4,0,1,0,1
"LAST",1,2,.3333333,.6666667,3,0,0,0,0
"LATEESHA",0,4,0,1,4,0,1,0,1
"LAUREE",0,5,0,1,5,0,1,0,1
"LAURENE",0,2,0,1,2,0,1,0,1
"LAURITA",0,2,0,1,2,0,1,0,1
"LAVELL",3,0,1,0,3,1,0,1,0
"LAWSON",3,0,1,0,3,1,0,1,0
"LAZ",3,0,1,0,3,1,0,1,0
"LEAR",0,2,0,1,2,0,1,0,1
"LECIA",0,2,0,1,2,0,1,0,1
"LEFTERIS",4,0,1,0,4,1,0,1,0
"LEIGHANNE",0,6,0,1,6,0,1,0,1
"LEJLA",0,4,0,1,4,0,1,0,1
"LENOX",4,1,.8,.2,5,1,0,0,0
"LENY",0,2,0,1,2,0,1,0,1
"LEONE",0,4,0,1,4,0,1,0,1
"LESLEE",0,5,0,1,5,0,1,0,1
"LEUNG",1,1,.5,.5,2,0,0,0,0
"LEYDA",0,2,0,1,2,0,1,0,1
"LIBBIE",0,2,0,1,2,0,1,0,1
"LIE",1,2,.3333333,.6666667,3,0,0,0,0
"LIESEL",0,2,0,1,2,0,1,0,1
"LINLIN",0,4,0,1,4,0,1,0,1
"LIO",3,2,.6,.4,5,0,0,0,0
"LIPA",4,0,1,0,4,1,0,1,0
"LISSIE",0,2,0,1,2,0,1,0,1
"LIZZA",0,3,0,1,3,0,1,0,1
"LLEWELLYN",3,0,1,0,3,1,0,1,0
"LOAN",0,2,0,1,2,0,1,0,1
"LOLI",0,4,0,1,4,0,1,0,1
"LORIS",4,3,.5714286,.4285714,7,0,0,0,0
"LOSO",4,0,1,0,4,1,0,1,0
"LOVETTE",0,4,0,1,4,0,1,0,1
"LOW",3,1,.75,.25,4,0,0,0,0
"LUCREZIA",0,4,0,1,4,0,1,0,1
"LUMI",1,4,.2,.8,5,0,1,0,0
"LYMARI",0,3,0,1,3,0,1,0,1
"LYON",3,0,1,0,3,1,0,1,0
"LYRA",0,4,0,1,4,0,1,0,1
"MACKIE",2,1,.6666667,.3333333,3,0,0,0,0
"MADALINE",0,4,0,1,4,0,1,0,1
"MAG",2,1,.6666667,.3333333,3,0,0,0,0
"MAHBUBUR",4,0,1,0,4,1,0,1,0
"MAHSHID",0,2,0,1,2,0,1,0,1
"MAHWISH",0,3,0,1,3,0,1,0,1
"MALCOM",4,0,1,0,4,1,0,1,0
"MAME",1,3,.25,.75,4,0,0,0,0
"MANMEET",2,2,.5,.5,4,0,0,0,0
"MANN",5,0,1,0,5,1,0,1,0
"MANNIE",3,1,.75,.25,4,0,0,0,0
"MANO",2,0,1,0,2,1,0,1,0
"MANOLIS",4,0,1,0,4,1,0,1,0
"MANOUCHKA",0,4,0,1,4,0,1,0,1
"MARCK",5,0,1,0,5,1,0,1,0
"MARG",1,4,.2,.8,5,0,1,0,0
"MARIALISA",0,2,0,1,2,0,1,0,1
"MARIE-CLAIRE",0,3,0,1,3,0,1,0,1
"MARILEE",0,6,0,1,6,0,1,0,1
"MARISE",0,3,0,1,3,0,1,0,1
"MARITES",0,4,0,1,4,0,1,0,1
"MARIZA",0,4,0,1,4,0,1,0,1
"MARJ",0,5,0,1,5,0,1,0,1
"MARLIE",0,4,0,1,4,0,1,0,1
"MARY-JO",0,3,0,1,3,0,1,0,1
"MARYLEE",0,5,0,1,5,0,1,0,1
"MARYSIA",0,3,0,1,3,0,1,0,1
"MARZIA",0,4,0,1,4,0,1,0,1
"MASAMI",2,2,.5,.5,4,0,0,0,0
"MASAYO",0,2,0,1,2,0,1,0,1
"MATHEUS",3,0,1,0,3,1,0,1,0
"MAULIK",4,0,1,0,4,1,0,1,0
"MAURICIA",0,3,0,1,3,0,1,0,1
"MAXIMUM",5,0,1,0,5,1,0,1,0
"MAYNOR",5,0,1,0,5,1,0,1,0
"MAYOWA",4,0,1,0,4,1,0,1,0
"MAYYA",0,4,0,1,4,0,1,0,1
"MAZ",4,1,.8,.2,5,1,0,0,0
"MCKINLEY",4,0,1,0,4,1,0,1,0
"MEA",2,2,.5,.5,4,0,0,0,0
"MEDHAT",3,0,1,0,3,1,0,1,0
"MEGGY",0,5,0,1,5,0,1,0,1
"MEHRDAD",3,0,1,0,3,1,0,1,0
"MELEK",1,2,.3333333,.6666667,3,0,0,0,0
"MELENA",0,3,0,1,3,0,1,0,1
"MELIKA",0,5,0,1,5,0,1,0,1
"MENTOR",4,0,1,0,4,1,0,1,0
"MERARI",2,3,.4,.6,5,0,0,0,0
"MERCER",2,0,1,0,2,1,0,1,0
"MERVYN",6,0,1,0,6,1,0,1,0
"MIATTA",0,5,0,1,5,0,1,0,1
"MICHIE",0,4,0,1,4,0,1,0,1
"MICKEL",7,0,1,0,7,1,0,1,0
"MICOL",0,2,0,1,2,0,1,0,1
"MIE",0,4,0,1,4,0,1,0,1
"MIKHAEL",3,2,.6,.4,5,0,0,0,0
"MIKIKO",0,3,0,1,3,0,1,0,1
"MILAD",2,0,1,0,2,1,0,1,0
"MILT",4,0,1,0,4,1,0,1,0
"MINDA",0,2,0,1,2,0,1,0,1
"MINK",2,2,.5,.5,4,0,0,0,0
"MINT",0,4,0,1,4,0,1,0,1
"MINWOO",4,1,.8,.2,5,1,0,0,0
"MISHELLE",0,2,0,1,2,0,1,0,1
"MISHKA",2,3,.4,.6,5,0,0,0,0
"MISUN",0,3,0,1,3,0,1,0,1
"MISZ",0,3,0,1,3,0,1,0,1
"MIWA",0,3,0,1,3,0,1,0,1
"MIYAKO",0,3,0,1,3,0,1,0,1
"MODOU",4,0,1,0,4,1,0,1,0
"MOH",3,1,.75,.25,4,0,0,0,0
"MOJGAN",0,3,0,1,3,0,1,0,1
"MONY",4,1,.8,.2,5,1,0,0,0
"MOORE",3,0,1,0,3,1,0,1,0
"MORA",0,3,0,1,3,0,1,0,1
"MORAIMA",0,5,0,1,5,0,1,0,1
"MORENO",6,0,1,0,6,1,0,1,0
"MORY",3,0,1,0,3,1,0,1,0
"MOSS",2,1,.6666667,.3333333,3,0,0,0,0
"MOTTI",4,0,1,0,4,1,0,1,0
"MUGE",0,2,0,1,2,0,1,0,1
"MURALI",5,0,1,0,5,1,0,1,0
"MYCHELLE",0,5,0,1,5,0,1,0,1
"MYKEL",4,1,.8,.2,5,1,0,0,0
"MYRTA",0,4,0,1,4,0,1,0,1
"MYSTIC",2,3,.4,.6,5,0,0,0,0
"NADINA",0,2,0,1,2,0,1,0,1
"NAFEESA",0,4,0,1,4,0,1,0,1
"NAMIKO",0,2,0,1,2,0,1,0,1
"NANCEE",0,3,0,1,3,0,1,0,1
"NANDY",1,1,.5,.5,2,0,0,0,0
"NAOMY",0,6,0,1,6,0,1,0,1
"NAOR",3,0,1,0,3,1,0,1,0
"NASEEM",1,6,.1428571,.8571429,7,0,1,0,0
"NASHAWN",4,1,.8,.2,5,1,0,0,0
"NASIA",0,3,0,1,3,0,1,0,1
"NASTASSJA",0,3,0,1,3,0,1,0,1
"NATO",3,2,.6,.4,5,0,0,0,0
"NAVITA",0,5,0,1,5,0,1,0,1
"NAWAL",0,4,0,1,4,0,1,0,1
"NAWAZ",3,0,1,0,3,1,0,1,0
"NAYAN",4,0,1,0,4,1,0,1,0
"NAZARETH",3,3,.5,.5,6,0,0,0,0
"NAZMA",0,2,0,1,2,0,1,0,1
"NAZRUL",4,0,1,0,4,1,0,1,0
"NEELIMA",0,3,0,1,3,0,1,0,1
"NEFERTARI",0,5,0,1,5,0,1,0,1
"NEKIA",1,6,.1428571,.8571429,7,0,1,0,0
"NELIA",0,4,0,1,4,0,1,0,1
"NELSI",1,5,.1666667,.8333333,6,0,1,0,0
"NEMANJA",5,0,1,0,5,1,0,1,0
"NEREYDA",0,5,0,1,5,0,1,0,1
"NERLANDE",0,5,0,1,5,0,1,0,1
"NESRIN",0,4,0,1,4,0,1,0,1
"NESTA",3,0,1,0,3,1,0,1,0
"NETANEL",6,0,1,0,6,1,0,1,0
"NEWMAN",5,0,1,0,5,1,0,1,0
"NICAURY",0,3,0,1,3,0,1,0,1
"NIDAL",5,0,1,0,5,1,0,1,0
"NIKESHA",0,6,0,1,6,0,1,0,1
"NIKKY",1,4,.2,.8,5,0,1,0,0
"NIKOLETA",0,4,0,1,4,0,1,0,1
"NIKUNJ",2,0,1,0,2,1,0,1,0
"NILZA",0,3,0,1,3,0,1,0,1
"NIM",1,2,.3333333,.6666667,3,0,0,0,0
"NIMMI",0,2,0,1,2,0,1,0,1
"NINFA",0,6,0,1,6,0,1,0,1
"NIQUA",0,3,0,1,3,0,1,0,1
"NIRA",0,7,0,1,7,0,1,0,1
"NISAN",3,1,.75,.25,4,0,0,0,0
"NISHIT",6,0,1,0,6,1,0,1,0
"NISREEN",0,5,0,1,5,0,1,0,1
"NITASHA",0,2,0,1,2,0,1,0,1
"NITESH",4,0,1,0,4,1,0,1,0
"NITHYA",0,2,0,1,2,0,1,0,1
"NIVEA",0,4,0,1,4,0,1,0,1
"NIVEDITA",0,3,0,1,3,0,1,0,1
"NURYS",0,5,0,1,5,0,1,0,1
"OI",0,4,0,1,4,0,1,0,1
"OLAWALE",4,0,1,0,4,1,0,1,0
"OLINDA",0,5,0,1,5,0,1,0,1
"OLLY",4,1,.8,.2,5,1,0,0,0
"OLUWAFEMI",4,0,1,0,4,1,0,1,0
"OMAIR",5,0,1,0,5,1,0,1,0
"ORCHID",0,5,0,1,5,0,1,0,1
"OREST",3,0,1,0,3,1,0,1,0
"OSHRAT",0,4,0,1,4,0,1,0,1
"PAA",6,1,.8571429,.1428571,7,1,0,0,0
"PAPITO",6,0,1,0,6,1,0,1,0
"PARVIN",1,2,.3333333,.6666667,3,0,0,0,0
"PASANG",5,1,.8333333,.1666667,6,1,0,0,0
"PATI",0,3,0,1,3,0,1,0,1
"PATO",2,2,.5,.5,4,0,0,0,0
"PATT",2,5,.2857143,.7142857,7,0,0,0,0
"PAULE",0,5,0,1,5,0,1,0,1
"PAULI",2,0,1,0,2,1,0,1,0
"PEARLY",0,2,0,1,2,0,1,0,1
"PEDRAM",2,0,1,0,2,1,0,1,0
"PEGAH",0,2,0,1,2,0,1,0,1
"PENNI",0,3,0,1,3,0,1,0,1
"PERICLES",3,0,1,0,3,1,0,1,0
"PETERS",0,3,0,1,3,0,1,0,1
"PETRIT",4,0,1,0,4,1,0,1,0
"PETUNIA",1,5,.1666667,.8333333,6,0,1,0,0
"PHAN",2,2,.5,.5,4,0,0,0,0
"PHILLIPE",3,0,1,0,3,1,0,1,0
"PLAMEN",3,0,1,0,3,1,0,1,0
"POLA",0,3,0,1,3,0,1,0,1
"PRADA",3,0,1,0,3,1,0,1,0
"PRAMOD",4,0,1,0,4,1,0,1,0
"PRATAP",4,0,1,0,4,1,0,1,0
"PRESLEY",3,2,.6,.4,5,0,0,0,0
"PRITHA",0,4,0,1,4,0,1,0,1
"QAMAR",7,0,1,0,7,1,0,1,0
"QIU",3,4,.4285714,.5714286,7,0,0,0,0
"QUALITY",1,2,.3333333,.6666667,3,0,0,0,0
"QUYNH",1,5,.1666667,.8333333,6,0,1,0,0
"RACHELL",0,3,0,1,3,0,1,0,1
"RADHAMES",6,0,1,0,6,1,0,1,0
"RADO",5,0,1,0,5,1,0,1,0
"RAEANN",0,4,0,1,4,0,1,0,1
"RAFFAELA",0,6,0,1,6,0,1,0,1
"RAFIK",2,0,1,0,2,1,0,1,0
"RAISSA",0,3,0,1,3,0,1,0,1
"RAKEEM",4,0,1,0,4,1,0,1,0
"RAMIE",2,2,.5,.5,4,0,0,0,0
"RAMIL",4,0,1,0,4,1,0,1,0
"RAMONITA",0,5,0,1,5,0,1,0,1
"RANY",5,1,.8333333,.1666667,6,1,0,0,0
"RAOUF",5,0,1,0,5,1,0,1,0
"RAPH",2,0,1,0,2,1,0,1,0
"RASHAN",4,0,1,0,4,1,0,1,0
"RATNA",0,5,0,1,5,0,1,0,1
"RAZIA",0,2,0,1,2,0,1,0,1
"RECEP",3,0,1,0,3,1,0,1,0
"REESA",0,2,0,1,2,0,1,0,1
"REHAM",0,4,0,1,4,0,1,0,1
"REYNARD",5,0,1,0,5,1,0,1,0
"RICHARDO",4,0,1,0,4,1,0,1,0
"RIMI",0,5,0,1,5,0,1,0,1
"RISH",3,1,.75,.25,4,0,0,0,0
"RISSA",0,5,0,1,5,0,1,0,1
"RIZZA",0,5,0,1,5,0,1,0,1
"ROBINA",0,3,0,1,3,0,1,0,1
"ROCHIE",0,2,0,1,2,0,1,0,1
"ROCKAWAY",3,0,1,0,3,1,0,1,0
"ROCKO",5,1,.8333333,.1666667,6,1,0,0,0
"RONKE",0,3,0,1,3,0,1,0,1
"ROSENDO",6,0,1,0,6,1,0,1,0
"ROSMERY",0,5,0,1,5,0,1,0,1
"RUBA",0,2,0,1,2,0,1,0,1
"RUBEL",5,0,1,0,5,1,0,1,0
"RUBIE",0,4,0,1,4,0,1,0,1
"RUKIYA",0,3,0,1,3,0,1,0,1
"RUPI",1,5,.1666667,.8333333,6,0,1,0,0
"RYNE",3,0,1,0,3,1,0,1,0
"RYON",3,0,1,0,3,1,0,1,0
"SABINO",5,0,1,0,5,1,0,1,0
"SABLE",0,3,0,1,3,0,1,0,1
"SACHEEN",0,2,0,1,2,0,1,0,1
"SADIK",6,0,1,0,6,1,0,1,0
"SADIQ",4,0,1,0,4,1,0,1,0
"SAFWAN",3,0,1,0,3,1,0,1,0
"SAGINE",0,4,0,1,4,0,1,0,1
"SAGRARIO",0,6,0,1,6,0,1,0,1
"SAHIN",2,1,.6666667,.3333333,3,0,0,0,0
"SAJAL",5,1,.8333333,.1666667,6,1,0,0,0
"SAKEENA",0,4,0,1,4,0,1,0,1
"SALEEMA",0,4,0,1,4,0,1,0,1
"SALONI",0,4,0,1,4,0,1,0,1
"SAMA",2,3,.4,.6,5,0,0,0,0
"SAMET",6,0,1,0,6,1,0,1,0
"SAMIT",7,0,1,0,7,1,0,1,0
"SAMONE",1,2,.3333333,.6666667,3,0,0,0,0
"SANGAY",1,2,.3333333,.6666667,3,0,0,0,0
"SANI",3,2,.6,.4,5,0,0,0,0
"SANNE",1,2,.3333333,.6666667,3,0,0,0,0
"SARAY",0,7,0,1,7,0,1,0,1
"SAROYA",0,2,0,1,2,0,1,0,1
"SASHKA",1,3,.25,.75,4,0,0,0,0
"SATHYA",1,3,.25,.75,4,0,0,0,0
"SAVVAS",6,0,1,0,6,1,0,1,0
"SEBRINA",0,5,0,1,5,0,1,0,1
"SEIJI",3,0,1,0,3,1,0,1,0
"SELMAN",5,0,1,0,5,1,0,1,0
"SEMONE",0,5,0,1,5,0,1,0,1
"SENDY",0,3,0,1,3,0,1,0,1
"SEREF",5,0,1,0,5,1,0,1,0
"SERHAN",5,0,1,0,5,1,0,1,0
"SEVERIN",2,0,1,0,2,1,0,1,0
"SHADAE",0,4,0,1,4,0,1,0,1
"SHADRACK",6,0,1,0,6,1,0,1,0
"SHAHARA",0,4,0,1,4,0,1,0,1
"SHAHBAZ",4,0,1,0,4,1,0,1,0
"SHAHRAM",3,0,1,0,3,1,0,1,0
"SHAKEEL",6,0,1,0,6,1,0,1,0
"SHAMIL",4,2,.6666667,.3333333,6,0,0,0,0
"SHAMMI",1,3,.25,.75,4,0,0,0,0
"SHAMUS",4,0,1,0,4,1,0,1,0
"SHANG",5,0,1,0,5,1,0,1,0
"SHANT",3,0,1,0,3,1,0,1,0
"SHANYA",0,4,0,1,4,0,1,0,1
"SHAQUANDA",0,4,0,1,4,0,1,0,1
"SHARATH",5,1,.8333333,.1666667,6,1,0,0,0
"SHARAY",0,6,0,1,6,0,1,0,1
"SHARAYA",0,4,0,1,4,0,1,0,1
"SHARAZ",5,0,1,0,5,1,0,1,0
"SHARNA",0,4,0,1,4,0,1,0,1
"SHAUNAK",3,0,1,0,3,1,0,1,0
"SHAUNTEL",0,4,0,1,4,0,1,0,1
"SHAWNDA",0,3,0,1,3,0,1,0,1
"SHAWNIE",0,3,0,1,3,0,1,0,1
"SHAZAD",5,0,1,0,5,1,0,1,0
"SHEHZAD",4,0,1,0,4,1,0,1,0
"SHEKHAR",5,0,1,0,5,1,0,1,0
"SHEMEKA",0,5,0,1,5,0,1,0,1
"SHENNY",0,3,0,1,3,0,1,0,1
"SHERARD",6,0,1,0,6,1,0,1,0
"SHERILL",0,5,0,1,5,0,1,0,1
"SHERLINE",0,5,0,1,5,0,1,0,1
"SHERRON",0,3,0,1,3,0,1,0,1
"SHERRYL",0,2,0,1,2,0,1,0,1
"SHIA",2,1,.6666667,.3333333,3,0,0,0,0
"SHIDA",0,2,0,1,2,0,1,0,1
"SHINEY",2,2,.5,.5,4,0,0,0,0
"SHLOIME",2,0,1,0,2,1,0,1,0
"SHLOIMY",4,0,1,0,4,1,0,1,0
"SHNEUR",3,0,1,0,3,1,0,1,0
"SHOMA",0,3,0,1,3,0,1,0,1
"SHONTE",0,2,0,1,2,0,1,0,1
"SHQIPE",0,4,0,1,4,0,1,0,1
"SHRADDHA",0,3,0,1,3,0,1,0,1
"SHREE",1,3,.25,.75,4,0,0,0,0
"SHULA",0,4,0,1,4,0,1,0,1
"SHULAMIT",0,2,0,1,2,0,1,0,1
"SIBI",2,1,.6666667,.3333333,3,0,0,0,0
"SIEW",2,3,.4,.6,5,0,0,0,0
"SILVESTER",5,0,1,0,5,1,0,1,0
"SIMIN",2,3,.4,.6,5,0,0,0,0
"SINDI",0,3,0,1,3,0,1,0,1
"SIRAJ",2,0,1,0,2,1,0,1,0
"SIRIUS",0,3,0,1,3,0,1,0,1
"SLAWOMIR",6,0,1,0,6,1,0,1,0
"SMART",1,1,.5,.5,2,0,0,0,0
"SNEZANA",0,2,0,1,2,0,1,0,1
"SOBEIDA",0,3,0,1,3,0,1,0,1
"SOHIL",2,0,1,0,2,1,0,1,0
"SOHRAB",5,0,1,0,5,1,0,1,0
"SOLO",4,0,1,0,4,1,0,1,0
"SONNIE",2,2,.5,.5,4,0,0,0,0
"SORIN",4,0,1,0,4,1,0,1,0
"SRDJAN",4,0,1,0,4,1,0,1,0
"STACEE",0,4,0,1,4,0,1,0,1
"STASH",5,1,.8333333,.1666667,6,1,0,0,0
"STAV",1,2,.3333333,.6666667,3,0,0,0,0
"STAY",5,1,.8333333,.1666667,6,1,0,0,0
"STRATOS",3,0,1,0,3,1,0,1,0
"SUADA",0,3,0,1,3,0,1,0,1
"SUELLEN",0,5,0,1,5,0,1,0,1
"SUET",1,1,.5,.5,2,0,0,0,0
"SUJAY",3,0,1,0,3,1,0,1,0
"SULEJMAN",6,0,1,0,6,1,0,1,0
"SULEMAN",1,1,.5,.5,2,0,0,0,0
"SUNNI",0,4,0,1,4,0,1,0,1
"SURABHI",0,4,0,1,4,0,1,0,1
"SUSU",0,5,0,1,5,0,1,0,1
"SVENJA",0,3,0,1,3,0,1,0,1
"SVITLANA",0,4,0,1,4,0,1,0,1
"SWAPNIL",6,0,1,0,6,1,0,1,0
"SWATHI",0,5,0,1,5,0,1,0,1
"SYDONIE",0,4,0,1,4,0,1,0,1
"SZYMON",5,0,1,0,5,1,0,1,0
"TAHMINA",0,3,0,1,3,0,1,0,1
"TAIA",0,3,0,1,3,0,1,0,1
"TAINO",5,0,1,0,5,1,0,1,0
"TALA",1,2,.3333333,.6666667,3,0,0,0,0
"TALIE",0,4,0,1,4,0,1,0,1
"TALLULAH",0,5,0,1,5,0,1,0,1
"TAMIRA",0,4,0,1,4,0,1,0,1
"TANIM",2,0,1,0,2,1,0,1,0
"TANIS",1,4,.2,.8,5,0,1,0,0
"TANIYA",0,3,0,1,3,0,1,0,1
"TANNAZ",0,2,0,1,2,0,1,0,1
"TANNY",1,2,.3333333,.6666667,3,0,0,0,0
"TANU",0,3,0,1,3,0,1,0,1
"TAQUAN",3,0,1,0,3,1,0,1,0
"TARIQUE",3,1,.75,.25,4,0,0,0,0
"TARON",3,0,1,0,3,1,0,1,0
"TASHEMA",0,4,0,1,4,0,1,0,1
"TASHIMA",0,4,0,1,4,0,1,0,1
"TASLIMA",0,3,0,1,3,0,1,0,1
"TASNIM",0,2,0,1,2,0,1,0,1
"TATY",0,3,0,1,3,0,1,0,1
"TAYANA",0,4,0,1,4,0,1,0,1
"TEEJAY",5,1,.8333333,.1666667,6,1,0,0,0
"TEESHA",0,2,0,1,2,0,1,0,1
"TEJA",0,3,0,1,3,0,1,0,1
"TEMPESTT",0,3,0,1,3,0,1,0,1
"TERRILL",3,0,1,0,3,1,0,1,0
"TES",0,2,0,1,2,0,1,0,1
"TESSY",0,3,0,1,3,0,1,0,1
"THANYA",0,4,0,1,4,0,1,0,1
"THIJS",2,0,1,0,2,1,0,1,0
"THURSTON",5,0,1,0,5,1,0,1,0
"TIFFINY",0,3,0,1,3,0,1,0,1
"TIFFY",0,3,0,1,3,0,1,0,1
"TIMM",1,1,.5,.5,2,0,0,0,0
"TINE",0,4,0,1,4,0,1,0,1
"TOMISLAV",2,0,1,0,2,1,0,1,0
"TONJA",0,5,0,1,5,0,1,0,1
"TORAL",0,4,0,1,4,0,1,0,1
"TOYE",3,2,.6,.4,5,0,0,0,0
"TRACYANN",0,5,0,1,5,0,1,0,1
"TRACY-ANN",0,5,0,1,5,0,1,0,1
"TRAM",1,3,.25,.75,4,0,0,0,0
"TRIS",5,1,.8333333,.1666667,6,1,0,0,0
"TUGCE",0,2,0,1,2,0,1,0,1
"TULAY",0,3,0,1,3,0,1,0,1
"TWANNA",0,6,0,1,6,0,1,0,1
"TWYLA",0,4,0,1,4,0,1,0,1
"TYASIA",0,5,0,1,5,0,1,0,1
"TYESHIA",0,3,0,1,3,0,1,0,1
"TYSHAUN",5,0,1,0,5,1,0,1,0
"TZIPORAH",0,5,0,1,5,0,1,0,1
"UMANG",2,0,1,0,2,1,0,1,0
"UN",5,0,1,0,5,1,0,1,0
"UPTOWN",3,1,.75,.25,4,0,0,0,0
"UZO",3,2,.6,.4,5,0,0,0,0
"UZOMA",4,0,1,0,4,1,0,1,0
"VANGIE",0,3,0,1,3,0,1,0,1
"VANINA",0,5,0,1,5,0,1,0,1
"VANNESA",0,3,0,1,3,0,1,0,1
"VASCO",4,0,1,0,4,1,0,1,0
"VASIL",3,0,1,0,3,1,0,1,0
"VASO",1,3,.25,.75,4,0,0,0,0
"VASSILI",4,0,1,0,4,1,0,1,0
"VAUGHAN",2,2,.5,.5,4,0,0,0,0
"VELDA",0,3,0,1,3,0,1,0,1
"VENERA",0,6,0,1,6,0,1,0,1
"VENETTA",0,5,0,1,5,0,1,0,1
"VERNITA",0,5,0,1,5,0,1,0,1
"VIDESH",5,0,1,0,5,1,0,1,0
"VIJAI",3,0,1,0,3,1,0,1,0
"VIKRANT",4,0,1,0,4,1,0,1,0
"VILAS",5,0,1,0,5,1,0,1,0
"VINETTE",1,5,.1666667,.8333333,6,0,1,0,0
"VIREN",3,0,1,0,3,1,0,1,0
"VIRNA",0,4,0,1,4,0,1,0,1
"VITALI",4,0,1,0,4,1,0,1,0
"WALDY",6,0,1,0,6,1,0,1,0
"WASIF",4,0,1,0,4,1,0,1,0
"WENJUN",3,2,.6,.4,5,0,0,0,0
"WESLY",4,0,1,0,4,1,0,1,0
"WILIAM",7,0,1,0,7,1,0,1,0
"WILLI",4,1,.8,.2,5,1,0,0,0
"WILMAR",5,0,1,0,5,1,0,1,0
"WOOD",3,1,.75,.25,4,0,0,0,0
"WOODS",0,2,0,1,2,0,1,0,1
"WOOJIN",2,1,.6666667,.3333333,3,0,0,0,0
"WYNNE",1,3,.25,.75,4,0,0,0,0
"YAA",0,3,0,1,3,0,1,0,1
"YACINE",3,1,.75,.25,4,0,0,0,0
"YANIL",0,4,0,1,4,0,1,0,1
"YANNIE",0,3,0,1,3,0,1,0,1
"YANYAN",0,3,0,1,3,0,1,0,1
"YAQUELIN",0,3,0,1,3,0,1,0,1
"YARDENA",0,4,0,1,4,0,1,0,1
"YAS",1,4,.2,.8,5,0,1,0,0
"YASER",4,0,1,0,4,1,0,1,0
"YENA",0,4,0,1,4,0,1,0,1
"YESHI",3,3,.5,.5,6,0,0,0,0
"YISEL",0,5,0,1,5,0,1,0,1
"YISHAI",4,0,1,0,4,1,0,1,0
"YLLI",6,0,1,0,6,1,0,1,0
"YOHANN",3,0,1,0,3,1,0,1,0
"YOONA",0,2,0,1,2,0,1,0,1
"YOSHIAKI",3,0,1,0,3,1,0,1,0
"YOSHIE",1,4,.2,.8,5,0,1,0,0
"YOUN",2,2,.5,.5,4,0,0,0,0
"YOVANNY",4,0,1,0,4,1,0,1,0
"YUFEI",2,3,.4,.6,5,0,0,0,0
"YUICHI",3,0,1,0,3,1,0,1,0
"YUK",2,0,1,0,2,1,0,1,0
"YUNI",0,6,0,1,6,0,1,0,1
"YUSIF",5,0,1,0,5,1,0,1,0
"ZAHARA",0,3,0,1,3,0,1,0,1
"ZAIM",4,0,1,0,4,1,0,1,0
"ZAKIYAH",0,2,0,1,2,0,1,0,1
"ZAP",6,0,1,0,6,1,0,1,0
"ZENON",3,0,1,0,3,1,0,1,0
"ZHU",4,1,.8,.2,5,1,0,0,0
"ZIPPORAH",0,3,0,1,3,0,1,0,1
"ZULEIMA",0,4,0,1,4,0,1,0,1
"Ã‡AÄ_ATAY",3,0,1,0,3,1,0,1,0
"AASIM",5,0,1,0,5,1,0,1,0
"ABDALLAH",3,0,1,0,3,1,0,1,0
"ABDULLA",6,0,1,0,6,1,0,1,0
"ABHIJEET",3,0,1,0,3,1,0,1,0
"ABIGALE",0,3,0,1,3,0,1,0,1
"ABOUBACAR",2,0,1,0,2,1,0,1,0
"ACID",3,0,1,0,3,1,0,1,0
"ACOSTA",1,1,.5,.5,2,0,0,0,0
"ADAEZE",0,2,0,1,2,0,1,0,1
"ADAH",0,4,0,1,4,0,1,0,1
"ADDI",2,1,.6666667,.3333333,3,0,0,0,0
"ADEYINKA",3,2,.6,.4,5,0,0,0,0
"ADIE",1,1,.5,.5,2,0,0,0,0
"ADISON",4,1,.8,.2,5,1,0,0,0
"ADOLPHUS",4,0,1,0,4,1,0,1,0
"ADON",3,0,1,0,3,1,0,1,0
"ADONAI",3,2,.6,.4,5,0,0,0,0
"ADRIAAN",3,0,1,0,3,1,0,1,0
"ADRIELLE",0,2,0,1,2,0,1,0,1
"ADVA",0,4,0,1,4,0,1,0,1
"AEISHA",0,3,0,1,3,0,1,0,1
"AHAD",2,0,1,0,2,1,0,1,0
"AHAMED",5,0,1,0,5,1,0,1,0
"AHRON",5,0,1,0,5,1,0,1,0
"AILI",0,2,0,1,2,0,1,0,1
"AILYN",0,5,0,1,5,0,1,0,1
"AIN",1,1,.5,.5,2,0,0,0,0
"AISH",2,1,.6666667,.3333333,3,0,0,0,0
"AISSATOU",0,2,0,1,2,0,1,0,1
"AIYANA",0,2,0,1,2,0,1,0,1
"AIYSHA",0,6,0,1,6,0,1,0,1
"AIZA",0,3,0,1,3,0,1,0,1
"AJMAL",3,0,1,0,3,1,0,1,0
"AKELA",0,3,0,1,3,0,1,0,1
"AKIF",2,0,1,0,2,1,0,1,0
"AKILA",0,5,0,1,5,0,1,0,1
"AKIO",1,1,.5,.5,2,0,0,0,0
"ALA",1,1,.5,.5,2,0,0,0,0
"ALAMGIR",4,0,1,0,4,1,0,1,0
"ALANNAH",0,5,0,1,5,0,1,0,1
"ALAYNE",0,2,0,1,2,0,1,0,1
"ALBERTINA",0,4,0,1,4,0,1,0,1
"ALBY",2,0,1,0,2,1,0,1,0
"ALDIN",3,0,1,0,3,1,0,1,0
"ALEKA",0,3,0,1,3,0,1,0,1
"ALESANDRA",0,2,0,1,2,0,1,0,1
"ALF",4,0,1,0,4,1,0,1,0
"ALFA",3,2,.6,.4,5,0,0,0,0
"ALFONSE",2,0,1,0,2,1,0,1,0
"ALIKA",1,3,.25,.75,4,0,0,0,0
"ALISTER",5,0,1,0,5,1,0,1,0
"ALTHIA",0,4,0,1,4,0,1,0,1
"ALVAREZ",2,1,.6666667,.3333333,3,0,0,0,0
"ALYN",1,2,.3333333,.6666667,3,0,0,0,0
"AMADU",4,0,1,0,4,1,0,1,0
"AMARILYS",0,3,0,1,3,0,1,0,1
"AMAURYS",5,0,1,0,5,1,0,1,0
"AME",0,3,0,1,3,0,1,0,1
"AMEENA",0,4,0,1,4,0,1,0,1
"AMITAI",5,0,1,0,5,1,0,1,0
"AMMY",0,5,0,1,5,0,1,0,1
"AMREEN",0,2,0,1,2,0,1,0,1
"ANAHI",0,4,0,1,4,0,1,0,1
"ANAMARIE",0,2,0,1,2,0,1,0,1
"ANCHAL",0,2,0,1,2,0,1,0,1
"ANCY",1,3,.25,.75,4,0,0,0,0
"ANDEL",4,0,1,0,4,1,0,1,0
"ANDELL",4,0,1,0,4,1,0,1,0
"ANDREIA",0,3,0,1,3,0,1,0,1
"ANGELIE",0,4,0,1,4,0,1,0,1
"ANGELITO",4,0,1,0,4,1,0,1,0
"ANGELOS",2,0,1,0,2,1,0,1,0
"ANGELYN",0,2,0,1,2,0,1,0,1
"ANICA",0,3,0,1,3,0,1,0,1
"ANJI",1,1,.5,.5,2,0,0,0,0
"ANNA-MARIA",0,2,0,1,2,0,1,0,1
"ANNA-MARIE",0,4,0,1,4,0,1,0,1
"ANNELI",0,5,0,1,5,0,1,0,1
"ANNELIES",0,2,0,1,2,0,1,0,1
"ANNETTA",0,3,0,1,3,0,1,0,1
"ANNICA",0,3,0,1,3,0,1,0,1
"ANOUSHKA",0,3,0,1,3,0,1,0,1
"ANTIONE",3,0,1,0,3,1,0,1,0
"ANUAR",4,0,1,0,4,1,0,1,0
"AP",3,1,.75,.25,4,0,0,0,0
"APOLLONIA",0,3,0,1,3,0,1,0,1
"APOSTOLOS",4,0,1,0,4,1,0,1,0
"ARACELYS",0,5,0,1,5,0,1,0,1
"ARAFAT",5,0,1,0,5,1,0,1,0
"ARCH",2,0,1,0,2,1,0,1,0
"ARCHIBALD",3,1,.75,.25,4,0,0,0,0
"ARELYS",0,4,0,1,4,0,1,0,1
"ARETI",0,3,0,1,3,0,1,0,1
"ARGELIS",3,1,.75,.25,4,0,0,0,0
"ARLENIS",0,5,0,1,5,0,1,0,1
"ARLINGTON",3,0,1,0,3,1,0,1,0
"ARMEND",4,0,1,0,4,1,0,1,0
"ARNON",4,0,1,0,4,1,0,1,0
"ARSHIA",0,3,0,1,3,0,1,0,1
"ASHLEA",0,2,0,1,2,0,1,0,1
"ASIYA",0,3,0,1,3,0,1,0,1
"ASLAN",2,0,1,0,2,1,0,1,0
"ASMAA",0,2,0,1,2,0,1,0,1
"ASMITA",0,4,0,1,4,0,1,0,1
"ASPASIA",0,5,0,1,5,0,1,0,1
"ASSAD",5,0,1,0,5,1,0,1,0
"ASSATA",0,3,0,1,3,0,1,0,1
"ATHAR",4,0,1,0,4,1,0,1,0
"ATINA",0,3,0,1,3,0,1,0,1
"ATLAS",4,0,1,0,4,1,0,1,0
"ATO",2,0,1,0,2,1,0,1,0
"ATOM",4,0,1,0,4,1,0,1,0
"AUBREE",0,3,0,1,3,0,1,0,1
"AUBYN",5,1,.8333333,.1666667,6,1,0,0,0
"AUDY",4,0,1,0,4,1,0,1,0
"AUGGIE",5,0,1,0,5,1,0,1,0
"AVEL",3,2,.6,.4,5,0,0,0,0
"AVISHAY",4,0,1,0,4,1,0,1,0
"AYAH",0,2,0,1,2,0,1,0,1
"AYANDA",1,2,.3333333,.6666667,3,0,0,0,0
"AYDAN",0,3,0,1,3,0,1,0,1
"AYOBAMI",4,0,1,0,4,1,0,1,0
"AZ",5,0,1,0,5,1,0,1,0
"AZALEA",0,3,0,1,3,0,1,0,1
"AZANIA",0,2,0,1,2,0,1,0,1
"AZRIEL",3,0,1,0,3,1,0,1,0
"BAHRAM",4,0,1,0,4,1,0,1,0
"BAMBOO",3,0,1,0,3,1,0,1,0
"BANG",4,2,.6666667,.3333333,6,0,0,0,0
"BARKLEY",2,3,.4,.6,5,0,0,0,0
"BARNABAS",3,0,1,0,3,1,0,1,0
"BASAR",2,0,1,0,2,1,0,1,0
"BASHAR",5,0,1,0,5,1,0,1,0
"BAZ",3,0,1,0,3,1,0,1,0
"BECK",3,2,.6,.4,5,0,0,0,0
"BEER",3,0,1,0,3,1,0,1,0
"BEHZAD",2,0,1,0,2,1,0,1,0
"BEIBEI",0,4,0,1,4,0,1,0,1
"BEL",0,3,0,1,3,0,1,0,1
"BELAL",3,0,1,0,3,1,0,1,0
"BELLO",5,0,1,0,5,1,0,1,0
"BER",3,0,1,0,3,1,0,1,0
"BERKELEY",2,0,1,0,2,1,0,1,0
"BERN",1,1,.5,.5,2,0,0,0,0
"BEULAH",0,4,0,1,4,0,1,0,1
"BHAWNA",0,2,0,1,2,0,1,0,1
"BIA",0,4,0,1,4,0,1,0,1
"BIMAL",3,1,.75,.25,4,0,0,0,0
"BINO",3,0,1,0,3,1,0,1,0
"BINOD",6,0,1,0,6,1,0,1,0
"BINTOU",0,2,0,1,2,0,1,0,1
"BIRD",3,1,.75,.25,4,0,0,0,0
"BIROL",5,0,1,0,5,1,0,1,0
"BISOLA",0,2,0,1,2,0,1,0,1
"BLANCO",4,2,.6666667,.3333333,6,0,0,0,0
"BOBY",4,1,.8,.2,5,1,0,0,0
"BOMI",0,2,0,1,2,0,1,0,1
"BONA",1,1,.5,.5,2,0,0,0,0
"BOOBOO",1,2,.3333333,.6666667,3,0,0,0,0
"BOOMER",1,1,.5,.5,2,0,0,0,0
"BRADD",4,0,1,0,4,1,0,1,0
"BRANDYN",5,0,1,0,5,1,0,1,0
"BRANISLAV",2,0,1,0,2,1,0,1,0
"BRENDY",0,2,0,1,2,0,1,0,1
"BRIDGE",2,1,.6666667,.3333333,3,0,0,0,0
"BRIJESH",5,0,1,0,5,1,0,1,0
"BRIN",0,2,0,1,2,0,1,0,1
"BRITA",0,3,0,1,3,0,1,0,1
"BROOKES",1,1,.5,.5,2,0,0,0,0
"BUNMI",2,1,.6666667,.3333333,3,0,0,0,0
"BUNNIE",0,5,0,1,5,0,1,0,1
"BUNTY",3,1,.75,.25,4,0,0,0,0
"BUSAYO",0,2,0,1,2,0,1,0,1
"BUTTA",1,3,.25,.75,4,0,0,0,0
"BYRD",4,0,1,0,4,1,0,1,0
"CADE",3,0,1,0,3,1,0,1,0
"CAGDAS",3,0,1,0,3,1,0,1,0
"CAIN",5,0,1,0,5,1,0,1,0
"CAKE",1,3,.25,.75,4,0,0,0,0
"CALEY",1,3,.25,.75,4,0,0,0,0
"CALINA",0,4,0,1,4,0,1,0,1
"CALIPH",5,0,1,0,5,1,0,1,0
"CALLAN",1,2,.3333333,.6666667,3,0,0,0,0
"CALLI",0,2,0,1,2,0,1,0,1
"CAMELLA",0,2,0,1,2,0,1,0,1
"CAMELLIA",0,4,0,1,4,0,1,0,1
"CAMILLO",3,0,1,0,3,1,0,1,0
"CAO",5,0,1,0,5,1,0,1,0
"CARLISA",0,5,0,1,5,0,1,0,1
"CARLITA",0,5,0,1,5,0,1,0,1
"CARLON",3,1,.75,.25,4,0,0,0,0
"CARR",1,2,.3333333,.6666667,3,0,0,0,0
"CARRI",0,3,0,1,3,0,1,0,1
"CARRON",0,5,0,1,5,0,1,0,1
"CASANOVA",4,0,1,0,4,1,0,1,0
"CASHMERE",1,3,.25,.75,4,0,0,0,0
"CASILDA",0,2,0,1,2,0,1,0,1
"CASIMIR",5,1,.8333333,.1666667,6,1,0,0,0
"CATH",0,4,0,1,4,0,1,0,1
"CATI",0,3,0,1,3,0,1,0,1
"CAYLA",0,2,0,1,2,0,1,0,1
"CCNY",3,0,1,0,3,1,0,1,0
"CEEJAY",1,2,.3333333,.6666667,3,0,0,0,0
"CELENE",0,4,0,1,4,0,1,0,1
"CELIN",1,4,.2,.8,5,0,1,0,0
"CENTRAL",3,0,1,0,3,1,0,1,0
"CERISE",0,4,0,1,4,0,1,0,1
"CEZAR",6,0,1,0,6,1,0,1,0
"CHACHI",0,2,0,1,2,0,1,0,1
"CHANIECE",0,4,0,1,4,0,1,0,1
"CHANIQUA",0,5,0,1,5,0,1,0,1
"CHARESE",0,5,0,1,5,0,1,0,1
"CHARINA",0,3,0,1,3,0,1,0,1
"CHARITA",0,4,0,1,4,0,1,0,1
"CHARITO",0,4,0,1,4,0,1,0,1
"CHARLOTTA",0,3,0,1,3,0,1,0,1
"CHARM",1,3,.25,.75,4,0,0,0,0
"CHARMAIN",0,3,0,1,3,0,1,0,1
"CHARNA",0,2,0,1,2,0,1,0,1
"CHARRISE",0,5,0,1,5,0,1,0,1
"CHAUNCY",5,0,1,0,5,1,0,1,0
"CHEICK",4,0,1,0,4,1,0,1,0
"CHELA",0,2,0,1,2,0,1,0,1
"CHEROKEE",1,2,.3333333,.6666667,3,0,0,0,0
"CHERRI",0,3,0,1,3,0,1,0,1
"CHIQUITA",0,3,0,1,3,0,1,0,1
"CHIYO",0,4,0,1,4,0,1,0,1
"CHOCO",1,2,.3333333,.6666667,3,0,0,0,0
"CHRISTABEL",0,6,0,1,6,0,1,0,1
"CHRISTIANO",3,0,1,0,3,1,0,1,0
"CHRISTON",4,0,1,0,4,1,0,1,0
"CHUK",2,1,.6666667,.3333333,3,0,0,0,0
"CHUKWUDI",2,0,1,0,2,1,0,1,0
"CHULO",5,0,1,0,5,1,0,1,0
"CHUMIE",0,3,0,1,3,0,1,0,1
"CHY",0,5,0,1,5,0,1,0,1
"CISSY",0,3,0,1,3,0,1,0,1
"CJAY",3,1,.75,.25,4,0,0,0,0
"CLEA",0,2,0,1,2,0,1,0,1
"COLEY",1,2,.3333333,.6666667,3,0,0,0,0
"COLIE",2,2,.5,.5,4,0,0,0,0
"COLMAN",2,0,1,0,2,1,0,1,0
"COMIC",1,2,.3333333,.6666667,3,0,0,0,0
"CONALL",3,0,1,0,3,1,0,1,0
"CONCEPCION",1,4,.2,.8,5,0,1,0,0
"CONCHITA",0,5,0,1,5,0,1,0,1
"CONNY",0,3,0,1,3,0,1,0,1
"CONSTANT",2,0,1,0,2,1,0,1,0
"CONSTANTINA",0,3,0,1,3,0,1,0,1
"CONSTANTINO",2,0,1,0,2,1,0,1,0
"CONTESSA",0,3,0,1,3,0,1,0,1
"CORDERO",4,0,1,0,4,1,0,1,0
"COSTANZA",0,3,0,1,3,0,1,0,1
"CRYSTEL",0,4,0,1,4,0,1,0,1
"CUI",1,5,.1666667,.8333333,6,0,1,0,0
"CUNNINGHAM",1,1,.5,.5,2,0,0,0,0
"CYRE",0,4,0,1,4,0,1,0,1
"CZAR",3,0,1,0,3,1,0,1,0
"DADY",4,1,.8,.2,5,1,0,0,0
"DAFINA",0,3,0,1,3,0,1,0,1
"DAG",4,0,1,0,4,1,0,1,0
"DAGOBERTO",5,0,1,0,5,1,0,1,0
"DAINE",3,1,.75,.25,4,0,0,0,0
"DAJUAN",4,0,1,0,4,1,0,1,0
"DALIAH",0,3,0,1,3,0,1,0,1
"DALIT",0,2,0,1,2,0,1,0,1
"DALY",1,2,.3333333,.6666667,3,0,0,0,0
"DAMEON",2,0,1,0,2,1,0,1,0
"DAMILOLA",2,1,.6666667,.3333333,3,0,0,0,0
"DANAH",0,3,0,1,3,0,1,0,1
"DANEEN",0,5,0,1,5,0,1,0,1
"DANIJELA",0,2,0,1,2,0,1,0,1
"DANISE",0,4,0,1,4,0,1,0,1
"DANITZA",0,5,0,1,5,0,1,0,1
"DANYAL",4,0,1,0,4,1,0,1,0
"DARDAN",3,0,1,0,3,1,0,1,0
"DARICE",0,2,0,1,2,0,1,0,1
"DARIELLE",0,3,0,1,3,0,1,0,1
"DARLYNE",0,3,0,1,3,0,1,0,1
"DARPAN",4,0,1,0,4,1,0,1,0
"DARRAGH",2,0,1,0,2,1,0,1,0
"DAVEN",2,0,1,0,2,1,0,1,0
"DAVONNE",2,2,.5,.5,4,0,0,0,0
"DAVOR",4,0,1,0,4,1,0,1,0
"DAWIT",5,0,1,0,5,1,0,1,0
"DAWNETTE",0,3,0,1,3,0,1,0,1
"DAWSON",4,0,1,0,4,1,0,1,0
"DAYVON",5,0,1,0,5,1,0,1,0
"DEANGELO",5,0,1,0,5,1,0,1,0
"DEBBIE-ANN",0,3,0,1,3,0,1,0,1
"DEEDRA",0,3,0,1,3,0,1,0,1
"DEJOHN",2,2,.5,.5,4,0,0,0,0
"DEKE",2,1,.6666667,.3333333,3,0,0,0,0
"DELGADO",4,0,1,0,4,1,0,1,0
"DELINDA",0,3,0,1,3,0,1,0,1
"DELIO",5,0,1,0,5,1,0,1,0
"DELMAR",2,1,.6666667,.3333333,3,0,0,0,0
"DELORIS",0,6,0,1,6,0,1,0,1
"DELTON",3,0,1,0,3,1,0,1,0
"DELVIS",2,1,.6666667,.3333333,3,0,0,0,0
"DEMETRIS",3,0,1,0,3,1,0,1,0
"DEMOND",4,0,1,0,4,1,0,1,0
"DENAE",0,3,0,1,3,0,1,0,1
"DENEISHA",0,3,0,1,3,0,1,0,1
"DENG",3,1,.75,.25,4,0,0,0,0
"DENNYS",1,1,.5,.5,2,0,0,0,0
"DESTINI",0,3,0,1,3,0,1,0,1
"DETRA",0,5,0,1,5,0,1,0,1
"DEVANAND",5,0,1,0,5,1,0,1,0
"DEVERY",3,0,1,0,3,1,0,1,0
"DEVESH",4,0,1,0,4,1,0,1,0
"DEYSI",0,5,0,1,5,0,1,0,1
"DIAHANN",0,4,0,1,4,0,1,0,1
"DICE",6,0,1,0,6,1,0,1,0
"DIEDRA",0,2,0,1,2,0,1,0,1
"DINEEN",0,4,0,1,4,0,1,0,1
"DIONISIA",0,5,0,1,5,0,1,0,1
"DIONY",3,0,1,0,3,1,0,1,0
"DIONYSIOS",4,0,1,0,4,1,0,1,0
"DIP",3,0,1,0,3,1,0,1,0
"DIPIKA",0,3,0,1,3,0,1,0,1
"DJANGO",6,0,1,0,6,1,0,1,0
"DOLL",0,4,0,1,4,0,1,0,1
"DOMINICA",1,2,.3333333,.6666667,3,0,0,0,0
"DONALDO",3,0,1,0,3,1,0,1,0
"DONATELLO",6,0,1,0,6,1,0,1,0
"DONDI",4,0,1,0,4,1,0,1,0
"DONIA",0,3,0,1,3,0,1,0,1
"DONNALEE",0,5,0,1,5,0,1,0,1
"DONTAY",4,0,1,0,4,1,0,1,0
"DORETTE",0,3,0,1,3,0,1,0,1
"DORICE",0,4,0,1,4,0,1,0,1
"DOUGLASS",2,1,.6666667,.3333333,3,0,0,0,0
"DOUNIA",0,5,0,1,5,0,1,0,1
"DRITON",1,1,.5,.5,2,0,0,0,0
"DUFFY",2,0,1,0,2,1,0,1,0
"DUVAN",2,0,1,0,2,1,0,1,0
"DYANNE",0,5,0,1,5,0,1,0,1
"EARLENE",0,2,0,1,2,0,1,0,1
"EARLINE",0,4,0,1,4,0,1,0,1
"EARNEST",4,1,.8,.2,5,1,0,0,0
"EARTHA",0,6,0,1,6,0,1,0,1
"EASY",4,0,1,0,4,1,0,1,0
"EFOSA",3,0,1,0,3,1,0,1,0
"EGEMEN",3,0,1,0,3,1,0,1,0
"EGLÄ–",0,3,0,1,3,0,1,0,1
"EGON",5,0,1,0,5,1,0,1,0
"EHREN",3,0,1,0,3,1,0,1,0
"EILISH",0,3,0,1,3,0,1,0,1
"ELHAM",0,3,0,1,3,0,1,0,1
"ELITA",0,4,0,1,4,0,1,0,1
"ELIUD",5,0,1,0,5,1,0,1,0
"ELLEE",0,2,0,1,2,0,1,0,1
"ELYSSE",0,4,0,1,4,0,1,0,1
"EMIRA",0,3,0,1,3,0,1,0,1
"EMPIRE",2,0,1,0,2,1,0,1,0
"ENGELS",6,0,1,0,6,1,0,1,0
"ENISA",0,2,0,1,2,0,1,0,1
"ENVER",4,0,1,0,4,1,0,1,0
"EOGHAN",3,0,1,0,3,1,0,1,0
"ERGÃœN",4,0,1,0,4,1,0,1,0
"ERICKSON",5,0,1,0,5,1,0,1,0
"ERIQ",3,0,1,0,3,1,0,1,0
"ERTAN",3,0,1,0,3,1,0,1,0
"ERYNN",0,2,0,1,2,0,1,0,1
"ESAD",4,0,1,0,4,1,0,1,0
"ESAN",3,0,1,0,3,1,0,1,0
"ESTEFANIE",0,5,0,1,5,0,1,0,1
"ETSUKO",0,2,0,1,2,0,1,0,1
"EURYDICE",0,4,0,1,4,0,1,0,1
"EVANA",0,6,0,1,6,0,1,0,1
"EVANTHIA",0,3,0,1,3,0,1,0,1
"EVELISE",0,2,0,1,2,0,1,0,1
"EYDIE",0,4,0,1,4,0,1,0,1
"EZE",3,1,.75,.25,4,0,0,0,0
"FA",3,1,.75,.25,4,0,0,0,0
"FABIA",0,3,0,1,3,0,1,0,1
"FAIZAN",3,0,1,0,3,1,0,1,0
"FALGUNI",0,2,0,1,2,0,1,0,1
"FALLEN",1,3,.25,.75,4,0,0,0,0
"FARAN",3,1,.75,.25,4,0,0,0,0
"FAREEHA",0,2,0,1,2,0,1,0,1
"FARES",4,0,1,0,4,1,0,1,0
"FAVIOLA",0,4,0,1,4,0,1,0,1
"FAWAZ",5,0,1,0,5,1,0,1,0
"FAYCAL",2,0,1,0,2,1,0,1,0
"FAYOLA",0,3,0,1,3,0,1,0,1
"FELICIANO",4,0,1,0,4,1,0,1,0
"FEN",0,3,0,1,3,0,1,0,1
"FERDINANDO",6,0,1,0,6,1,0,1,0
"FERENC",3,0,1,0,3,1,0,1,0
"FIKRET",3,0,1,0,3,1,0,1,0
"FLATBUSH",3,0,1,0,3,1,0,1,0
"FLORE",0,3,0,1,3,0,1,0,1
"FLORIANA",0,2,0,1,2,0,1,0,1
"FLOW",1,3,.25,.75,4,0,0,0,0
"FNU",3,0,1,0,3,1,0,1,0
"FORHAD",3,0,1,0,3,1,0,1,0
"FRANCESKA",0,3,0,1,3,0,1,0,1
"FRANKA",0,2,0,1,2,0,1,0,1
"FRANKI",1,3,.25,.75,4,0,0,0,0
"FULVIO",3,0,1,0,3,1,0,1,0
"FUNKE",0,3,0,1,3,0,1,0,1
"GA",0,3,0,1,3,0,1,0,1
"GABINO",6,0,1,0,6,1,0,1,0
"GAD",5,0,1,0,5,1,0,1,0
"GAI",2,0,1,0,2,1,0,1,0
"GAMES",5,1,.8333333,.1666667,6,1,0,0,0
"GANGA",0,3,0,1,3,0,1,0,1
"GAO",2,2,.5,.5,4,0,0,0,0
"GARDENIA",0,5,0,1,5,0,1,0,1
"GARGI",0,2,0,1,2,0,1,0,1
"GARNER",3,0,1,0,3,1,0,1,0
"GAUDY",0,4,0,1,4,0,1,0,1
"GEANINE",0,2,0,1,2,0,1,0,1
"GENI",1,4,.2,.8,5,0,1,0,0
"GENNIFER",0,2,0,1,2,0,1,0,1
"GENTRY",2,1,.6666667,.3333333,3,0,0,0,0
"GERDA",0,2,0,1,2,0,1,0,1
"GERTI",3,0,1,0,3,1,0,1,0
"GIANMARCO",5,0,1,0,5,1,0,1,0
"GIGA",2,0,1,0,2,1,0,1,0
"GINNIE",0,4,0,1,4,0,1,0,1
"GISELL",0,4,0,1,4,0,1,0,1
"GIUSY",0,5,0,1,5,0,1,0,1
"GLADIS",0,5,0,1,5,0,1,0,1
"GLENIS",0,3,0,1,3,0,1,0,1
"GOLAN",3,0,1,0,3,1,0,1,0
"GONCA",0,2,0,1,2,0,1,0,1
"GRAZIA",0,5,0,1,5,0,1,0,1
"GUINEVERE",0,3,0,1,3,0,1,0,1
"GULNARA",0,5,0,1,5,0,1,0,1
"GULSAH",0,4,0,1,4,0,1,0,1
"GURDEEP",2,0,1,0,2,1,0,1,0
"GURMEET",3,0,1,0,3,1,0,1,0
"GURVINDER",5,0,1,0,5,1,0,1,0
"HAGAI",2,0,1,0,2,1,0,1,0
"HAIFA",0,4,0,1,4,0,1,0,1
"HAILE",4,1,.8,.2,5,1,0,0,0
"HAITHAM",3,0,1,0,3,1,0,1,0
"HALIM",3,0,1,0,3,1,0,1,0
"HALIT",2,0,1,0,2,1,0,1,0
"HANAA",0,2,0,1,2,0,1,0,1
"HARJOT",3,0,1,0,3,1,0,1,0
"HAROULA",0,2,0,1,2,0,1,0,1
"HARTLEY",5,0,1,0,5,1,0,1,0
"HARUMI",0,4,0,1,4,0,1,0,1
"HASIB",4,0,1,0,4,1,0,1,0
"HAT",3,0,1,0,3,1,0,1,0
"HAVA",0,3,0,1,3,0,1,0,1
"HAVANA",0,2,0,1,2,0,1,0,1
"HAYA",0,2,0,1,2,0,1,0,1
"HAZEL-ANN",0,4,0,1,4,0,1,0,1
"HEAVENLY",0,4,0,1,4,0,1,0,1
"HEDDA",0,5,0,1,5,0,1,0,1
"HEDDY",1,3,.25,.75,4,0,0,0,0
"HEESUN",0,3,0,1,3,0,1,0,1
"HELAL",3,0,1,0,3,1,0,1,0
"HELANE",0,4,0,1,4,0,1,0,1
"HELDER",5,0,1,0,5,1,0,1,0
"HELI",1,2,.3333333,.6666667,3,0,0,0,0
"HELMUT",5,0,1,0,5,1,0,1,0
"HEMANTH",5,0,1,0,5,1,0,1,0
"HENA",0,3,0,1,3,0,1,0,1
"HENDRA",4,0,1,0,4,1,0,1,0
"HENDY",3,2,.6,.4,5,0,0,0,0
"HENNESSY",0,3,0,1,3,0,1,0,1
"HERMINIA",0,3,0,1,3,0,1,0,1
"HERTA",0,4,0,1,4,0,1,0,1
"HIBA",0,2,0,1,2,0,1,0,1
"HIDEKI",6,0,1,0,6,1,0,1,0
"HILAL",1,3,.25,.75,4,0,0,0,0
"HILARIO",4,0,1,0,4,1,0,1,0
"HILLERY",0,2,0,1,2,0,1,0,1
"HIRAN",3,0,1,0,3,1,0,1,0
"HOJOON",3,0,1,0,3,1,0,1,0
"HOOVER",5,0,1,0,5,1,0,1,0
"HOSSAIN",3,0,1,0,3,1,0,1,0
"HOUMAN",3,0,1,0,3,1,0,1,0
"HSIANG",2,3,.4,.6,5,0,0,0,0
"HUMAIRA",0,2,0,1,2,0,1,0,1
"HUNT",2,0,1,0,2,1,0,1,0
"HYEMI",0,4,0,1,4,0,1,0,1
"HYEWON",0,2,0,1,2,0,1,0,1
"HYMAN",4,0,1,0,4,1,0,1,0
"HYUNSOO",4,0,1,0,4,1,0,1,0
"IA",2,3,.4,.6,5,0,0,0,0
"IANNA",0,5,0,1,5,0,1,0,1
"IBN",4,0,1,0,4,1,0,1,0
"ICE",2,2,.5,.5,4,0,0,0,0
"IDALIS",0,3,0,1,3,0,1,0,1
"IDRISS",3,0,1,0,3,1,0,1,0
"IKUKO",0,2,0,1,2,0,1,0,1
"ILLIANA",0,3,0,1,3,0,1,0,1
"ILLYA",2,0,1,0,2,1,0,1,0
"INDYA",0,2,0,1,2,0,1,0,1
"INFAMOUS",3,1,.75,.25,4,0,0,0,0
"INGMAR",5,0,1,0,5,1,0,1,0
"IOLANDA",0,2,0,1,2,0,1,0,1
"IREM",0,3,0,1,3,0,1,0,1
"IRIN",2,2,.5,.5,4,0,0,0,0
"IRMAK",0,3,0,1,3,0,1,0,1
"ISHAN",4,0,1,0,4,1,0,1,0
"ISHITA",0,3,0,1,3,0,1,0,1
"ISREAL",4,0,1,0,4,1,0,1,0
"ITTAI",3,0,1,0,3,1,0,1,0
"IULIA",0,4,0,1,4,0,1,0,1
"IVELIS",0,3,0,1,3,0,1,0,1
"IVETH",1,2,.3333333,.6666667,3,0,0,0,0
"IVI",1,2,.3333333,.6666667,3,0,0,0,0
"IYESHA",0,5,0,1,5,0,1,0,1
"JACKELYN",0,4,0,1,4,0,1,0,1
"JACO",2,0,1,0,2,1,0,1,0
"JACOBS",0,3,0,1,3,0,1,0,1
"JAHID",6,0,1,0,6,1,0,1,0
"JAHIRA",0,5,0,1,5,0,1,0,1
"JAIMY",1,2,.3333333,.6666667,3,0,0,0,0
"JAINA",0,2,0,1,2,0,1,0,1
"JAIRUS",4,0,1,0,4,1,0,1,0
"JALAL",3,0,1,0,3,1,0,1,0
"JAMA",4,0,1,0,4,1,0,1,0
"JAMAINE",5,0,1,0,5,1,0,1,0
"JAMMIE",3,1,.75,.25,4,0,0,0,0
"JANCY",1,2,.3333333,.6666667,3,0,0,0,0
"JANEAN",0,2,0,1,2,0,1,0,1
"JANELLY",0,3,0,1,3,0,1,0,1
"JANESE",0,3,0,1,3,0,1,0,1
"JANICA",0,4,0,1,4,0,1,0,1
"JANIEL",0,5,0,1,5,0,1,0,1
"JANIELLE",0,4,0,1,4,0,1,0,1
"JANIQUE",0,2,0,1,2,0,1,0,1
"JANIRIS",0,4,0,1,4,0,1,0,1
"JANITA",0,5,0,1,5,0,1,0,1
"JANNELL",0,4,0,1,4,0,1,0,1
"JARA",1,1,.5,.5,2,0,0,0,0
"JARET",4,0,1,0,4,1,0,1,0
"JASSEN",4,0,1,0,4,1,0,1,0
"JAVIN",3,0,1,0,3,1,0,1,0
"JAWARA",5,0,1,0,5,1,0,1,0
"JAYANT",3,0,1,0,3,1,0,1,0
"JAYJAY",2,1,.6666667,.3333333,3,0,0,0,0
"JAYSEN",6,0,1,0,6,1,0,1,0
"JAZZIE",0,4,0,1,4,0,1,0,1
"JEANANN",0,2,0,1,2,0,1,0,1
"JEANETTA",0,5,0,1,5,0,1,0,1
"JEANICE",0,2,0,1,2,0,1,0,1
"JEDD",3,0,1,0,3,1,0,1,0
"JEEWON",0,2,0,1,2,0,1,0,1
"JEHU",3,0,1,0,3,1,0,1,0
"JEMINA",0,2,0,1,2,0,1,0,1
"JEMMY",2,2,.5,.5,4,0,0,0,0
"JENEAN",0,3,0,1,3,0,1,0,1
"JENETTE",0,4,0,1,4,0,1,0,1
"JENIE",0,5,0,1,5,0,1,0,1
"JENILEE",0,2,0,1,2,0,1,0,1
"JENNELL",0,3,0,1,3,0,1,0,1
"JERICA",0,4,0,1,4,0,1,0,1
"JEROLD",3,0,1,0,3,1,0,1,0
"JERVIS",5,0,1,0,5,1,0,1,0
"JESAL",2,1,.6666667,.3333333,3,0,0,0,0
"JEZEBEL",0,3,0,1,3,0,1,0,1
"JHOAN",5,0,1,0,5,1,0,1,0
"JIHOON",3,0,1,0,3,1,0,1,0
"JINCY",0,2,0,1,2,0,1,0,1
"JINETTE",0,4,0,1,4,0,1,0,1
"JINI",0,2,0,1,2,0,1,0,1
"JISELLE",0,3,0,1,3,0,1,0,1
"JOAKIM",5,0,1,0,5,1,0,1,0
"JO-ANNA",0,4,0,1,4,0,1,0,1
"JOAQUIM",6,0,1,0,6,1,0,1,0
"JOBA",3,1,.75,.25,4,0,0,0,0
"JOCELIN",0,3,0,1,3,0,1,0,1
"JOCHEN",5,0,1,0,5,1,0,1,0
"JOELLA",0,4,0,1,4,0,1,0,1
"JOESEPH",6,0,1,0,6,1,0,1,0
"JOJI",2,1,.6666667,.3333333,3,0,0,0,0
"JOLINA",0,5,0,1,5,0,1,0,1
"JOMAR",4,0,1,0,4,1,0,1,0
"JONEL",4,2,.6666667,.3333333,6,0,0,0,0
"JONELL",0,2,0,1,2,0,1,0,1
"JONETTE",0,4,0,1,4,0,1,0,1
"JOOST",2,0,1,0,2,1,0,1,0
"JOOYOUNG",1,3,.25,.75,4,0,0,0,0
"JOSI",0,2,0,1,2,0,1,0,1
"JOSSY",0,4,0,1,4,0,1,0,1
"JOVANKA",0,4,0,1,4,0,1,0,1
"JOVI",3,1,.75,.25,4,0,0,0,0
"JOYCEE",0,3,0,1,3,0,1,0,1
"JUAN-CARLOS",3,0,1,0,3,1,0,1,0
"JUANITO",6,0,1,0,6,1,0,1,0
"JUDINE",0,4,0,1,4,0,1,0,1
"JULIDE",0,2,0,1,2,0,1,0,1
"JULINE",0,5,0,1,5,0,1,0,1
"JULITO",4,0,1,0,4,1,0,1,0
"JUNIA",0,5,0,1,5,0,1,0,1
"JUNICHI",3,0,1,0,3,1,0,1,0
"JUNIPER",0,3,0,1,3,0,1,0,1
"JUNJIE",2,0,1,0,2,1,0,1,0
"JUNY",3,1,.75,.25,4,0,0,0,0
"JUÃ‰LZ",2,1,.6666667,.3333333,3,0,0,0,0
"JYOTSNA",0,3,0,1,3,0,1,0,1
"KACHI",2,2,.5,.5,4,0,0,0,0
"KADE",2,1,.6666667,.3333333,3,0,0,0,0
"KADIATOU",0,5,0,1,5,0,1,0,1
"KADIJA",0,2,0,1,2,0,1,0,1
"KAILEY",0,2,0,1,2,0,1,0,1
"KAIRI",2,1,.6666667,.3333333,3,0,0,0,0
"KALEEM",2,1,.6666667,.3333333,3,0,0,0,0
"KALIM",1,1,.5,.5,2,0,0,0,0
"KALIMA",0,4,0,1,4,0,1,0,1
"KALIN",3,0,1,0,3,1,0,1,0
"KALLIOPI",0,4,0,1,4,0,1,0,1
"KALYN",0,2,0,1,2,0,1,0,1
"KAMARA",0,3,0,1,3,0,1,0,1
"KAMESHA",0,5,0,1,5,0,1,0,1
"KAMILIA",0,4,0,1,4,0,1,0,1
"KAMLA",0,4,0,1,4,0,1,0,1
"KANAE",0,3,0,1,3,0,1,0,1
"KANYE",2,1,.6666667,.3333333,3,0,0,0,0
"KARAM",3,1,.75,.25,4,0,0,0,0
"KARAMJIT",2,0,1,0,2,1,0,1,0
"KARINNE",0,4,0,1,4,0,1,0,1
"KARLEE",0,2,0,1,2,0,1,0,1
"KASHAN",1,2,.3333333,.6666667,3,0,0,0,0
"KASIM",5,0,1,0,5,1,0,1,0
"KASSI",0,5,0,1,5,0,1,0,1
"KATEE",0,3,0,1,3,0,1,0,1
"KATELIN",0,3,0,1,3,0,1,0,1
"KATH",0,4,0,1,4,0,1,0,1
"KATHRINA",0,2,0,1,2,0,1,0,1
"KATHY-ANN",0,3,0,1,3,0,1,0,1
"KAVON",2,1,.6666667,.3333333,3,0,0,0,0
"KAWAN",2,0,1,0,2,1,0,1,0
"KAYRA",1,3,.25,.75,4,0,0,0,0
"KAYSHA",0,2,0,1,2,0,1,0,1
"KAZUHIRO",5,0,1,0,5,1,0,1,0
"KEDA",0,2,0,1,2,0,1,0,1
"KEEM",4,1,.8,.2,5,1,0,0,0
"KEENYA",0,4,0,1,4,0,1,0,1
"KEIRON",5,0,1,0,5,1,0,1,0
"KELLER",3,1,.75,.25,4,0,0,0,0
"KELLYE",0,4,0,1,4,0,1,0,1
"KELLYN",1,1,.5,.5,2,0,0,0,0
"KELZ",2,1,.6666667,.3333333,3,0,0,0,0
"KEMA",0,3,0,1,3,0,1,0,1
"KENE",2,0,1,0,2,1,0,1,0
"KENEISHA",0,5,0,1,5,0,1,0,1
"KENG",5,0,1,0,5,1,0,1,0
"KENLEY",5,0,1,0,5,1,0,1,0
"KENNIA",0,4,0,1,4,0,1,0,1
"KEREL",2,0,1,0,2,1,0,1,0
"KERIM",4,0,1,0,4,1,0,1,0
"KESIA",0,4,0,1,4,0,1,0,1
"KETEVAN",0,5,0,1,5,0,1,0,1
"KEVA",0,2,0,1,2,0,1,0,1
"KEVORK",4,0,1,0,4,1,0,1,0
"KEYONNA",0,6,0,1,6,0,1,0,1
"KEZIAH",0,5,0,1,5,0,1,0,1
"KHAI",0,2,0,1,2,0,1,0,1
"KHALIAH",0,4,0,1,4,0,1,0,1
"KHALIF",4,0,1,0,4,1,0,1,0
"KHEMRAJ",5,0,1,0,5,1,0,1,0
"KHIRY",5,0,1,0,5,1,0,1,0
"KHURAM",5,0,1,0,5,1,0,1,0
"KIEN",3,0,1,0,3,1,0,1,0
"KIMBA",0,3,0,1,3,0,1,0,1
"KIMBALL",2,0,1,0,2,1,0,1,0
"KIMBERLEIGH",0,4,0,1,4,0,1,0,1
"KIMBERLYN",0,2,0,1,2,0,1,0,1
"KIMISHA",0,4,0,1,4,0,1,0,1
"KIMMARIE",0,2,0,1,2,0,1,0,1
"KISHIA",0,5,0,1,5,0,1,0,1
"KISHOR",3,0,1,0,3,1,0,1,0
"KISSY",0,5,0,1,5,0,1,0,1
"KITSON",4,0,1,0,4,1,0,1,0
"KITTIE",0,5,0,1,5,0,1,0,1
"KLEVER",6,0,1,0,6,1,0,1,0
"KOH",3,0,1,0,3,1,0,1,0
"KOHEI",4,0,1,0,4,1,0,1,0
"KOLBY",4,0,1,0,4,1,0,1,0
"KRISHA",0,4,0,1,4,0,1,0,1
"KRISI",0,2,0,1,2,0,1,0,1
"KRISTOFOR",4,0,1,0,4,1,0,1,0
"KRYSTIE",0,2,0,1,2,0,1,0,1
"KSHITIJ",3,0,1,0,3,1,0,1,0
"KSUSHA",0,3,0,1,3,0,1,0,1
"KU",3,1,.75,.25,4,0,0,0,0
"KUJTIM",6,0,1,0,6,1,0,1,0
"KULDEEP",2,1,.6666667,.3333333,3,0,0,0,0
"KUMASI",4,0,1,0,4,1,0,1,0
"KUN",4,2,.6666667,.3333333,6,0,0,0,0
"KUNGA",3,0,1,0,3,1,0,1,0
"KWAI",2,1,.6666667,.3333333,3,0,0,0,0
"KYANNA",0,3,0,1,3,0,1,0,1
"KYARA",0,2,0,1,2,0,1,0,1
"KYOUNG",3,0,1,0,3,1,0,1,0
"KYSHA",0,2,0,1,2,0,1,0,1
"LADA",0,4,0,1,4,0,1,0,1
"LAIS",0,4,0,1,4,0,1,0,1
"LAISHA",0,5,0,1,5,0,1,0,1
"LAITH",4,0,1,0,4,1,0,1,0
"LAKECIA",0,2,0,1,2,0,1,0,1
"LALIT",5,0,1,0,5,1,0,1,0
"LAMBROS",4,0,1,0,4,1,0,1,0
"LAMEEK",5,0,1,0,5,1,0,1,0
"LANAE",0,3,0,1,3,0,1,0,1
"LANDI",3,1,.75,.25,4,0,0,0,0
"LANDRY",3,1,.75,.25,4,0,0,0,0
"LANDY",2,2,.5,.5,4,0,0,0,0
"LANISE",0,3,0,1,3,0,1,0,1
"LAREINA",0,4,0,1,4,0,1,0,1
"LAREN",2,3,.4,.6,5,0,0,0,0
"LARHONDA",0,4,0,1,4,0,1,0,1
"LASCELLES",3,0,1,0,3,1,0,1,0
"LASHAUNDA",0,3,0,1,3,0,1,0,1
"LATCHMI",0,3,0,1,3,0,1,0,1
"LATOYIA",0,5,0,1,5,0,1,0,1
"LAUNA",0,5,0,1,5,0,1,0,1
"LAURAN",0,2,0,1,2,0,1,0,1
"LAW",2,1,.6666667,.3333333,3,0,0,0,0
"LAWANA",0,5,0,1,5,0,1,0,1
"LAYA",0,2,0,1,2,0,1,0,1
"LEANDER",3,0,1,0,3,1,0,1,0
"LEANORA",0,3,0,1,3,0,1,0,1
"LEATRICE",0,4,0,1,4,0,1,0,1
"LEE-ANN",0,3,0,1,3,0,1,0,1
"LEIGHA",0,6,0,1,6,0,1,0,1
"LEIGH-ANN",0,3,0,1,3,0,1,0,1
"LEROI",5,0,1,0,5,1,0,1,0
"LESTON",3,0,1,0,3,1,0,1,0
"LETY",0,4,0,1,4,0,1,0,1
"LEXUS",2,2,.5,.5,4,0,0,0,0
"LEYDY",0,6,0,1,6,0,1,0,1
"LEZLIE",0,5,0,1,5,0,1,0,1
"LIANN",0,3,0,1,3,0,1,0,1
"LIBI",0,2,0,1,2,0,1,0,1
"LIDIYA",0,2,0,1,2,0,1,0,1
"LIEL",2,1,.6666667,.3333333,3,0,0,0,0
"LIEZL",0,2,0,1,2,0,1,0,1
"LIJO",3,0,1,0,3,1,0,1,0
"LIJU",4,0,1,0,4,1,0,1,0
"LINDER",1,2,.3333333,.6666667,3,0,0,0,0
"LINGLING",0,4,0,1,4,0,1,0,1
"LINK",3,1,.75,.25,4,0,0,0,0
"LION",4,0,1,0,4,1,0,1,0
"LISETH",0,2,0,1,2,0,1,0,1
"LISLE",2,0,1,0,2,1,0,1,0
"LISS",0,3,0,1,3,0,1,0,1
"LIUBOV",0,4,0,1,4,0,1,0,1
"LIVIU",2,0,1,0,2,1,0,1,0
"LIZI",0,3,0,1,3,0,1,0,1
"LOBO",3,0,1,0,3,1,0,1,0
"LOKESH",5,0,1,0,5,1,0,1,0
"LORI-ANN",0,2,0,1,2,0,1,0,1
"LOTTA",0,3,0,1,3,0,1,0,1
"LOUI",2,1,.6666667,.3333333,3,0,0,0,0
"LOUIZA",0,3,0,1,3,0,1,0,1
"LUBIN",4,0,1,0,4,1,0,1,0
"LUCCA",3,0,1,0,3,1,0,1,0
"LUCHO",5,0,1,0,5,1,0,1,0
"LUCIANNE",0,2,0,1,2,0,1,0,1
"LUE",3,2,.6,.4,5,0,0,0,0
"LUNG",3,0,1,0,3,1,0,1,0
"LUQMAN",3,0,1,0,3,1,0,1,0
"LYNCH",2,1,.6666667,.3333333,3,0,0,0,0
"LYNDI",0,2,0,1,2,0,1,0,1
"MACKY",5,1,.8333333,.1666667,6,1,0,0,0
"MACON",3,0,1,0,3,1,0,1,0
"MADALINA",0,3,0,1,3,0,1,0,1
"MADGE",0,4,0,1,4,0,1,0,1
"MADHAV",2,0,1,0,2,1,0,1,0
"MAHMUDUL",4,0,1,0,4,1,0,1,0
"MAIKA",0,4,0,1,4,0,1,0,1
"MAIRIN",0,2,0,1,2,0,1,0,1
"MAISA",0,4,0,1,4,0,1,0,1
"MAJELLA",0,4,0,1,4,0,1,0,1
"MAJESTIC",0,2,0,1,2,0,1,0,1
"MAKA",1,4,.2,.8,5,0,1,0,0
"MALISA",0,2,0,1,2,0,1,0,1
"MANAV",3,0,1,0,3,1,0,1,0
"MANDEE",0,3,0,1,3,0,1,0,1
"MANDO",2,0,1,0,2,1,0,1,0
"MANEL",0,2,0,1,2,0,1,0,1
"MANJEET",2,1,.6666667,.3333333,3,0,0,0,0
"MANMOHAN",4,0,1,0,4,1,0,1,0
"MANOUCHEKA",0,5,0,1,5,0,1,0,1
"MANSOUR",3,0,1,0,3,1,0,1,0
"MAPLE",0,3,0,1,3,0,1,0,1
"MARANDA",0,5,0,1,5,0,1,0,1
"MARC-ANTOINE",4,1,.8,.2,5,1,0,0,0
"MARCIANO",3,1,.75,.25,4,0,0,0,0
"MARGY",0,4,0,1,4,0,1,0,1
"MARICA",0,3,0,1,3,0,1,0,1
"MARIEN",0,3,0,1,3,0,1,0,1
"MARIJANA",0,2,0,1,2,0,1,0,1
"MARIYAM",0,2,0,1,2,0,1,0,1
"MARJIE",0,3,0,1,3,0,1,0,1
"MARKISHA",0,4,0,1,4,0,1,0,1
"MARLANA",0,2,0,1,2,0,1,0,1
"MARLENI",0,4,0,1,4,0,1,0,1
"MARNE",1,4,.2,.8,5,0,1,0,0
"MARQ",5,0,1,0,5,1,0,1,0
"MARTE",4,0,1,0,4,1,0,1,0
"MARTYN",3,0,1,0,3,1,0,1,0
"MARVEL",2,2,.5,.5,4,0,0,0,0
"MARYALICE",0,2,0,1,2,0,1,0,1
"MARYLU",0,6,0,1,6,0,1,0,1
"MARYLYN",1,3,.25,.75,4,0,0,0,0
"MASAI",4,1,.8,.2,5,1,0,0,0
"MASATO",2,0,1,0,2,1,0,1,0
"MASOUD",3,0,1,0,3,1,0,1,0
"MAYLEEN",0,3,0,1,3,0,1,0,1
"MAYLING",0,4,0,1,4,0,1,0,1
"MAYSA",0,5,0,1,5,0,1,0,1
"MEGHANA",0,4,0,1,4,0,1,0,1
"MEHRAN",5,0,1,0,5,1,0,1,0
"MELAINA",0,5,0,1,5,0,1,0,1
"MELFI",2,1,.6666667,.3333333,3,0,0,0,0
"MELIA",0,2,0,1,2,0,1,0,1
"MELITA",0,4,0,1,4,0,1,0,1
"MELLIE",0,2,0,1,2,0,1,0,1
"MELLO",3,1,.75,.25,4,0,0,0,0
"MELVYN",4,0,1,0,4,1,0,1,0
"MELYNDA",0,3,0,1,3,0,1,0,1
"MEMO",4,1,.8,.2,5,1,0,0,0
"MENSUR",3,0,1,0,3,1,0,1,0
"MERGIM",3,0,1,0,3,1,0,1,0
"MERIEM",0,5,0,1,5,0,1,0,1
"MERILYN",0,4,0,1,4,0,1,0,1
"MERON",0,2,0,1,2,0,1,0,1
"MIAH",1,4,.2,.8,5,0,1,0,0
"MICAHEL",4,0,1,0,4,1,0,1,0
"MIDO",5,0,1,0,5,1,0,1,0
"MIESHA",0,2,0,1,2,0,1,0,1
"MIG",3,0,1,0,3,1,0,1,0
"MIKAH",1,1,.5,.5,2,0,0,0,0
"MIKEE",5,0,1,0,5,1,0,1,0
"MIKKEL",2,0,1,0,2,1,0,1,0
"MILADYS",0,4,0,1,4,0,1,0,1
"MILAGRO",0,5,0,1,5,0,1,0,1
"MILEDYS",1,4,.2,.8,5,0,1,0,0
"MILKY",2,1,.6666667,.3333333,3,0,0,0,0
"MIMMA",0,4,0,1,4,0,1,0,1
"MINHO",5,0,1,0,5,1,0,1,0
"MINO",3,1,.75,.25,4,0,0,0,0
"MINOO",0,4,0,1,4,0,1,0,1
"MIODRAG",5,0,1,0,5,1,0,1,0
"MIRCEA",5,0,1,0,5,1,0,1,0
"MIREK",4,0,1,0,4,1,0,1,0
"MISHAL",2,0,1,0,2,1,0,1,0
"MIT",1,1,.5,.5,2,0,0,0,0
"MIXALIS",2,0,1,0,2,1,0,1,0
"MIZANUR",3,0,1,0,3,1,0,1,0
"MODERN",3,1,.75,.25,4,0,0,0,0
"MODESTA",0,4,0,1,4,0,1,0,1
"MODUPE",0,3,0,1,3,0,1,0,1
"MOET",1,3,.25,.75,4,0,0,0,0
"MOIZ",3,0,1,0,3,1,0,1,0
"MOJI",0,4,0,1,4,0,1,0,1
"MOLINA",1,1,.5,.5,2,0,0,0,0
"MONAY",0,5,0,1,5,0,1,0,1
"MONEE",0,3,0,1,3,0,1,0,1
"MONISH",2,0,1,0,2,1,0,1,0
"MONK",5,0,1,0,5,1,0,1,0
"MORGANA",0,4,0,1,4,0,1,0,1
"MORT",2,0,1,0,2,1,0,1,0
"MORTEZA",5,0,1,0,5,1,0,1,0
"MORTIMER",4,0,1,0,4,1,0,1,0
"MOTY",3,0,1,0,3,1,0,1,0
"MOULAY",4,0,1,0,4,1,0,1,0
"MOUNA",1,4,.2,.8,5,0,1,0,0
"MUJAHID",4,0,1,0,4,1,0,1,0
"MUMTAZ",1,4,.2,.8,5,0,1,0,0
"MUN",4,0,1,0,4,1,0,1,0
"MUTLU",4,0,1,0,4,1,0,1,0
"MYESHA",0,3,0,1,3,0,1,0,1
"MYK",4,0,1,0,4,1,0,1,0
"MYLINH",0,2,0,1,2,0,1,0,1
"NACHUM",2,0,1,0,2,1,0,1,0
"NAEEMA",0,4,0,1,4,0,1,0,1
"NAHEED",0,4,0,1,4,0,1,0,1
"NAHEEM",3,0,1,0,3,1,0,1,0
"NAHSHON",4,0,1,0,4,1,0,1,0
"NAIRA",0,2,0,1,2,0,1,0,1
"NAJEEB",3,0,1,0,3,1,0,1,0
"NAJWA",0,2,0,1,2,0,1,0,1
"NAKEIA",0,2,0,1,2,0,1,0,1
"NANCE",0,3,0,1,3,0,1,0,1
"NANNA",0,3,0,1,3,0,1,0,1
"NANNY",0,4,0,1,4,0,1,0,1
"NARGIS",0,4,0,1,4,0,1,0,1
"NARIN",1,2,.3333333,.6666667,3,0,0,0,0
"NARISA",0,2,0,1,2,0,1,0,1
"NASER",5,0,1,0,5,1,0,1,0
"NATAKI",0,3,0,1,3,0,1,0,1
"NATANAEL",5,0,1,0,5,1,0,1,0
"NATANIA",0,4,0,1,4,0,1,0,1
"NATASCIA",0,5,0,1,5,0,1,0,1
"NATOSHA",0,4,0,1,4,0,1,0,1
"NATSUKI",1,3,.25,.75,4,0,0,0,0
"NATSUKO",0,4,0,1,4,0,1,0,1
"NAUREEN",0,2,0,1,2,0,1,0,1
"NAVID",2,0,1,0,2,1,0,1,0
"NAVJOT",3,0,1,0,3,1,0,1,0
"NAYIBE",0,2,0,1,2,0,1,0,1
"NAYOUNG",0,3,0,1,3,0,1,0,1
"NAYRA",0,3,0,1,3,0,1,0,1
"NAZNEEN",0,3,0,1,3,0,1,0,1
"NAZY",0,3,0,1,3,0,1,0,1
"NECDET",4,0,1,0,4,1,0,1,0
"NEERU",0,3,0,1,3,0,1,0,1
"NEGIN",0,2,0,1,2,0,1,0,1
"NEGRO",3,0,1,0,3,1,0,1,0
"NEHEMIAH",4,0,1,0,4,1,0,1,0
"NEIDA",0,5,0,1,5,0,1,0,1
"NEKA",0,4,0,1,4,0,1,0,1
"NEKISHA",0,4,0,1,4,0,1,0,1
"NEXT",1,1,.5,.5,2,0,0,0,0
"NEY",4,1,.8,.2,5,1,0,0,0
"NGINA",0,2,0,1,2,0,1,0,1
"NICKEL",5,0,1,0,5,1,0,1,0
"NICOLETA",0,4,0,1,4,0,1,0,1
"NIEL",4,1,.8,.2,5,1,0,0,0
"NIKEA",0,5,0,1,5,0,1,0,1
"NIKOLETTA",0,3,0,1,3,0,1,0,1
"NILO",3,0,1,0,3,1,0,1,0
"NIMISH",5,0,1,0,5,1,0,1,0
"NIRANJAN",3,0,1,0,3,1,0,1,0
"NIRIT",0,3,0,1,3,0,1,0,1
"NISHAN",5,0,1,0,5,1,0,1,0
"NITIKA",0,3,0,1,3,0,1,0,1
"NIYAH",0,5,0,1,5,0,1,0,1
"NIYI",5,0,1,0,5,1,0,1,0
"NOEMY",0,3,0,1,3,0,1,0,1
"NONYA",1,2,.3333333,.6666667,3,0,0,0,0
"NORBU",5,0,1,0,5,1,0,1,0
"NORINA",0,4,0,1,4,0,1,0,1
"NORINE",0,3,0,1,3,0,1,0,1
"NORIS",1,2,.3333333,.6666667,3,0,0,0,0
"NORY",0,3,0,1,3,0,1,0,1
"NOSA",2,1,.6666667,.3333333,3,0,0,0,0
"NOUREDDINE",5,0,1,0,5,1,0,1,0
"NOY",0,4,0,1,4,0,1,0,1
"NOZOMI",0,2,0,1,2,0,1,0,1
"NU",2,1,.6666667,.3333333,3,0,0,0,0
"NUMAN",2,0,1,0,2,1,0,1,0
"NUNZIA",0,2,0,1,2,0,1,0,1
"NYCE",2,2,.5,.5,4,0,0,0,0
"NYSSA",0,2,0,1,2,0,1,0,1
"OBA",2,1,.6666667,.3333333,3,0,0,0,0
"ODANE",5,0,1,0,5,1,0,1,0
"OLABISI",1,1,.5,.5,2,0,0,0,0
"OLIA",0,2,0,1,2,0,1,0,1
"OLUSOLA",2,1,.6666667,.3333333,3,0,0,0,0
"OLUWASEUN",4,1,.8,.2,5,1,0,0,0
"OMKAR",5,0,1,0,5,1,0,1,0
"ONDER",3,0,1,0,3,1,0,1,0
"ONEKA",0,4,0,1,4,0,1,0,1
"ONIX",1,1,.5,.5,2,0,0,0,0
"ONOFRIO",2,0,1,0,2,1,0,1,0
"ONYI",0,2,0,1,2,0,1,0,1
"ORAZIO",2,0,1,0,2,1,0,1,0
"ORESTE",4,0,1,0,4,1,0,1,0
"ORIEL",1,2,.3333333,.6666667,3,0,0,0,0
"ORQUIDEA",0,4,0,1,4,0,1,0,1
"OSAHON",2,0,1,0,2,1,0,1,0
"OSBERT",4,0,1,0,4,1,0,1,0
"OTILIA",0,3,0,1,3,0,1,0,1
"OUIDA",0,3,0,1,3,0,1,0,1
"OUMOU",0,4,0,1,4,0,1,0,1
"OURANIA",0,5,0,1,5,0,1,0,1
"OVADIA",4,0,1,0,4,1,0,1,0
"OYA",0,3,0,1,3,0,1,0,1
"PADRAIG",2,0,1,0,2,1,0,1,0
"PALAK",1,1,.5,.5,2,0,0,0,0
"PANA",1,1,.5,.5,2,0,0,0,0
"PANAYIOTIS",3,0,1,0,3,1,0,1,0
"PANDA",2,2,.5,.5,4,0,0,0,0
"PANDORA",0,4,0,1,4,0,1,0,1
"PANO",5,0,1,0,5,1,0,1,0
"PANSY",1,2,.3333333,.6666667,3,0,0,0,0
"PARVEZ",2,0,1,0,2,1,0,1,0
"PEACE",1,2,.3333333,.6666667,3,0,0,0,0
"PEACH",0,5,0,1,5,0,1,0,1
"PENN",2,0,1,0,2,1,0,1,0
"PENNIE",0,3,0,1,3,0,1,0,1
"PEPI",2,4,.3333333,.6666667,6,0,0,0,0
"PEREL",0,2,0,1,2,0,1,0,1
"PETAGAYE",0,5,0,1,5,0,1,0,1
"PEYMAN",2,0,1,0,2,1,0,1,0
"PHONG",3,0,1,0,3,1,0,1,0
"PIPPA",0,3,0,1,3,0,1,0,1
"PLACE",1,1,.5,.5,2,0,0,0,0
"PLESHETTE",0,4,0,1,4,0,1,0,1
"POWELL",3,1,.75,.25,4,0,0,0,0
"PRENTICE",3,0,1,0,3,1,0,1,0
"PRIMO",5,0,1,0,5,1,0,1,0
"PULKIT",3,0,1,0,3,1,0,1,0
"PUMKIN",2,1,.6666667,.3333333,3,0,0,0,0
"PW",1,1,.5,.5,2,0,0,0,0
"QIONG",2,2,.5,.5,4,0,0,0,0
"QU",2,1,.6666667,.3333333,3,0,0,0,0
"QUEENA",0,3,0,1,3,0,1,0,1
"QUIET",2,1,.6666667,.3333333,3,0,0,0,0
"RAEANNE",0,3,0,1,3,0,1,0,1
"RAFAELLA",0,3,0,1,3,0,1,0,1
"RAHEEN",3,0,1,0,3,1,0,1,0
"RAHI",2,1,.6666667,.3333333,3,0,0,0,0
"RAIMONDO",4,1,.8,.2,5,1,0,0,0
"RAKHEE",1,5,.1666667,.8333333,6,0,1,0,0
"RALSTON",6,0,1,0,6,1,0,1,0
"RAMIRÃ‰Z",3,0,1,0,3,1,0,1,0
"RAMZY",5,1,.8333333,.1666667,6,1,0,0,0
"RANBIR",3,0,1,0,3,1,0,1,0
"RANJAN",4,1,.8,.2,5,1,0,0,0
"RAPHAELA",0,3,0,1,3,0,1,0,1
"RAQUELLE",0,4,0,1,4,0,1,0,1
"RASEAN",6,0,1,0,6,1,0,1,0
"RASHELLE",0,3,0,1,3,0,1,0,1
"RASMUS",2,0,1,0,2,1,0,1,0
"RAYCHEL",0,2,0,1,2,0,1,0,1
"RAYLENE",0,3,0,1,3,0,1,0,1
"RAYNELL",2,2,.5,.5,4,0,0,0,0
"RAYRAY",3,1,.75,.25,4,0,0,0,0
"RAZVAN",2,0,1,0,2,1,0,1,0
"REDWAN",4,0,1,0,4,1,0,1,0
"REEVES",4,1,.8,.2,5,1,0,0,0
"REGGY",1,2,.3333333,.6666667,3,0,0,0,0
"REHA",3,0,1,0,3,1,0,1,0
"REMO",5,0,1,0,5,1,0,1,0
"REMUS",4,0,1,0,4,1,0,1,0
"RENALD",4,0,1,0,4,1,0,1,0
"REZWANA",0,2,0,1,2,0,1,0,1
"RHAMEL",5,0,1,0,5,1,0,1,0
"RHIAN",0,3,0,1,3,0,1,0,1
"RIADH",4,0,1,0,4,1,0,1,0
"RIANNA",0,2,0,1,2,0,1,0,1
"RICHARDS",1,3,.25,.75,4,0,0,0,0
"RIDA",0,2,0,1,2,0,1,0,1
"RIDGE",2,0,1,0,2,1,0,1,0
"RINKU",1,1,.5,.5,2,0,0,0,0
"RODOLPHE",5,0,1,0,5,1,0,1,0
"ROEE",6,0,1,0,6,1,0,1,0
"ROGERS",1,2,.3333333,.6666667,3,0,0,0,0
"ROIE",2,2,.5,.5,4,0,0,0,0
"ROLLY",3,1,.75,.25,4,0,0,0,0
"ROMIE",2,2,.5,.5,4,0,0,0,0
"RONIE",3,0,1,0,3,1,0,1,0
"RONIQUE",1,1,.5,.5,2,0,0,0,0
"ROSALY",0,2,0,1,2,0,1,0,1
"ROSALYNN",0,2,0,1,2,0,1,0,1
"ROSANGEL",0,5,0,1,5,0,1,0,1
"ROSENA",0,2,0,1,2,0,1,0,1
"ROSHAWN",3,1,.75,.25,4,0,0,0,0
"ROSHELLE",0,2,0,1,2,0,1,0,1
"ROSSANO",4,0,1,0,4,1,0,1,0
"ROSSLYN",0,3,0,1,3,0,1,0,1
"ROWLAND",3,0,1,0,3,1,0,1,0
"ROYALE",3,1,.75,.25,4,0,0,0,0
"ROZANA",0,4,0,1,4,0,1,0,1
"RUCHIKA",0,2,0,1,2,0,1,0,1
"RUE",3,0,1,0,3,1,0,1,0
"RUPESH",4,0,1,0,4,1,0,1,0
"RUPINDER",0,3,0,1,3,0,1,0,1
"RUSHELL",0,5,0,1,5,0,1,0,1
"RUSLANA",0,4,0,1,4,0,1,0,1
"RUXANDRA",0,5,0,1,5,0,1,0,1
"RYANNE",1,1,.5,.5,2,0,0,0,0
"RYLAN",4,1,.8,.2,5,1,0,0,0
"SABIR",2,0,1,0,2,1,0,1,0
"SABREENA",0,2,0,1,2,0,1,0,1
"SABRIA",0,3,0,1,3,0,1,0,1
"SACHIE",0,4,0,1,4,0,1,0,1
"SADHANA",0,4,0,1,4,0,1,0,1
"SADI",3,1,.75,.25,4,0,0,0,0
"SADIQA",0,3,0,1,3,0,1,0,1
"SAFA",1,3,.25,.75,4,0,0,0,0
"SAHIR",2,0,1,0,2,1,0,1,0
"SAHIRA",0,3,0,1,3,0,1,0,1
"SAIM",4,0,1,0,4,1,0,1,0
"SAKSHI",0,4,0,1,4,0,1,0,1
"SALSA",3,1,.75,.25,4,0,0,0,0
"SAMARTH",4,0,1,0,4,1,0,1,0
"SAMII",0,4,0,1,4,0,1,0,1
"SAMIUR",3,0,1,0,3,1,0,1,0
"SAMPATH",6,0,1,0,6,1,0,1,0
"SANAE",0,3,0,1,3,0,1,0,1
"SANCHIA",0,5,0,1,5,0,1,0,1
"SANDESH",3,0,1,0,3,1,0,1,0
"SANDYE",0,3,0,1,3,0,1,0,1
"SANGEETHA",0,3,0,1,3,0,1,0,1
"SANJIV",4,0,1,0,4,1,0,1,0
"SANKET",3,0,1,0,3,1,0,1,0
"SARAHI",0,2,0,1,2,0,1,0,1
"SARAH-JANE",0,2,0,1,2,0,1,0,1
"SARFARAZ",2,0,1,0,2,1,0,1,0
"SARO",5,0,1,0,5,1,0,1,0
"SASI",2,2,.5,.5,4,0,0,0,0
"SATESH",2,0,1,0,2,1,0,1,0
"SATIN",0,3,0,1,3,0,1,0,1
"SAUDA",0,3,0,1,3,0,1,0,1
"SAURAV",3,0,1,0,3,1,0,1,0
"SAWSAN",0,5,0,1,5,0,1,0,1
"SAY",4,0,1,0,4,1,0,1,0
"SAYEM",4,0,1,0,4,1,0,1,0
"SCOUT",3,3,.5,.5,6,0,0,0,0
"SEANA",0,3,0,1,3,0,1,0,1
"SEGUNDO",4,0,1,0,4,1,0,1,0
"SEL",2,0,1,0,2,1,0,1,0
"SENAY",1,2,.3333333,.6666667,3,0,0,0,0
"SEOK",3,1,.75,.25,4,0,0,0,0
"SEPHORA",0,2,0,1,2,0,1,0,1
"SERAFIN",4,0,1,0,4,1,0,1,0
"SEVAN",1,1,.5,.5,2,0,0,0,0
"SEVGI",0,4,0,1,4,0,1,0,1
"SEYI",1,2,.3333333,.6666667,3,0,0,0,0
"SEZGIN",5,0,1,0,5,1,0,1,0
"SHABBIR",3,0,1,0,3,1,0,1,0
"SHAFIQ",5,0,1,0,5,1,0,1,0
"SHAHNAZ",0,4,0,1,4,0,1,0,1
"SHAIL",2,1,.6666667,.3333333,3,0,0,0,0
"SHAKEENA",0,4,0,1,4,0,1,0,1
"SHAKENA",0,5,0,1,5,0,1,0,1
"SHAKTI",1,1,.5,.5,2,0,0,0,0
"SHAKUR",4,1,.8,.2,5,1,0,0,0
"SHAKYRA",0,4,0,1,4,0,1,0,1
"SHALENA",0,4,0,1,4,0,1,0,1
"SHALENE",0,5,0,1,5,0,1,0,1
"SHALLY",0,4,0,1,4,0,1,0,1
"SHALON",1,3,.25,.75,4,0,0,0,0
"SHALU",1,1,.5,.5,2,0,0,0,0
"SHAMICA",0,2,0,1,2,0,1,0,1
"SHAMINA",0,3,0,1,3,0,1,0,1
"SHANAI",0,4,0,1,4,0,1,0,1
"SHANDRA",0,4,0,1,4,0,1,0,1
"SHANEEK",0,2,0,1,2,0,1,0,1
"SHANEIKA",0,5,0,1,5,0,1,0,1
"SHANLEY",1,1,.5,.5,2,0,0,0,0
"SHANTEE",0,5,0,1,5,0,1,0,1
"SHARDAY",0,6,0,1,6,0,1,0,1
"SHARENA",0,4,0,1,4,0,1,0,1
"SHARMA",2,2,.5,.5,4,0,0,0,0
"SHAROYA",0,5,0,1,5,0,1,0,1
"SHASTA",1,2,.3333333,.6666667,3,0,0,0,0
"SHASTRI",4,0,1,0,4,1,0,1,0
"SHATEMA",0,3,0,1,3,0,1,0,1
"SHATOYA",0,4,0,1,4,0,1,0,1
"SHAUNICE",0,4,0,1,4,0,1,0,1
"SHAUNTAE",0,3,0,1,3,0,1,0,1
"SHAWNNA",0,5,0,1,5,0,1,0,1
"SHAWNTEL",1,3,.25,.75,4,0,0,0,0
"SHAZ",1,1,.5,.5,2,0,0,0,0
"SHEANA",0,3,0,1,3,0,1,0,1
"SHELLIAN",0,4,0,1,4,0,1,0,1
"SHELLON",0,5,0,1,5,0,1,0,1
"SHENITA",0,4,0,1,4,0,1,0,1
"SHEPPARD",5,0,1,0,5,1,0,1,0
"SHEREN",0,4,0,1,4,0,1,0,1
"SHERIFA",0,4,0,1,4,0,1,0,1
"SHERLYN",0,5,0,1,5,0,1,0,1
"SHERNETTE",0,4,0,1,4,0,1,0,1
"SHERRY-ANN",0,3,0,1,3,0,1,0,1
"SHERWOOD",4,1,.8,.2,5,1,0,0,0
"SHEVY",0,3,0,1,3,0,1,0,1
"SHEY",0,3,0,1,3,0,1,0,1
"SHINO",1,4,.2,.8,5,0,1,0,0
"SHINY",0,6,0,1,6,0,1,0,1
"SHIORI",0,2,0,1,2,0,1,0,1
"SHIVANIE",0,5,0,1,5,0,1,0,1
"SHLOMIE",3,0,1,0,3,1,0,1,0
"SHONTAE",0,4,0,1,4,0,1,0,1
"SHOSHANAH",0,3,0,1,3,0,1,0,1
"SHOW",4,0,1,0,4,1,0,1,0
"SHUA",5,0,1,0,5,1,0,1,0
"SHUMON",4,0,1,0,4,1,0,1,0
"SHVETA",0,2,0,1,2,0,1,0,1
"SHYANN",0,3,0,1,3,0,1,0,1
"SIGALIT",0,3,0,1,3,0,1,0,1
"SIHAM",0,2,0,1,2,0,1,0,1
"SILKY",1,1,.5,.5,2,0,0,0,0
"SIMRANJIT",3,0,1,0,3,1,0,1,0
"SITI",0,4,0,1,4,0,1,0,1
"SIVA",4,0,1,0,4,1,0,1,0
"SKIPPY",2,2,.5,.5,4,0,0,0,0
"SKYLA",0,4,0,1,4,0,1,0,1
"SMRITI",0,2,0,1,2,0,1,0,1
"SNIGDHA",0,2,0,1,2,0,1,0,1
"SOFIANE",2,0,1,0,2,1,0,1,0
"SOFIJA",0,3,0,1,3,0,1,0,1
"SOJOURNER",0,4,0,1,4,0,1,0,1
"SOLIMAR",0,2,0,1,2,0,1,0,1
"SOLLY",3,0,1,0,3,1,0,1,0
"SOLY",2,1,.6666667,.3333333,3,0,0,0,0
"SOMER",0,4,0,1,4,0,1,0,1
"SONNI",1,2,.3333333,.6666667,3,0,0,0,0
"SOPHONIE",2,2,.5,.5,4,0,0,0,0
"SOY",2,1,.6666667,.3333333,3,0,0,0,0
"SPIRIT",2,1,.6666667,.3333333,3,0,0,0,0
"SPOT",3,1,.75,.25,4,0,0,0,0
"SQUISHY",3,1,.75,.25,4,0,0,0,0
"SRAVAN",5,0,1,0,5,1,0,1,0
"SREE",5,1,.8333333,.1666667,6,1,0,0,0
"STARLA",0,4,0,1,4,0,1,0,1
"STEFANNY",0,5,0,1,5,0,1,0,1
"STOKES",3,2,.6,.4,5,0,0,0,0
"SUBIN",4,0,1,0,4,1,0,1,0
"SUGA",2,1,.6666667,.3333333,3,0,0,0,0
"SUHEY",0,4,0,1,4,0,1,0,1
"SUJATHA",0,3,0,1,3,0,1,0,1
"SUMAIYA",0,4,0,1,4,0,1,0,1
"SUNDAR",3,0,1,0,3,1,0,1,0
"SUNEET",2,0,1,0,2,1,0,1,0
"SUNGHEE",1,2,.3333333,.6666667,3,0,0,0,0
"SUPREET",0,3,0,1,3,0,1,0,1
"SUREKHA",0,4,0,1,4,0,1,0,1
"SURINDER",2,1,.6666667,.3333333,3,0,0,0,0
"SYDNEE",1,3,.25,.75,4,0,0,0,0
"SYL",2,1,.6666667,.3333333,3,0,0,0,0
"TAG",6,0,1,0,6,1,0,1,0
"TAHLIA",0,5,0,1,5,0,1,0,1
"TAHNEE",0,4,0,1,4,0,1,0,1
"TAKAO",5,0,1,0,5,1,0,1,0
"TAKARA",0,2,0,1,2,0,1,0,1
"TAKUMI",3,1,.75,.25,4,0,0,0,0
"TALAYA",0,4,0,1,4,0,1,0,1
"TALITHA",0,4,0,1,4,0,1,0,1
"TALLI",1,2,.3333333,.6666667,3,0,0,0,0
"TAMALA",1,2,.3333333,.6666667,3,0,0,0,0
"TAMARRA",0,5,0,1,5,0,1,0,1
"TAMECA",0,5,0,1,5,0,1,0,1
"TAMEKIA",0,4,0,1,4,0,1,0,1
"TAMEL",5,0,1,0,5,1,0,1,0
"TAMIM",4,0,1,0,4,1,0,1,0
"TANASHA",0,2,0,1,2,0,1,0,1
"TANASIA",0,5,0,1,5,0,1,0,1
"TANAY",1,3,.25,.75,4,0,0,0,0
"TANZANIA",0,4,0,1,4,0,1,0,1
"TANZILA",0,2,0,1,2,0,1,0,1
"TARKAN",2,0,1,0,2,1,0,1,0
"TASFIA",0,2,0,1,2,0,1,0,1
"TASHARA",0,4,0,1,4,0,1,0,1
"TASHEKA",0,4,0,1,4,0,1,0,1
"TASHINA",0,5,0,1,5,0,1,0,1
"TATHIANA",0,2,0,1,2,0,1,0,1
"TAUNYA",0,4,0,1,4,0,1,0,1
"TAWNY",0,4,0,1,4,0,1,0,1
"TAYLA",0,4,0,1,4,0,1,0,1
"TEMUR",4,0,1,0,4,1,0,1,0
"TENILLE",0,4,0,1,4,0,1,0,1
"TEOFILO",5,0,1,0,5,1,0,1,0
"TERRAN",3,2,.6,.4,5,0,0,0,0
"TERRY-ANN",0,3,0,1,3,0,1,0,1
"TETSUYA",5,0,1,0,5,1,0,1,0
"TEVFIK",2,0,1,0,2,1,0,1,0
"THABO",2,1,.6666667,.3333333,3,0,0,0,0
"THATCHER",3,0,1,0,3,1,0,1,0
"THOMSON",2,1,.6666667,.3333333,3,0,0,0,0
"THONY",5,0,1,0,5,1,0,1,0
"THORSTEN",2,0,1,0,2,1,0,1,0
"THUPTEN",6,0,1,0,6,1,0,1,0
"THURMAN",2,1,.6666667,.3333333,3,0,0,0,0
"TIANI",0,4,0,1,4,0,1,0,1
"TICO",5,0,1,0,5,1,0,1,0
"TIE",2,1,.6666667,.3333333,3,0,0,0,0
"TIFFINI",0,4,0,1,4,0,1,0,1
"TIINA",0,5,0,1,5,0,1,0,1
"TIMI",1,3,.25,.75,4,0,0,0,0
"TINESHA",0,2,0,1,2,0,1,0,1
"TIRSO",3,0,1,0,3,1,0,1,0
"TO",2,2,.5,.5,4,0,0,0,0
"TOMIKO",0,2,0,1,2,0,1,0,1
"TONA",2,0,1,0,2,1,0,1,0
"TONINO",4,0,1,0,4,1,0,1,0
"TONITA",0,4,0,1,4,0,1,0,1
"TORBEN",5,0,1,0,5,1,0,1,0
"TORRIE",1,2,.3333333,.6666667,3,0,0,0,0
"TOSHIKO",0,3,0,1,3,0,1,0,1
"TOUSSAINT",4,0,1,0,4,1,0,1,0
"TOVE",0,4,0,1,4,0,1,0,1
"TOWANDA",0,3,0,1,3,0,1,0,1
"TOWANNA",0,5,0,1,5,0,1,0,1
"TOY",0,5,0,1,5,0,1,0,1
"TRAV",5,0,1,0,5,1,0,1,0
"TRECIA",0,2,0,1,2,0,1,0,1
"TRENA",0,2,0,1,2,0,1,0,1
"TREV",3,0,1,0,3,1,0,1,0
"TREVA",0,4,0,1,4,0,1,0,1
"TREVER",3,0,1,0,3,1,0,1,0
"TRIBECA",1,1,.5,.5,2,0,0,0,0
"TRISHIA",0,4,0,1,4,0,1,0,1
"TROI",2,1,.6666667,.3333333,3,0,0,0,0
"TRUONG",3,1,.75,.25,4,0,0,0,0
"TSANG",3,0,1,0,3,1,0,1,0
"TSUYOSHI",4,0,1,0,4,1,0,1,0
"TUESDAY",0,3,0,1,3,0,1,0,1
"TUHIN",2,0,1,0,2,1,0,1,0
"TULI",2,1,.6666667,.3333333,3,0,0,0,0
"TUNJI",5,0,1,0,5,1,0,1,0
"TURGUT",2,0,1,0,2,1,0,1,0
"TURI",2,2,.5,.5,4,0,0,0,0
"TUVIA",4,0,1,0,4,1,0,1,0
"TUYEN",1,1,.5,.5,2,0,0,0,0
"TYESE",0,3,0,1,3,0,1,0,1
"TYIESHA",0,2,0,1,2,0,1,0,1
"TYRELLE",5,0,1,0,5,1,0,1,0
"TYRIK",3,0,1,0,3,1,0,1,0
"TYSHA",0,4,0,1,4,0,1,0,1
"UJJWAL",3,0,1,0,3,1,0,1,0
"URA",4,1,.8,.2,5,1,0,0,0
"UTE",0,3,0,1,3,0,1,0,1
"UWE",6,0,1,0,6,1,0,1,0
"VAHID",3,0,1,0,3,1,0,1,0
"VALENE",0,5,0,1,5,0,1,0,1
"VALI",1,2,.3333333,.6666667,3,0,0,0,0
"VALRIE",0,6,0,1,6,0,1,0,1
"VAMSEE",4,0,1,0,4,1,0,1,0
"VARDA",0,3,0,1,3,0,1,0,1
"VARGAS",1,2,.3333333,.6666667,3,0,0,0,0
"VARGHESE",3,1,.75,.25,4,0,0,0,0
"VASHAWN",4,0,1,0,4,1,0,1,0
"VEERA",0,3,0,1,3,0,1,0,1
"VEHBI",5,0,1,0,5,1,0,1,0
"VELEZ",0,2,0,1,2,0,1,0,1
"VENISE",0,2,0,1,2,0,1,0,1
"VENITA",0,3,0,1,3,0,1,0,1
"VENKATESH",2,0,1,0,2,1,0,1,0
"VIANCA",0,2,0,1,2,0,1,0,1
"VIANNA",0,4,0,1,4,0,1,0,1
"VICKRAM",4,0,1,0,4,1,0,1,0
"VID",3,1,.75,.25,4,0,0,0,0
"VITOR",4,0,1,0,4,1,0,1,0
"VIVECA",0,3,0,1,3,0,1,0,1
"VLADO",3,0,1,0,3,1,0,1,0
"VLORA",0,3,0,1,3,0,1,0,1
"VOVA",4,0,1,0,4,1,0,1,0
"WAHEEDA",0,4,0,1,4,0,1,0,1
"WALI",2,0,1,0,2,1,0,1,0
"WALKIRIA",0,5,0,1,5,0,1,0,1
"WARDELL",4,0,1,0,4,1,0,1,0
"WAY",3,1,.75,.25,4,0,0,0,0
"WAYLAND",2,0,1,0,2,1,0,1,0
"WAYLON",3,0,1,0,3,1,0,1,0
"WELLS",3,1,.75,.25,4,0,0,0,0
"WILLAM",6,0,1,0,6,1,0,1,0
"WILMARIE",0,3,0,1,3,0,1,0,1
"WINCY",0,5,0,1,5,0,1,0,1
"WINONA",0,4,0,1,4,0,1,0,1
"WINSLOW",3,1,.75,.25,4,0,0,0,0
"WISE",2,2,.5,.5,4,0,0,0,0
"WLADIMIR",3,0,1,0,3,1,0,1,0
"WREN",1,2,.3333333,.6666667,3,0,0,0,0
"XAN",2,1,.6666667,.3333333,3,0,0,0,0
"XIAOLI",0,4,0,1,4,0,1,0,1
"XIAOMING",3,1,.75,.25,4,0,0,0,0
"XUN",2,1,.6666667,.3333333,3,0,0,0,0
"YADI",0,2,0,1,2,0,1,0,1
"YAFA",0,3,0,1,3,0,1,0,1
"YAMEL",1,4,.2,.8,5,0,1,0,0
"YAMIN",5,1,.8333333,.1666667,6,1,0,0,0
"YAMINI",0,3,0,1,3,0,1,0,1
"YANIK",3,2,.6,.4,5,0,0,0,0
"YANILL",0,3,0,1,3,0,1,0,1
"YANKEE",2,2,.5,.5,4,0,0,0,0
"YANKI",1,2,.3333333,.6666667,3,0,0,0,0
"YARDLEY",2,1,.6666667,.3333333,3,0,0,0,0
"YARIELA",0,3,0,1,3,0,1,0,1
"YASHICA",0,5,0,1,5,0,1,0,1
"YAU",1,2,.3333333,.6666667,3,0,0,0,0
"YAZ",2,1,.6666667,.3333333,3,0,0,0,0
"YAÄ_MUR",1,1,.5,.5,2,0,0,0,0
"YELIZ",1,3,.25,.75,4,0,0,0,0
"YEMISI",1,2,.3333333,.6666667,3,0,0,0,0
"YESI",0,5,0,1,5,0,1,0,1
"YESID",4,0,1,0,4,1,0,1,0
"YEUNG",3,1,.75,.25,4,0,0,0,0
"YEVA",0,3,0,1,3,0,1,0,1
"YINGYING",0,4,0,1,4,0,1,0,1
"YITZCHAK",4,0,1,0,4,1,0,1,0
"YODIT",0,3,0,1,3,0,1,0,1
"YOHANA",0,4,0,1,4,0,1,0,1
"YOHANNES",3,0,1,0,3,1,0,1,0
"YONETTE",0,4,0,1,4,0,1,0,1
"YOOMI",0,3,0,1,3,0,1,0,1
"YOSEPH",5,0,1,0,5,1,0,1,0
"YOVANI",2,2,.5,.5,4,0,0,0,0
"YOVANKA",0,2,0,1,2,0,1,0,1
"YRIS",0,4,0,1,4,0,1,0,1
"YUCEL",1,1,.5,.5,2,0,0,0,0
"YUKSEL",4,1,.8,.2,5,1,0,0,0
"YUL",2,1,.6666667,.3333333,3,0,0,0,0
"YULANDA",0,3,0,1,3,0,1,0,1
"YUNIOR",5,0,1,0,5,1,0,1,0
"YUSSEF",5,0,1,0,5,1,0,1,0
"YUYA",4,0,1,0,4,1,0,1,0
"YVE",0,3,0,1,3,0,1,0,1
"ZACHERY",5,0,1,0,5,1,0,1,0
"ZAL",3,0,1,0,3,1,0,1,0
"ZAMIR",5,0,1,0,5,1,0,1,0
"ZAMIRA",0,6,0,1,6,0,1,0,1
"ZARIA",0,4,0,1,4,0,1,0,1
"ZAW",5,0,1,0,5,1,0,1,0
"ZAY",3,1,.75,.25,4,0,0,0,0
"ZAYRA",0,5,0,1,5,0,1,0,1
"ZEENA",0,4,0,1,4,0,1,0,1
"ZEEV",3,0,1,0,3,1,0,1,0
"ZEHAVIT",0,2,0,1,2,0,1,0,1
"ZELIG",5,0,1,0,5,1,0,1,0
"ZENEIDA",0,2,0,1,2,0,1,0,1
"ZENY",0,3,0,1,3,0,1,0,1
"ZHUO",5,1,.8333333,.1666667,6,1,0,0,0
"ZO",2,1,.6666667,.3333333,3,0,0,0,0
"ZOIE",1,3,.25,.75,4,0,0,0,0
"ZORY",2,1,.6666667,.3333333,3,0,0,0,0
"ZSUZSA",0,2,0,1,2,0,1,0,1
"ZULY",0,4,0,1,4,0,1,0,1
"ZUNILDA",0,4,0,1,4,0,1,0,1
"AAISHA",0,2,0,1,2,0,1,0,1
"AAN",0,2,0,1,2,0,1,0,1
"AARTHI",0,4,0,1,4,0,1,0,1
"ABAYOMI",4,0,1,0,4,1,0,1,0
"ABDALLA",4,0,1,0,4,1,0,1,0
"ABDELRAHMAN",3,0,1,0,3,1,0,1,0
"ABDULLAHI",3,0,1,0,3,1,0,1,0
"ABIDA",0,2,0,1,2,0,1,0,1
"ABIEL",3,0,1,0,3,1,0,1,0
"ABIMAEL",3,0,1,0,3,1,0,1,0
"ADARSH",2,0,1,0,2,1,0,1,0
"ADELSO",3,0,1,0,3,1,0,1,0
"ADIB",4,0,1,0,4,1,0,1,0
"ADOLPH",4,0,1,0,4,1,0,1,0
"ADONIA",0,3,0,1,3,0,1,0,1
"AFRAZ",4,0,1,0,4,1,0,1,0
"AFSHEEN",1,2,.3333333,.6666667,3,0,0,0,0
"AFZAL",4,0,1,0,4,1,0,1,0
"AILENE",0,2,0,1,2,0,1,0,1
"AIM",3,1,.75,.25,4,0,0,0,0
"AITOR",3,0,1,0,3,1,0,1,0
"AJENE",3,1,.75,.25,4,0,0,0,0
"AKANKSHA",0,4,0,1,4,0,1,0,1
"AKINA",0,3,0,1,3,0,1,0,1
"AKITA",1,2,.3333333,.6666667,3,0,0,0,0
"AKM",5,0,1,0,5,1,0,1,0
"ALANZO",4,0,1,0,4,1,0,1,0
"ALARA",0,2,0,1,2,0,1,0,1
"ALBERTHA",0,3,0,1,3,0,1,0,1
"ALBIE",2,0,1,0,2,1,0,1,0
"ALBINO",4,0,1,0,4,1,0,1,0
"ALDI",4,0,1,0,4,1,0,1,0
"ALDWIN",3,0,1,0,3,1,0,1,0
"ALEJANDRINA",0,4,0,1,4,0,1,0,1
"ALENE",0,4,0,1,4,0,1,0,1
"ALESE",0,2,0,1,2,0,1,0,1
"ALETHA",0,2,0,1,2,0,1,0,1
"ALEVTINA",0,2,0,1,2,0,1,0,1
"ALEXANDRO",3,0,1,0,3,1,0,1,0
"ALEYDA",0,3,0,1,3,0,1,0,1
"ALFIO",5,0,1,0,5,1,0,1,0
"ALICA",0,4,0,1,4,0,1,0,1
"ALIEU",4,0,1,0,4,1,0,1,0
"ALIONA",0,4,0,1,4,0,1,0,1
"ALISHER",2,0,1,0,2,1,0,1,0
"ALISHIA",0,3,0,1,3,0,1,0,1
"ALIVIA",0,3,0,1,3,0,1,0,1
"ALIZAH",0,3,0,1,3,0,1,0,1
"ALKETA",0,2,0,1,2,0,1,0,1
"ALLE",1,2,.3333333,.6666667,3,0,0,0,0
"ALLEYNE",1,2,.3333333,.6666667,3,0,0,0,0
"ALLIAH",0,2,0,1,2,0,1,0,1
"ALLIYAH",0,2,0,1,2,0,1,0,1
"ALOYSIUS",3,0,1,0,3,1,0,1,0
"ALRICK",3,0,1,0,3,1,0,1,0
"ALVIS",3,0,1,0,3,1,0,1,0
"AMARACHI",0,4,0,1,4,0,1,0,1
"AMBERLY",0,3,0,1,3,0,1,0,1
"AMBRE",0,2,0,1,2,0,1,0,1
"AMEEN",3,0,1,0,3,1,0,1,0
"AMEN",4,1,.8,.2,5,1,0,0,0
"AMERIE",0,3,0,1,3,0,1,0,1
"AMEY",0,4,0,1,4,0,1,0,1
"AMINU",4,0,1,0,4,1,0,1,0
"AMON",3,0,1,0,3,1,0,1,0
"AMRAM",3,0,1,0,3,1,0,1,0
"AMRO",2,0,1,0,2,1,0,1,0
"AMRUTA",0,3,0,1,3,0,1,0,1
"AMYN",2,0,1,0,2,1,0,1,0
"ANABELA",0,2,0,1,2,0,1,0,1
"ANAISE",0,3,0,1,3,0,1,0,1
"ANAN",1,1,.5,.5,2,0,0,0,0
"ANDER",1,1,.5,.5,2,0,0,0,0
"ANDONI",3,0,1,0,3,1,0,1,0
"ANDRESSA",0,4,0,1,4,0,1,0,1
"ANDRIUS",3,0,1,0,3,1,0,1,0
"ANEES",2,0,1,0,2,1,0,1,0
"ANEUDI",4,0,1,0,4,1,0,1,0
"ANICE",0,3,0,1,3,0,1,0,1
"ANIEL",2,0,1,0,2,1,0,1,0
"ANIRUDH",5,0,1,0,5,1,0,1,0
"ANNA-LENA",0,3,0,1,3,0,1,0,1
"ANNALIESE",0,2,0,1,2,0,1,0,1
"ANNAROSE",0,2,0,1,2,0,1,0,1
"ANNELLE",0,2,0,1,2,0,1,0,1
"ANNIS",0,4,0,1,4,0,1,0,1
"ANTHI",0,2,0,1,2,0,1,0,1
"ANTHON",4,0,1,0,4,1,0,1,0
"ANTHONIA",0,2,0,1,2,0,1,0,1
"ANTONE",2,0,1,0,2,1,0,1,0
"ANTONETA",0,3,0,1,3,0,1,0,1
"ANTONI",4,0,1,0,4,1,0,1,0
"ANTONIETA",0,4,0,1,4,0,1,0,1
"ANUBHAV",4,0,1,0,4,1,0,1,0
"ANUPA",0,2,0,1,2,0,1,0,1
"ANUSH",2,1,.6666667,.3333333,3,0,0,0,0
"ANUSHREE",0,3,0,1,3,0,1,0,1
"ANYELINA",0,2,0,1,2,0,1,0,1
"ANYELO",4,0,1,0,4,1,0,1,0
"APOORVA",3,0,1,0,3,1,0,1,0
"APOSTLE",3,0,1,0,3,1,0,1,0
"APRILLE",0,2,0,1,2,0,1,0,1
"AQIB",2,0,1,0,2,1,0,1,0
"AQILA",0,3,0,1,3,0,1,0,1
"AQUA",1,1,.5,.5,2,0,0,0,0
"AQUILES",3,0,1,0,3,1,0,1,0
"ARABIA",0,3,0,1,3,0,1,0,1
"ARALIS",0,5,0,1,5,0,1,0,1
"ARAN",4,0,1,0,4,1,0,1,0
"ARCHER",3,0,1,0,3,1,0,1,0
"ARIEF",5,0,1,0,5,1,0,1,0
"ARIKA",0,4,0,1,4,0,1,0,1
"ARION",2,0,1,0,2,1,0,1,0
"ARISLEYDA",0,5,0,1,5,0,1,0,1
"ARISMENDY",3,0,1,0,3,1,0,1,0
"ARJAY",3,0,1,0,3,1,0,1,0
"ARJETA",0,2,0,1,2,0,1,0,1
"ARJUNA",4,0,1,0,4,1,0,1,0
"ARLEIGH",0,2,0,1,2,0,1,0,1
"ARLIND",3,0,1,0,3,1,0,1,0
"ARMON",3,0,1,0,3,1,0,1,0
"ARMSTRONG",2,1,.6666667,.3333333,3,0,0,0,0
"ARSENE",3,0,1,0,3,1,0,1,0
"ASEL",0,2,0,1,2,0,1,0,1
"ASHELEY",0,3,0,1,3,0,1,0,1
"ASHI",1,2,.3333333,.6666667,3,0,0,0,0
"ASHKAN",3,0,1,0,3,1,0,1,0
"ASHRAFUL",2,0,1,0,2,1,0,1,0
"ASIYAH",0,4,0,1,4,0,1,0,1
"ASKIA",2,0,1,0,2,1,0,1,0
"ASPEN",2,2,.5,.5,4,0,0,0,0
"ASRA",0,2,0,1,2,0,1,0,1
"ASSA",1,3,.25,.75,4,0,0,0,0
"ASSANE",2,0,1,0,2,1,0,1,0
"ASTER",0,3,0,1,3,0,1,0,1
"ASTRA",0,2,0,1,2,0,1,0,1
"ASTRIDE",0,2,0,1,2,0,1,0,1
"ATHANASIA",0,2,0,1,2,0,1,0,1
"ATTA",3,1,.75,.25,4,0,0,0,0
"AUDLEY",2,0,1,0,2,1,0,1,0
"AUDREA",0,4,0,1,4,0,1,0,1
"AUGUSTINO",4,0,1,0,4,1,0,1,0
"AUN",3,1,.75,.25,4,0,0,0,0
"AURI",2,2,.5,.5,4,0,0,0,0
"AURIA",0,3,0,1,3,0,1,0,1
"AVERILL",3,1,.75,.25,4,0,0,0,0
"AVIAN",2,1,.6666667,.3333333,3,0,0,0,0
"AVIGAYIL",0,2,0,1,2,0,1,0,1
"AVIK",2,0,1,0,2,1,0,1,0
"AVY",2,0,1,0,2,1,0,1,0
"AYN",0,2,0,1,2,0,1,0,1
"AYNSLEY",0,3,0,1,3,0,1,0,1
"AYOKA",0,3,0,1,3,0,1,0,1
"AYSEL",0,4,0,1,4,0,1,0,1
"AZAR",2,2,.5,.5,4,0,0,0,0
"AZEEZ",4,0,1,0,4,1,0,1,0
"AZIZI",1,4,.2,.8,5,0,1,0,0
"AZUL",0,4,0,1,4,0,1,0,1
"BABAJIDE",3,0,1,0,3,1,0,1,0
"BABI",1,1,.5,.5,2,0,0,0,0
"BACH",3,0,1,0,3,1,0,1,0
"BACHIR",3,0,1,0,3,1,0,1,0
"BADD",0,2,0,1,2,0,1,0,1
"BAJRAM",3,0,1,0,3,1,0,1,0
"BALAZS",3,0,1,0,3,1,0,1,0
"BALJIT",2,1,.6666667,.3333333,3,0,0,0,0
"BALOGUN",4,1,.8,.2,5,1,0,0,0
"BANA",0,3,0,1,3,0,1,0,1
"BANE",4,0,1,0,4,1,0,1,0
"BANI",2,1,.6666667,.3333333,3,0,0,0,0
"BARACK",3,0,1,0,3,1,0,1,0
"BARBAROS",2,0,1,0,2,1,0,1,0
"BARNES",2,1,.6666667,.3333333,3,0,0,0,0
"BASEL",2,0,1,0,2,1,0,1,0
"BASH",2,0,1,0,2,1,0,1,0
"BAT",3,1,.75,.25,4,0,0,0,0
"BATTLE",2,2,.5,.5,4,0,0,0,0
"BAYRON",3,0,1,0,3,1,0,1,0
"BEAUTIFULL",0,3,0,1,3,0,1,0,1
"BEENISH",0,2,0,1,2,0,1,0,1
"BEGUM",0,2,0,1,2,0,1,0,1
"BELISSA",0,2,0,1,2,0,1,0,1
"BENIGNO",3,0,1,0,3,1,0,1,0
"BENTZI",2,0,1,0,2,1,0,1,0
"BENZION",3,0,1,0,3,1,0,1,0
"BEPPE",4,0,1,0,4,1,0,1,0
"BERLINDA",0,2,0,1,2,0,1,0,1
"BERTHE",0,5,0,1,5,0,1,0,1
"BERTIE",2,1,.6666667,.3333333,3,0,0,0,0
"BERTINA",0,2,0,1,2,0,1,0,1
"BETZY",1,4,.2,.8,5,0,1,0,0
"BHARGAV",2,0,1,0,2,1,0,1,0
"BHASKAR",3,0,1,0,3,1,0,1,0
"BHAVIK",2,0,1,0,2,1,0,1,0
"BIEN",1,3,.25,.75,4,0,0,0,0
"BIFF",2,0,1,0,2,1,0,1,0
"BIGGS",4,0,1,0,4,1,0,1,0
"BIKE",2,1,.6666667,.3333333,3,0,0,0,0
"BILGE",1,1,.5,.5,2,0,0,0,0
"BINDI",0,2,0,1,2,0,1,0,1
"BIPIN",4,0,1,0,4,1,0,1,0
"BIRGITTA",0,2,0,1,2,0,1,0,1
"BITSY",0,3,0,1,3,0,1,0,1
"BLAKELY",1,1,.5,.5,2,0,0,0,0
"BLANKA",0,3,0,1,3,0,1,0,1
"BLESSED",2,0,1,0,2,1,0,1,0
"BLESSEN",2,0,1,0,2,1,0,1,0
"BOEY",1,3,.25,.75,4,0,0,0,0
"BOHDAN",4,0,1,0,4,1,0,1,0
"BONES",3,0,1,0,3,1,0,1,0
"BOOK",3,1,.75,.25,4,0,0,0,0
"BOOKER",1,1,.5,.5,2,0,0,0,0
"BOOTS",4,1,.8,.2,5,1,0,0,0
"BORNA",3,0,1,0,3,1,0,1,0
"BOSE",0,3,0,1,3,0,1,0,1
"BOUBA",3,0,1,0,3,1,0,1,0
"BOWIE",2,1,.6666667,.3333333,3,0,0,0,0
"BOYAN",3,0,1,0,3,1,0,1,0
"BOZHENA",0,2,0,1,2,0,1,0,1
"BRAND",4,0,1,0,4,1,0,1,0
"BRAXTON",2,0,1,0,2,1,0,1,0
"BREA",0,3,0,1,3,0,1,0,1
"BREAK",2,0,1,0,2,1,0,1,0
"BREENA",0,2,0,1,2,0,1,0,1
"BREEZE",2,2,.5,.5,4,0,0,0,0
"BRETTE",0,2,0,1,2,0,1,0,1
"BRISA",0,3,0,1,3,0,1,0,1
"BRITTNAY",0,3,0,1,3,0,1,0,1
"BUMPY",3,0,1,0,3,1,0,1,0
"BUN",2,1,.6666667,.3333333,3,0,0,0,0
"BUTLER",3,1,.75,.25,4,0,0,0,0
"BUZ",4,0,1,0,4,1,0,1,0
"BYRNE",2,0,1,0,2,1,0,1,0
"CAGLAR",4,0,1,0,4,1,0,1,0
"CALEIGH",0,3,0,1,3,0,1,0,1
"CALEN",3,0,1,0,3,1,0,1,0
"CALLE",2,0,1,0,2,1,0,1,0
"CALLY",0,3,0,1,3,0,1,0,1
"CAMAY",0,2,0,1,2,0,1,0,1
"CANDECE",0,4,0,1,4,0,1,0,1
"CAP",2,1,.6666667,.3333333,3,0,0,0,0
"CARLES",2,1,.6666667,.3333333,3,0,0,0,0
"CARLETON",5,0,1,0,5,1,0,1,0
"CARMAN",0,2,0,1,2,0,1,0,1
"CARMI",4,0,1,0,4,1,0,1,0
"CARMITA",0,3,0,1,3,0,1,0,1
"CARNELL",4,0,1,0,4,1,0,1,0
"CAROLANNE",0,4,0,1,4,0,1,0,1
"CAROLYNNE",0,3,0,1,3,0,1,0,1
"CARTIER",2,2,.5,.5,4,0,0,0,0
"CASA",1,2,.3333333,.6666667,3,0,0,0,0
"CATINA",0,4,0,1,4,0,1,0,1
"CATO",2,0,1,0,2,1,0,1,0
"CATT",2,1,.6666667,.3333333,3,0,0,0,0
"CAVAN",3,1,.75,.25,4,0,0,0,0
"CAVEL",0,2,0,1,2,0,1,0,1
"CECILLE",0,4,0,1,4,0,1,0,1
"CEECEE",0,3,0,1,3,0,1,0,1
"CELAL",5,0,1,0,5,1,0,1,0
"CELY",0,2,0,1,2,0,1,0,1
"CEMAL",5,0,1,0,5,1,0,1,0
"CHACE",5,0,1,0,5,1,0,1,0
"CHANEQUA",0,3,0,1,3,0,1,0,1
"CHANEY",2,0,1,0,2,1,0,1,0
"CHANNON",0,2,0,1,2,0,1,0,1
"CHANNY",1,1,.5,.5,2,0,0,0,0
"CHAPIN",2,0,1,0,2,1,0,1,0
"CHARI",0,2,0,1,2,0,1,0,1
"CHARMIAN",0,2,0,1,2,0,1,0,1
"CHARMING",2,1,.6666667,.3333333,3,0,0,0,0
"CHASIDY",0,5,0,1,5,0,1,0,1
"CHAUNTE",0,3,0,1,3,0,1,0,1
"CHEECH",3,0,1,0,3,1,0,1,0
"CHEL",0,3,0,1,3,0,1,0,1
"CHELE",0,2,0,1,2,0,1,0,1
"CHELO",2,0,1,0,2,1,0,1,0
"CHENOA",0,2,0,1,2,0,1,0,1
"CHERITA",0,3,0,1,3,0,1,0,1
"CHERON",1,3,.25,.75,4,0,0,0,0
"CHERRON",1,2,.3333333,.6666667,3,0,0,0,0
"CHEVONE",0,3,0,1,3,0,1,0,1
"CHEYANNE",0,2,0,1,2,0,1,0,1
"CHEZKY",4,0,1,0,4,1,0,1,0
"CHHAVI",0,2,0,1,2,0,1,0,1
"CHIDI",3,1,.75,.25,4,0,0,0,0
"CHIH",2,2,.5,.5,4,0,0,0,0
"CHILDREN",1,1,.5,.5,2,0,0,0,0
"CHIMA",4,0,1,0,4,1,0,1,0
"CHIME",0,4,0,1,4,0,1,0,1
"CHINATSU",0,4,0,1,4,0,1,0,1
"CHINELLE",0,3,0,1,3,0,1,0,1
"CHINELO",2,1,.6666667,.3333333,3,0,0,0,0
"CHINENYE",1,2,.3333333,.6666667,3,0,0,0,0
"CHIVON",1,3,.25,.75,4,0,0,0,0
"CHRISOULA",0,2,0,1,2,0,1,0,1
"CHRISTAN",0,2,0,1,2,0,1,0,1
"CHRISTENA",0,4,0,1,4,0,1,0,1
"CHRISTOFFER",2,0,1,0,2,1,0,1,0
"CHRISTOPER",5,0,1,0,5,1,0,1,0
"CHRIZ",2,0,1,0,2,1,0,1,0
"CHULA",1,3,.25,.75,4,0,0,0,0
"CIARRA",0,2,0,1,2,0,1,0,1
"CINDERELLA",0,3,0,1,3,0,1,0,1
"CINDIA",0,4,0,1,4,0,1,0,1
"CIRCLE",2,2,.5,.5,4,0,0,0,0
"CLAES",3,0,1,0,3,1,0,1,0
"CLARITZA",0,4,0,1,4,0,1,0,1
"CLARY",0,4,0,1,4,0,1,0,1
"CLAUDY",2,3,.4,.6,5,0,0,0,0
"CLOSET",1,3,.25,.75,4,0,0,0,0
"COBBY",3,0,1,0,3,1,0,1,0
"COLINE",1,2,.3333333,.6666667,3,0,0,0,0
"COLVIN",3,0,1,0,3,1,0,1,0
"CONEY",1,2,.3333333,.6666667,3,0,0,0,0
"CONSUELA",0,2,0,1,2,0,1,0,1
"COOK",3,1,.75,.25,4,0,0,0,0
"CORDEL",2,0,1,0,2,1,0,1,0
"CORRINNE",0,2,0,1,2,0,1,0,1
"COTY",2,1,.6666667,.3333333,3,0,0,0,0
"COY",4,1,.8,.2,5,1,0,0,0
"CRISSIE",0,2,0,1,2,0,1,0,1
"CROMWELL",2,0,1,0,2,1,0,1,0
"CRYS",0,3,0,1,3,0,1,0,1
"CRYSTLE",0,3,0,1,3,0,1,0,1
"CURLENE",0,5,0,1,5,0,1,0,1
"CUSTOM",3,1,.75,.25,4,0,0,0,0
"CYAN",0,2,0,1,2,0,1,0,1
"CYNARA",0,4,0,1,4,0,1,0,1
"DAFNE",0,3,0,1,3,0,1,0,1
"DAICHI",2,0,1,0,2,1,0,1,0
"DAINTY",0,4,0,1,4,0,1,0,1
"DAIQUAN",4,0,1,0,4,1,0,1,0
"DALIDA",0,3,0,1,3,0,1,0,1
"DALILAH",0,3,0,1,3,0,1,0,1
"DALISA",0,5,0,1,5,0,1,0,1
"DAMEIN",3,0,1,0,3,1,0,1,0
"DANASIA",0,3,0,1,3,0,1,0,1
"DANELLA",0,2,0,1,2,0,1,0,1
"DANIAL",4,0,1,0,4,1,0,1,0
"DANIELL",1,1,.5,.5,2,0,0,0,0
"DANIL",3,0,1,0,3,1,0,1,0
"DANILA",0,3,0,1,3,0,1,0,1
"DANINE",0,3,0,1,3,0,1,0,1
"DANIS",2,0,1,0,2,1,0,1,0
"DANIXA",0,3,0,1,3,0,1,0,1
"DANYELL",0,2,0,1,2,0,1,0,1
"DAOUDA",2,0,1,0,2,1,0,1,0
"DAPO",2,0,1,0,2,1,0,1,0
"DARAH",0,3,0,1,3,0,1,0,1
"DARCELLE",0,2,0,1,2,0,1,0,1
"DARLENY",0,4,0,1,4,0,1,0,1
"DARRIEL",2,1,.6666667,.3333333,3,0,0,0,0
"DARRIEN",2,0,1,0,2,1,0,1,0
"DARRION",3,0,1,0,3,1,0,1,0
"DARRYN",3,0,1,0,3,1,0,1,0
"DASHON",4,1,.8,.2,5,1,0,0,0
"DAT",4,0,1,0,4,1,0,1,0
"DAVAUGHN",4,0,1,0,4,1,0,1,0
"DAVENA",0,3,0,1,3,0,1,0,1
"DEANO",3,0,1,0,3,1,0,1,0
"DEBJANI",0,3,0,1,3,0,1,0,1
"DEEN",2,0,1,0,2,1,0,1,0
"DEFNE",0,2,0,1,2,0,1,0,1
"DEIGHTON",3,0,1,0,3,1,0,1,0
"DEJUAN",4,1,.8,.2,5,1,0,0,0
"DELA",2,0,1,0,2,1,0,1,0
"DELAINA",0,4,0,1,4,0,1,0,1
"DELANA",0,3,0,1,3,0,1,0,1
"DELMY",0,3,0,1,3,0,1,0,1
"DEMETRICE",1,2,.3333333,.6666667,3,0,0,0,0
"DENARD",2,1,.6666667,.3333333,3,0,0,0,0
"DENE",1,3,.25,.75,4,0,0,0,0
"DENINE",0,2,0,1,2,0,1,0,1
"DENMARK",4,0,1,0,4,1,0,1,0
"DENNISON",4,1,.8,.2,5,1,0,0,0
"DERRYCK",4,0,1,0,4,1,0,1,0
"DESSY",1,1,.5,.5,2,0,0,0,0
"DESTIN",2,1,.6666667,.3333333,3,0,0,0,0
"DEVANG",3,0,1,0,3,1,0,1,0
"DEVITA",0,2,0,1,2,0,1,0,1
"DEVONE",4,0,1,0,4,1,0,1,0
"DEVRON",4,0,1,0,4,1,0,1,0
"DEWITT",3,0,1,0,3,1,0,1,0
"DIAS",3,0,1,0,3,1,0,1,0
"DICKY",5,0,1,0,5,1,0,1,0
"DIEM",1,1,.5,.5,2,0,0,0,0
"DIEN",1,2,.3333333,.6666667,3,0,0,0,0
"DIERDRE",0,3,0,1,3,0,1,0,1
"DIESEL",2,1,.6666667,.3333333,3,0,0,0,0
"DIETMAR",4,0,1,0,4,1,0,1,0
"DILLY",1,3,.25,.75,4,0,0,0,0
"DIMI",1,1,.5,.5,2,0,0,0,0
"DIPAL",3,0,1,0,3,1,0,1,0
"DIPESH",2,0,1,0,2,1,0,1,0
"DISHA",0,3,0,1,3,0,1,0,1
"DIVA",0,3,0,1,3,0,1,0,1
"DJAMEL",3,0,1,0,3,1,0,1,0
"DJIBRIL",5,0,1,0,5,1,0,1,0
"DOCK",4,0,1,0,4,1,0,1,0
"DOLMA",0,4,0,1,4,0,1,0,1
"DOMINO",2,2,.5,.5,4,0,0,0,0
"DOMINQUE",1,2,.3333333,.6666667,3,0,0,0,0
"DONELLE",2,3,.4,.6,5,0,0,0,0
"DONIEL",4,0,1,0,4,1,0,1,0
"DONIKA",0,2,0,1,2,0,1,0,1
"DONNEL",2,1,.6666667,.3333333,3,0,0,0,0
"DONNI",2,0,1,0,2,1,0,1,0
"DORCA",0,5,0,1,5,0,1,0,1
"DOREE",0,3,0,1,3,0,1,0,1
"DORIANN",0,2,0,1,2,0,1,0,1
"DORINE",0,3,0,1,3,0,1,0,1
"DORITA",0,4,0,1,4,0,1,0,1
"DOTAN",2,0,1,0,2,1,0,1,0
"DOUBLE",2,0,1,0,2,1,0,1,0
"DREN",2,0,1,0,2,1,0,1,0
"DREXEL",4,0,1,0,4,1,0,1,0
"DRISS",3,0,1,0,3,1,0,1,0
"DRUM",3,0,1,0,3,1,0,1,0
"DSA",3,1,.75,.25,4,0,0,0,0
"DUCE",4,0,1,0,4,1,0,1,0
"DUDI",4,0,1,0,4,1,0,1,0
"DUNBAR",2,0,1,0,2,1,0,1,0
"DUONG",1,1,.5,.5,2,0,0,0,0
"DURAND",3,0,1,0,3,1,0,1,0
"DUSHAN",2,0,1,0,2,1,0,1,0
"DUVID",2,0,1,0,2,1,0,1,0
"DUY",2,0,1,0,2,1,0,1,0
"DYON",3,1,.75,.25,4,0,0,0,0
"EARLY",2,0,1,0,2,1,0,1,0
"EASTER",1,1,.5,.5,2,0,0,0,0
"EBONEY",0,5,0,1,5,0,1,0,1
"EDIS",3,0,1,0,3,1,0,1,0
"EDISSON",4,0,1,0,4,1,0,1,0
"EDITHA",0,2,0,1,2,0,1,0,1
"EDLIN",1,1,.5,.5,2,0,0,0,0
"EDRIS",2,2,.5,.5,4,0,0,0,0
"EDVARD",3,0,1,0,3,1,0,1,0
"EDVIN",5,0,1,0,5,1,0,1,0
"EDWING",3,0,1,0,3,1,0,1,0
"EDYTHE",0,5,0,1,5,0,1,0,1
"EGBERT",3,0,1,0,3,1,0,1,0
"EIKO",0,2,0,1,2,0,1,0,1
"EKA",0,3,0,1,3,0,1,0,1
"EKOW",3,0,1,0,3,1,0,1,0
"ELEFTHERIA",0,2,0,1,2,0,1,0,1
"ELENY",0,2,0,1,2,0,1,0,1
"ELIAH",2,0,1,0,2,1,0,1,0
"ELIEL",4,0,1,0,4,1,0,1,0
"ELIGIO",4,0,1,0,4,1,0,1,0
"ELITE",0,3,0,1,3,0,1,0,1
"ELLICE",1,3,.25,.75,4,0,0,0,0
"ELLIN",0,2,0,1,2,0,1,0,1
"ELLISE",0,3,0,1,3,0,1,0,1
"ELVI",1,2,.3333333,.6666667,3,0,0,0,0
"ELVIE",0,4,0,1,4,0,1,0,1
"ELVIO",3,0,1,0,3,1,0,1,0
"EMER",1,2,.3333333,.6666667,3,0,0,0,0
"EMIE",0,2,0,1,2,0,1,0,1
"EMILLY",0,3,0,1,3,0,1,0,1
"EMMI",0,3,0,1,3,0,1,0,1
"ENDA",2,0,1,0,2,1,0,1,0
"ENDRI",2,0,1,0,2,1,0,1,0
"ENGEL",2,0,1,0,2,1,0,1,0
"ENGELBERT",3,0,1,0,3,1,0,1,0
"ENGLISH",2,2,.5,.5,4,0,0,0,0
"ENKELEJDA",0,4,0,1,4,0,1,0,1
"ENNIS",2,0,1,0,2,1,0,1,0
"ENOC",3,0,1,0,3,1,0,1,0
"ENOCK",3,0,1,0,3,1,0,1,0
"ENTELA",0,3,0,1,3,0,1,0,1
"EPIC",3,0,1,0,3,1,0,1,0
"ERDINC",2,0,1,0,2,1,0,1,0
"EREK",4,0,1,0,4,1,0,1,0
"ERICCA",0,3,0,1,3,0,1,0,1
"ERIKKA",0,2,0,1,2,0,1,0,1
"ERJON",3,0,1,0,3,1,0,1,0
"ERKIN",2,0,1,0,2,1,0,1,0
"ERLIN",1,1,.5,.5,2,0,0,0,0
"ERMAN",2,0,1,0,2,1,0,1,0
"ERMIR",4,0,1,0,4,1,0,1,0
"ERN",2,0,1,0,2,1,0,1,0
"ERSAN",2,0,1,0,2,1,0,1,0
"ERSKINE",3,0,1,0,3,1,0,1,0
"ERUM",0,3,0,1,3,0,1,0,1
"ESA",1,1,.5,.5,2,0,0,0,0
"ESE",0,2,0,1,2,0,1,0,1
"ESEN",1,1,.5,.5,2,0,0,0,0
"ESHE",0,4,0,1,4,0,1,0,1
"ESI",0,3,0,1,3,0,1,0,1
"ESTEVAN",4,0,1,0,4,1,0,1,0
"ETA",0,2,0,1,2,0,1,0,1
"ETON",3,0,1,0,3,1,0,1,0
"EUAN",2,0,1,0,2,1,0,1,0
"EUNJIN",0,3,0,1,3,0,1,0,1
"EUPHEMIA",0,2,0,1,2,0,1,0,1
"EVELIO",3,0,1,0,3,1,0,1,0
"EVERALD",2,0,1,0,2,1,0,1,0
"EVEY",0,4,0,1,4,0,1,0,1
"EVGENIY",3,0,1,0,3,1,0,1,0
"EWEN",3,1,.75,.25,4,0,0,0,0
"EX",3,1,.75,.25,4,0,0,0,0
"EYE",0,2,0,1,2,0,1,0,1
"FABI",1,1,.5,.5,2,0,0,0,0
"FABIANO",5,0,1,0,5,1,0,1,0
"FABY",2,1,.6666667,.3333333,3,0,0,0,0
"FAHIMA",0,2,0,1,2,0,1,0,1
"FAIGE",0,2,0,1,2,0,1,0,1
"FANI",0,3,0,1,3,0,1,0,1
"FAREN",1,3,.25,.75,4,0,0,0,0
"FARIN",0,2,0,1,2,0,1,0,1
"FARRIS",5,0,1,0,5,1,0,1,0
"FARYAL",0,3,0,1,3,0,1,0,1
"FATAL",1,3,.25,.75,4,0,0,0,0
"FATE",2,2,.5,.5,4,0,0,0,0
"FATON",4,0,1,0,4,1,0,1,0
"FAYNA",0,2,0,1,2,0,1,0,1
"FAZEELA",0,3,0,1,3,0,1,0,1
"FEIFEI",0,4,0,1,4,0,1,0,1
"FERAS",4,0,1,0,4,1,0,1,0
"FIN",1,1,.5,.5,2,0,0,0,0
"FINBAR",3,0,1,0,3,1,0,1,0
"FINE",2,0,1,0,2,1,0,1,0
"FIRAT",3,0,1,0,3,1,0,1,0
"FLEMMING",3,1,.75,.25,4,0,0,0,0
"FLORIE",0,3,0,1,3,0,1,0,1
"FLORINE",0,3,0,1,3,0,1,0,1
"FONTAINE",1,1,.5,.5,2,0,0,0,0
"FOO",2,1,.6666667,.3333333,3,0,0,0,0
"FOREX",3,1,.75,.25,4,0,0,0,0
"FOZIA",0,3,0,1,3,0,1,0,1
"FRANCENE",0,3,0,1,3,0,1,0,1
"FRANKE",2,0,1,0,2,1,0,1,0
"FRANS",4,0,1,0,4,1,0,1,0
"FULYA",0,3,0,1,3,0,1,0,1
"GAETAN",3,0,1,0,3,1,0,1,0
"GAETANE",0,2,0,1,2,0,1,0,1
"GAIRY",2,0,1,0,2,1,0,1,0
"GARO",2,0,1,0,2,1,0,1,0
"GATES",3,0,1,0,3,1,0,1,0
"GAYLORD",3,0,1,0,3,1,0,1,0
"GAZMEND",5,0,1,0,5,1,0,1,0
"GEAN",2,2,.5,.5,4,0,0,0,0
"GEETIKA",0,2,0,1,2,0,1,0,1
"GEGE",1,1,.5,.5,2,0,0,0,0
"GEMINI",0,3,0,1,3,0,1,0,1
"GENCO",3,1,.75,.25,4,0,0,0,0
"GENEA",0,4,0,1,4,0,1,0,1
"GENELL",0,4,0,1,4,0,1,0,1
"GENGHIS",2,0,1,0,2,1,0,1,0
"GENT",2,0,1,0,2,1,0,1,0
"GEORDIE",3,0,1,0,3,1,0,1,0
"GERA",2,1,.6666667,.3333333,3,0,0,0,0
"GERSHOM",3,0,1,0,3,1,0,1,0
"GHAZAL",1,1,.5,.5,2,0,0,0,0
"GIANPAOLO",2,0,1,0,2,1,0,1,0
"GILLY",0,2,0,1,2,0,1,0,1
"GILMA",1,2,.3333333,.6666667,3,0,0,0,0
"GJERGJ",3,0,1,0,3,1,0,1,0
"GJERGJI",2,0,1,0,2,1,0,1,0
"GJON",2,0,1,0,2,1,0,1,0
"GLYNN",1,1,.5,.5,2,0,0,0,0
"GMONEY",3,0,1,0,3,1,0,1,0
"GODFRED",3,0,1,0,3,1,0,1,0
"GOLAM",4,0,1,0,4,1,0,1,0
"GOLDBERG",3,0,1,0,3,1,0,1,0
"GOT",1,2,.3333333,.6666667,3,0,0,0,0
"GOTTI",4,0,1,0,4,1,0,1,0
"GRETEL",0,4,0,1,4,0,1,0,1
"GRIER",2,0,1,0,2,1,0,1,0
"GRIFF",3,0,1,0,3,1,0,1,0
"GRISHA",4,1,.8,.2,5,1,0,0,0
"GRO",1,2,.3333333,.6666667,3,0,0,0,0
"GUAN",2,0,1,0,2,1,0,1,0
"GUDRUN",0,5,0,1,5,0,1,0,1
"GUILLE",2,0,1,0,2,1,0,1,0
"GUIRLAINE",0,4,0,1,4,0,1,0,1
"GUISELLA",0,5,0,1,5,0,1,0,1
"GULSUM",0,3,0,1,3,0,1,0,1
"GURKAN",3,0,1,0,3,1,0,1,0
"GURU",4,0,1,0,4,1,0,1,0
"GWYN",0,3,0,1,3,0,1,0,1
"GZIM",4,0,1,0,4,1,0,1,0
"HABTE",3,0,1,0,3,1,0,1,0
"HADIYAH",0,2,0,1,2,0,1,0,1
"HADRIEN",2,0,1,0,2,1,0,1,0
"HAGEN",3,1,.75,.25,4,0,0,0,0
"HAGER",0,3,0,1,3,0,1,0,1
"HAIDEE",0,2,0,1,2,0,1,0,1
"HAIDY",0,2,0,1,2,0,1,0,1
"HALIE",0,4,0,1,4,0,1,0,1
"HAMDY",4,0,1,0,4,1,0,1,0
"HANIFA",0,4,0,1,4,0,1,0,1
"HANKY",4,0,1,0,4,1,0,1,0
"HANNI",1,2,.3333333,.6666667,3,0,0,0,0
"HARAN",1,1,.5,.5,2,0,0,0,0
"HARDEEP",2,0,1,0,2,1,0,1,0
"HARINDER",2,0,1,0,2,1,0,1,0
"HARINI",0,4,0,1,4,0,1,0,1
"HARLEEN",0,2,0,1,2,0,1,0,1
"HARLIN",1,1,.5,.5,2,0,0,0,0
"HARMINDER",2,0,1,0,2,1,0,1,0
"HARMON",3,0,1,0,3,1,0,1,0
"HAROUT",2,0,1,0,2,1,0,1,0
"HASHEM",2,0,1,0,2,1,0,1,0
"HATIM",3,0,1,0,3,1,0,1,0
"HAVIER",4,0,1,0,4,1,0,1,0
"HAYLIE",0,3,0,1,3,0,1,0,1
"HEAD",2,0,1,0,2,1,0,1,0
"HEIKO",2,0,1,0,2,1,0,1,0
"HELLA",0,4,0,1,4,0,1,0,1
"HENDRY",5,0,1,0,5,1,0,1,0
"HENOK",3,0,1,0,3,1,0,1,0
"HER",1,2,.3333333,.6666667,3,0,0,0,0
"HERA",1,1,.5,.5,2,0,0,0,0
"HERO",4,0,1,0,4,1,0,1,0
"HERSON",4,0,1,0,4,1,0,1,0
"HERU",5,0,1,0,5,1,0,1,0
"HERY",2,0,1,0,2,1,0,1,0
"HI",3,0,1,0,3,1,0,1,0
"HICHEM",4,0,1,0,4,1,0,1,0
"HIDEKO",0,3,0,1,3,0,1,0,1
"HIROAKI",3,0,1,0,3,1,0,1,0
"HITEN",4,0,1,0,4,1,0,1,0
"HOLMAN",2,0,1,0,2,1,0,1,0
"HOMERO",4,0,1,0,4,1,0,1,0
"HONDA",2,1,.6666667,.3333333,3,0,0,0,0
"HOW",2,0,1,0,2,1,0,1,0
"HOYT",3,0,1,0,3,1,0,1,0
"HSIAO",1,1,.5,.5,2,0,0,0,0
"HSU",1,2,.3333333,.6666667,3,0,0,0,0
"HU",1,1,.5,.5,2,0,0,0,0
"HUDI",1,1,.5,.5,2,0,0,0,0
"HUDY",0,2,0,1,2,0,1,0,1
"HUGHES",3,1,.75,.25,4,0,0,0,0
"HUGUES",2,0,1,0,2,1,0,1,0
"HUMAN",4,0,1,0,4,1,0,1,0
"HUNTLEY",2,1,.6666667,.3333333,3,0,0,0,0
"HUSAM",5,0,1,0,5,1,0,1,0
"HUSEIN",4,0,1,0,4,1,0,1,0
"HWA",0,5,0,1,5,0,1,0,1
"HYUNJI",0,2,0,1,2,0,1,0,1
"IAISHA",0,4,0,1,4,0,1,0,1
"IBOU",3,0,1,0,3,1,0,1,0
"IBRAHEEM",3,0,1,0,3,1,0,1,0
"IDANIA",0,3,0,1,3,0,1,0,1
"IDARA",0,3,0,1,3,0,1,0,1
"IDOWU",2,0,1,0,2,1,0,1,0
"IEASHA",0,4,0,1,4,0,1,0,1
"IESHIA",0,5,0,1,5,0,1,0,1
"IJAZ",3,0,1,0,3,1,0,1,0
"ILEANE",0,5,0,1,5,0,1,0,1
"ILKAY",1,2,.3333333,.6666667,3,0,0,0,0
"ILKNUR",0,3,0,1,3,0,1,0,1
"ILLY",1,1,.5,.5,2,0,0,0,0
"IMAGE",1,1,.5,.5,2,0,0,0,0
"IMEE",0,2,0,1,2,0,1,0,1
"IMER",3,0,1,0,3,1,0,1,0
"INDERPAL",2,0,1,0,2,1,0,1,0
"INDRANI",0,2,0,1,2,0,1,0,1
"INDRE",0,3,0,1,3,0,1,0,1
"INSOO",3,1,.75,.25,4,0,0,0,0
"INSUNG",4,0,1,0,4,1,0,1,0
"INWOOD",1,1,.5,.5,2,0,0,0,0
"INYOUNG",0,3,0,1,3,0,1,0,1
"ION",2,1,.6666667,.3333333,3,0,0,0,0
"IRWING",4,0,1,0,4,1,0,1,0
"ISHTIAQUE",3,0,1,0,3,1,0,1,0
"ISMELDA",0,2,0,1,2,0,1,0,1
"IV",1,1,.5,.5,2,0,0,0,0
"IVAYLO",2,0,1,0,2,1,0,1,0
"IVONE",0,3,0,1,3,0,1,0,1
"IYANNA",0,3,0,1,3,0,1,0,1
"IZIK",2,0,1,0,2,1,0,1,0
"IZZET",3,0,1,0,3,1,0,1,0
"JAAN",3,1,.75,.25,4,0,0,0,0
"JABED",3,0,1,0,3,1,0,1,0
"JACALYN",0,2,0,1,2,0,1,0,1
"JACQUELENE",0,3,0,1,3,0,1,0,1
"JACQUELYNN",0,3,0,1,3,0,1,0,1
"JADIE",1,1,.5,.5,2,0,0,0,0
"JADINE",0,3,0,1,3,0,1,0,1
"JAEHEE",1,3,.25,.75,4,0,0,0,0
"JAEYOUNG",2,1,.6666667,.3333333,3,0,0,0,0
"JAFFAR",4,0,1,0,4,1,0,1,0
"JAGGER",4,0,1,0,4,1,0,1,0
"JAHANGIR",4,0,1,0,4,1,0,1,0
"JAHED",5,0,1,0,5,1,0,1,0
"JAHI",3,0,1,0,3,1,0,1,0
"JAHIR",3,0,1,0,3,1,0,1,0
"JAHLIL",4,0,1,0,4,1,0,1,0
"JAILYN",1,3,.25,.75,4,0,0,0,0
"JAIN",2,2,.5,.5,4,0,0,0,0
"JAKIA",0,3,0,1,3,0,1,0,1
"JALEH",0,5,0,1,5,0,1,0,1
"JAMARI",3,1,.75,.25,4,0,0,0,0
"JAMILET",0,4,0,1,4,0,1,0,1
"JAMINE",1,1,.5,.5,2,0,0,0,0
"JAMIYLA",0,3,0,1,3,0,1,0,1
"JANAN",0,2,0,1,2,0,1,0,1
"JANAYE",0,2,0,1,2,0,1,0,1
"JANIN",0,4,0,1,4,0,1,0,1
"JANS",5,0,1,0,5,1,0,1,0
"JANSEN",1,1,.5,.5,2,0,0,0,0
"JARETH",5,0,1,0,5,1,0,1,0
"JASHIRA",0,3,0,1,3,0,1,0,1
"JASIN",2,1,.6666667,.3333333,3,0,0,0,0
"JASMEEN",0,3,0,1,3,0,1,0,1
"JASMINKA",0,3,0,1,3,0,1,0,1
"JASS",0,4,0,1,4,0,1,0,1
"JASSI",3,0,1,0,3,1,0,1,0
"JASSIEL",2,1,.6666667,.3333333,3,0,0,0,0
"JAVY",4,0,1,0,4,1,0,1,0
"JAYDA",0,3,0,1,3,0,1,0,1
"JAY-JAY",4,1,.8,.2,5,1,0,0,0
"JAYLEN",2,0,1,0,2,1,0,1,0
"JEANCARLOS",4,0,1,0,4,1,0,1,0
"JEANI",0,3,0,1,3,0,1,0,1
"JEANLUC",4,0,1,0,4,1,0,1,0
"JEDI",1,1,.5,.5,2,0,0,0,0
"JEDIDIAH",3,0,1,0,3,1,0,1,0
"JEEYEON",0,2,0,1,2,0,1,0,1
"JEFFEREY",5,0,1,0,5,1,0,1,0
"JEFFRIE",5,0,1,0,5,1,0,1,0
"JEI",2,0,1,0,2,1,0,1,0
"JEMIMAH",0,2,0,1,2,0,1,0,1
"JENAE",0,3,0,1,3,0,1,0,1
"JENICA",0,3,0,1,3,0,1,0,1
"JENILLE",0,5,0,1,5,0,1,0,1
"JENIQUE",0,3,0,1,3,0,1,0,1
"JENNEL",0,4,0,1,4,0,1,0,1
"JENNELLE",0,4,0,1,4,0,1,0,1
"JENNICE",0,5,0,1,5,0,1,0,1
"JERIKA",0,2,0,1,2,0,1,0,1
"JERMAL",5,0,1,0,5,1,0,1,0
"JERREL",4,0,1,0,4,1,0,1,0
"JERYL",2,2,.5,.5,4,0,0,0,0
"JESSEN",2,0,1,0,2,1,0,1,0
"JESSEY",0,3,0,1,3,0,1,0,1
"JESY",1,3,.25,.75,4,0,0,0,0
"JETON",3,0,1,0,3,1,0,1,0
"JETTA",1,2,.3333333,.6666667,3,0,0,0,0
"JEYA",1,3,.25,.75,4,0,0,0,0
"JHOVANNY",3,0,1,0,3,1,0,1,0
"JIAO",1,2,.3333333,.6666667,3,0,0,0,0
"JIAWEI",3,1,.75,.25,4,0,0,0,0
"JIMY",4,0,1,0,4,1,0,1,0
"JINGYU",2,2,.5,.5,4,0,0,0,0
"JINHO",4,0,1,0,4,1,0,1,0
"JINOK",0,4,0,1,4,0,1,0,1
"JINWON",1,1,.5,.5,2,0,0,0,0
"JINYOUNG",1,2,.3333333,.6666667,3,0,0,0,0
"JOCHY",3,0,1,0,3,1,0,1,0
"JOCK",2,0,1,0,2,1,0,1,0
"JOEANN",0,5,0,1,5,0,1,0,1
"JOHARI",2,1,.6666667,.3333333,3,0,0,0,0
"JOHNIE",2,1,.6666667,.3333333,3,0,0,0,0
"JOHN-MICHAEL",2,0,1,0,2,1,0,1,0
"JOLEE",0,2,0,1,2,0,1,0,1
"JONIDA",0,4,0,1,4,0,1,0,1
"JONJON",4,0,1,0,4,1,0,1,0
"JONNEL",2,2,.5,.5,4,0,0,0,0
"JORAM",3,0,1,0,3,1,0,1,0
"JORGEN",2,0,1,0,2,1,0,1,0
"JOSEP",2,0,1,0,2,1,0,1,0
"JOSINA",0,3,0,1,3,0,1,0,1
"JOUMANA",0,3,0,1,3,0,1,0,1
"JOY-ANN",0,4,0,1,4,0,1,0,1
"JUANJO",2,0,1,0,2,1,0,1,0
"JUBILEE",0,2,0,1,2,0,1,0,1
"JUDELKA",0,3,0,1,3,0,1,0,1
"JUDGE",3,0,1,0,3,1,0,1,0
"JULE",1,2,.3333333,.6666667,3,0,0,0,0
"JULIE-ANN",0,2,0,1,2,0,1,0,1
"JUMAANE",4,0,1,0,4,1,0,1,0
"JUNGEUN",0,4,0,1,4,0,1,0,1
"JUNGHYUN",2,2,.5,.5,4,0,0,0,0
"JURAJ",3,0,1,0,3,1,0,1,0
"KACPER",3,0,1,0,3,1,0,1,0
"KADER",2,0,1,0,2,1,0,1,0
"KADIE",0,3,0,1,3,0,1,0,1
"KADISHA",0,2,0,1,2,0,1,0,1
"KAGAN",4,0,1,0,4,1,0,1,0
"KAISER",2,0,1,0,2,1,0,1,0
"KALANI",0,2,0,1,2,0,1,0,1
"KALPESH",2,0,1,0,2,1,0,1,0
"KAMELA",0,4,0,1,4,0,1,0,1
"KAMMY",0,3,0,1,3,0,1,0,1
"KANAN",1,2,.3333333,.6666667,3,0,0,0,0
"KANANI",0,2,0,1,2,0,1,0,1
"KANISHA",0,2,0,1,2,0,1,0,1
"KANYA",0,2,0,1,2,0,1,0,1
"KAREGA",4,0,1,0,4,1,0,1,0
"KARLIN",3,1,.75,.25,4,0,0,0,0
"KARTHIKEYAN",2,0,1,0,2,1,0,1,0
"KASHEEM",4,0,1,0,4,1,0,1,0
"KASHEENA",0,4,0,1,4,0,1,0,1
"KASRA",2,0,1,0,2,1,0,1,0
"KASSIM",3,0,1,0,3,1,0,1,0
"KASUN",3,0,1,0,3,1,0,1,0
"KATA",0,2,0,1,2,0,1,0,1
"KATHARYN",0,2,0,1,2,0,1,0,1
"KATHERINNE",0,2,0,1,2,0,1,0,1
"KATISHA",0,2,0,1,2,0,1,0,1
"KATO",4,0,1,0,4,1,0,1,0
"KATZ",1,2,.3333333,.6666667,3,0,0,0,0
"KAUFMAN",2,1,.6666667,.3333333,3,0,0,0,0
"KAYDEEN",0,3,0,1,3,0,1,0,1
"KAYDENE",0,3,0,1,3,0,1,0,1
"KAYDEON",0,3,0,1,3,0,1,0,1
"KAYOKO",0,3,0,1,3,0,1,0,1
"KAYVAN",3,1,.75,.25,4,0,0,0,0
"KEASHA",0,4,0,1,4,0,1,0,1
"KEATON",4,0,1,0,4,1,0,1,0
"KEELAN",1,1,.5,.5,2,0,0,0,0
"KEEVA",0,3,0,1,3,0,1,0,1
"KEIJI",3,0,1,0,3,1,0,1,0
"KEIMA",0,3,0,1,3,0,1,0,1
"KELA",0,3,0,1,3,0,1,0,1
"KELSANG",0,2,0,1,2,0,1,0,1
"KELSEA",0,3,0,1,3,0,1,0,1
"KENNARD",2,0,1,0,2,1,0,1,0
"KENRIC",2,0,1,0,2,1,0,1,0
"KENROY",3,0,1,0,3,1,0,1,0
"KENSUKE",5,0,1,0,5,1,0,1,0
"KEOSHA",0,4,0,1,4,0,1,0,1
"KERENE",0,3,0,1,3,0,1,0,1
"KERISSA",0,2,0,1,2,0,1,0,1
"KERLINE",0,4,0,1,4,0,1,0,1
"KERR",3,0,1,0,3,1,0,1,0
"KERRIAN",0,4,0,1,4,0,1,0,1
"KERVENS",3,0,1,0,3,1,0,1,0
"KEYMA",0,2,0,1,2,0,1,0,1
"KEYONA",0,3,0,1,3,0,1,0,1
"KHALEED",3,0,1,0,3,1,0,1,0
"KHALIQ",4,0,1,0,4,1,0,1,0
"KHARA",0,2,0,1,2,0,1,0,1
"KHRISTIAN",2,0,1,0,2,1,0,1,0
"KIKUKO",0,2,0,1,2,0,1,0,1
"KILLAH",3,0,1,0,3,1,0,1,0
"KIMARLEY",4,1,.8,.2,5,1,0,0,0
"KIMON",2,0,1,0,2,1,0,1,0
"KINDELL",2,2,.5,.5,4,0,0,0,0
"KINE",0,2,0,1,2,0,1,0,1
"KIRSTI",0,2,0,1,2,0,1,0,1
"KISHAWN",0,2,0,1,2,0,1,0,1
"KITA",0,4,0,1,4,0,1,0,1
"KIYOKO",0,2,0,1,2,0,1,0,1
"KLAAS",2,0,1,0,2,1,0,1,0
"KLARISSA",0,2,0,1,2,0,1,0,1
"KNUT",3,0,1,0,3,1,0,1,0
"KOBINA",4,0,1,0,4,1,0,1,0
"KOEN",5,0,1,0,5,1,0,1,0
"KONNY",0,3,0,1,3,0,1,0,1
"KOOKIE",1,3,.25,.75,4,0,0,0,0
"KORE",3,0,1,0,3,1,0,1,0
"KORRINE",0,2,0,1,2,0,1,0,1
"KOULA",0,4,0,1,4,0,1,0,1
"KRISTIANA",0,2,0,1,2,0,1,0,1
"KRISTJAN",3,0,1,0,3,1,0,1,0
"KRISTYNA",0,2,0,1,2,0,1,0,1
"KUBA",3,0,1,0,3,1,0,1,0
"KUL",3,1,.75,.25,4,0,0,0,0
"KUMA",2,1,.6666667,.3333333,3,0,0,0,0
"KUMARIE",0,3,0,1,3,0,1,0,1
"KWAMI",4,0,1,0,4,1,0,1,0
"KWELI",0,3,0,1,3,0,1,0,1
"KWON",3,1,.75,.25,4,0,0,0,0
"KWONG",4,0,1,0,4,1,0,1,0
"KYNA",0,3,0,1,3,0,1,0,1
"KYRIAKOS",4,0,1,0,4,1,0,1,0
"KYUNGHWA",0,5,0,1,5,0,1,0,1
"LACHLAN",2,0,1,0,2,1,0,1,0
"LADAN",1,2,.3333333,.6666667,3,0,0,0,0
"LADAWN",0,4,0,1,4,0,1,0,1
"LAJUANA",0,4,0,1,4,0,1,0,1
"LAKESHIA",0,2,0,1,2,0,1,0,1
"LAMINE",2,0,1,0,2,1,0,1,0
"LAMIS",0,3,0,1,3,0,1,0,1
"LAMYA",0,2,0,1,2,0,1,0,1
"LANDIS",1,2,.3333333,.6666667,3,0,0,0,0
"LANELL",3,1,.75,.25,4,0,0,0,0
"LAQUINTA",0,4,0,1,4,0,1,0,1
"LARINA",0,3,0,1,3,0,1,0,1
"LARRAINE",0,3,0,1,3,0,1,0,1
"LASEAN",0,4,0,1,4,0,1,0,1
"LASHONNA",0,2,0,1,2,0,1,0,1
"LASSE",3,0,1,0,3,1,0,1,0
"LATA",0,3,0,1,3,0,1,0,1
"LATASHIA",0,3,0,1,3,0,1,0,1
"LATAVIA",0,3,0,1,3,0,1,0,1
"LATHA",0,3,0,1,3,0,1,0,1
"LATICHA",0,3,0,1,3,0,1,0,1
"LATIESHA",0,2,0,1,2,0,1,0,1
"LATIKA",0,3,0,1,3,0,1,0,1
"LATIMA",0,4,0,1,4,0,1,0,1
"LATRELL",1,1,.5,.5,2,0,0,0,0
"LAURAINE",0,3,0,1,3,0,1,0,1
"LAURIEANN",0,4,0,1,4,0,1,0,1
"LAVONDA",0,4,0,1,4,0,1,0,1
"LAYLAH",0,4,0,1,4,0,1,0,1
"LEILAH",0,3,0,1,3,0,1,0,1
"LEISHA",0,2,0,1,2,0,1,0,1
"LENE",0,2,0,1,2,0,1,0,1
"LENNA",0,2,0,1,2,0,1,0,1
"LENNART",3,0,1,0,3,1,0,1,0
"LENNI",1,1,.5,.5,2,0,0,0,0
"LENNIN",4,0,1,0,4,1,0,1,0
"LEONG",3,0,1,0,3,1,0,1,0
"LESLEIGH",0,3,0,1,3,0,1,0,1
"LESLEY-ANN",0,5,0,1,5,0,1,0,1
"LESYA",0,2,0,1,2,0,1,0,1
"LETECIA",0,4,0,1,4,0,1,0,1
"LETTICE",0,2,0,1,2,0,1,0,1
"LEXA",1,2,.3333333,.6666667,3,0,0,0,0
"LEXII",0,3,0,1,3,0,1,0,1
"LIDIJA",0,3,0,1,3,0,1,0,1
"LILIAM",0,2,0,1,2,0,1,0,1
"LILIANN",0,3,0,1,3,0,1,0,1
"LIMO",3,1,.75,.25,4,0,0,0,0
"LINDE",0,2,0,1,2,0,1,0,1
"LINDEL",2,2,.5,.5,4,0,0,0,0
"LINDON",4,0,1,0,4,1,0,1,0
"LINE",0,4,0,1,4,0,1,0,1
"LINNA",0,4,0,1,4,0,1,0,1
"LINZY",1,2,.3333333,.6666667,3,0,0,0,0
"LIRA",0,4,0,1,4,0,1,0,1
"LIRIA",0,2,0,1,2,0,1,0,1
"LIZZI",0,3,0,1,3,0,1,0,1
"LOCKSLEY",4,0,1,0,4,1,0,1,0
"LOLLY",1,2,.3333333,.6666667,3,0,0,0,0
"LOLY",0,5,0,1,5,0,1,0,1
"LORAN",0,3,0,1,3,0,1,0,1
"LORITA",0,4,0,1,4,0,1,0,1
"LOTTIE",0,2,0,1,2,0,1,0,1
"LOVIN",0,2,0,1,2,0,1,0,1
"LUA",0,3,0,1,3,0,1,0,1
"LUANNA",0,3,0,1,3,0,1,0,1
"LUCHA",2,2,.5,.5,4,0,0,0,0
"LUCHY",1,3,.25,.75,4,0,0,0,0
"LUCIANE",0,4,0,1,4,0,1,0,1
"LUCILE",0,4,0,1,4,0,1,0,1
"LUCINA",0,3,0,1,3,0,1,0,1
"LUISANA",0,4,0,1,4,0,1,0,1
"LULY",0,3,0,1,3,0,1,0,1
"LUM",4,1,.8,.2,5,1,0,0,0
"LURLINE",0,5,0,1,5,0,1,0,1
"LYDA",0,2,0,1,2,0,1,0,1
"LYNE",0,3,0,1,3,0,1,0,1
"LYRIC",0,2,0,1,2,0,1,0,1
"LYSANDER",2,0,1,0,2,1,0,1,0
"LYUDA",0,2,0,1,2,0,1,0,1
"MADD",2,1,.6666667,.3333333,3,0,0,0,0
"MAFER",0,3,0,1,3,0,1,0,1
"MAGDALA",0,2,0,1,2,0,1,0,1
"MAGUY",0,2,0,1,2,0,1,0,1
"MAHADEO",4,0,1,0,4,1,0,1,0
"MAHBOOB",3,0,1,0,3,1,0,1,0
"MAIKEL",4,0,1,0,4,1,0,1,0
"MAJ",1,2,.3333333,.6666667,3,0,0,0,0
"MAJEED",3,0,1,0,3,1,0,1,0
"MAJLINDA",0,2,0,1,2,0,1,0,1
"MAKIA",1,3,.25,.75,4,0,0,0,0
"MAKINI",0,2,0,1,2,0,1,0,1
"MAKO",1,3,.25,.75,4,0,0,0,0
"MAMADY",2,0,1,0,2,1,0,1,0
"MANAR",1,1,.5,.5,2,0,0,0,0
"MANDAR",4,0,1,0,4,1,0,1,0
"MANDEL",3,1,.75,.25,4,0,0,0,0
"MANDELA",3,0,1,0,3,1,0,1,0
"MANDELL",4,0,1,0,4,1,0,1,0
"MANEESH",2,0,1,0,2,1,0,1,0
"MANIK",3,0,1,0,3,1,0,1,0
"MANNA",0,3,0,1,3,0,1,0,1
"MANNIX",3,0,1,0,3,1,0,1,0
"MANOLI",3,0,1,0,3,1,0,1,0
"MANSUR",2,0,1,0,2,1,0,1,0
"MANZOOR",5,0,1,0,5,1,0,1,0
"MARC-ANTHONY",3,0,1,0,3,1,0,1,0
"MARCEE",0,3,0,1,3,0,1,0,1
"MARDI",0,2,0,1,2,0,1,0,1
"MARDOCHEE",2,2,.5,.5,4,0,0,0,0
"MAREA",0,2,0,1,2,0,1,0,1
"MARESA",0,2,0,1,2,0,1,0,1
"MARGARETH",0,3,0,1,3,0,1,0,1
"MARGEAUX",0,2,0,1,2,0,1,0,1
"MARGUERITA",0,2,0,1,2,0,1,0,1
"MARIANE",0,4,0,1,4,0,1,0,1
"MARIELI",0,4,0,1,4,0,1,0,1
"MARIKE",0,3,0,1,3,0,1,0,1
"MARK-ANTHONY",3,0,1,0,3,1,0,1,0
"MARKEL",4,0,1,0,4,1,0,1,0
"MARKELL",4,0,1,0,4,1,0,1,0
"MARKY",5,0,1,0,5,1,0,1,0
"MARLOW",4,0,1,0,4,1,0,1,0
"MARNA",0,2,0,1,2,0,1,0,1
"MARNEY",0,3,0,1,3,0,1,0,1
"MARRY",0,4,0,1,4,0,1,0,1
"MARSEL",4,0,1,0,4,1,0,1,0
"MARSHAL",3,0,1,0,3,1,0,1,0
"MARTELL",3,0,1,0,3,1,0,1,0
"MARTIE",0,2,0,1,2,0,1,0,1
"MARTIKA",0,2,0,1,2,0,1,0,1
"MARTINIQUE",0,5,0,1,5,0,1,0,1
"MARY-ANN",0,3,0,1,3,0,1,0,1
"MARY-BETH",0,2,0,1,2,0,1,0,1
"MARYKAY",0,4,0,1,4,0,1,0,1
"MARZ",0,3,0,1,3,0,1,0,1
"MASAYUKI",3,0,1,0,3,1,0,1,0
"MASHAL",0,2,0,1,2,0,1,0,1
"MASUMA",0,2,0,1,2,0,1,0,1
"MATEEN",3,0,1,0,3,1,0,1,0
"MATOS",2,2,.5,.5,4,0,0,0,0
"MATY",1,2,.3333333,.6666667,3,0,0,0,0
"MAURISA",0,3,0,1,3,0,1,0,1
"MAYO",2,3,.4,.6,5,0,0,0,0
"MCCOY",3,1,.75,.25,4,0,0,0,0
"MEDI",2,1,.6666667,.3333333,3,0,0,0,0
"MEDO",3,0,1,0,3,1,0,1,0
"MEGI",0,4,0,1,4,0,1,0,1
"MEHEDI",4,0,1,0,4,1,0,1,0
"MEIKE",0,2,0,1,2,0,1,0,1
"MELLANIE",0,2,0,1,2,0,1,0,1
"MERCURY",4,0,1,0,4,1,0,1,0
"MERIDA",0,5,0,1,5,0,1,0,1
"MERIN",0,4,0,1,4,0,1,0,1
"MERITA",0,4,0,1,4,0,1,0,1
"MERLINE",0,4,0,1,4,0,1,0,1
"MERNA",0,2,0,1,2,0,1,0,1
"MESHACH",4,0,1,0,4,1,0,1,0
"MIASHA",0,3,0,1,3,0,1,0,1
"MICHAELE",0,5,0,1,5,0,1,0,1
"MICHELENE",0,2,0,1,2,0,1,0,1
"MICHIYO",0,4,0,1,4,0,1,0,1
"MICHOU",3,0,1,0,3,1,0,1,0
"MIHAL",1,2,.3333333,.6666667,3,0,0,0,0
"MIKAIL",3,0,1,0,3,1,0,1,0
"MIKIE",2,2,.5,.5,4,0,0,0,0
"MIKLOS",2,0,1,0,2,1,0,1,0
"MIKOLAJ",3,0,1,0,3,1,0,1,0
"MILANO",2,2,.5,.5,4,0,0,0,0
"MILEDY",0,4,0,1,4,0,1,0,1
"MIM",0,2,0,1,2,0,1,0,1
"MIMIE",0,3,0,1,3,0,1,0,1
"MINGO",5,0,1,0,5,1,0,1,0
"MINHAJ",3,0,1,0,3,1,0,1,0
"MINKI",1,2,.3333333,.6666667,3,0,0,0,0
"MIRCO",4,0,1,0,4,1,0,1,0
"MIRJAM",0,3,0,1,3,0,1,0,1
"MIRLA",0,5,0,1,5,0,1,0,1
"MIRLANDE",0,4,0,1,4,0,1,0,1
"MIRLENE",0,3,0,1,3,0,1,0,1
"MISAKI",0,2,0,1,2,0,1,0,1
"MISAKO",0,3,0,1,3,0,1,0,1
"MISBAH",0,3,0,1,3,0,1,0,1
"MISH",1,1,.5,.5,2,0,0,0,0
"MITSURU",2,1,.6666667,.3333333,3,0,0,0,0
"MIU",0,2,0,1,2,0,1,0,1
"MIYOSHI",0,2,0,1,2,0,1,0,1
"MODESTY",0,2,0,1,2,0,1,0,1
"MOHINDER",3,0,1,0,3,1,0,1,0
"MOI",1,4,.2,.8,5,0,1,0,0
"MOMAR",4,0,1,0,4,1,0,1,0
"MOMI",0,3,0,1,3,0,1,0,1
"MONE",0,3,0,1,3,0,1,0,1
"MONEA",0,3,0,1,3,0,1,0,1
"MONO",2,0,1,0,2,1,0,1,0
"MONSUR",3,0,1,0,3,1,0,1,0
"MOOK",3,0,1,0,3,1,0,1,0
"MORE",1,1,.5,.5,2,0,0,0,0
"MORIA",0,2,0,1,2,0,1,0,1
"MORRISON",2,2,.5,.5,4,0,0,0,0
"MORRY",4,0,1,0,4,1,0,1,0
"MORTEN",3,0,1,0,3,1,0,1,0
"MOSHIK",3,0,1,0,3,1,0,1,0
"MOUHAMED",4,0,1,0,4,1,0,1,0
"MOY",4,0,1,0,4,1,0,1,0
"MUGSY",5,0,1,0,5,1,0,1,0
"MUHARREM",4,0,1,0,4,1,0,1,0
"MUI",2,2,.5,.5,4,0,0,0,0
"MUKTI",1,2,.3333333,.6666667,3,0,0,0,0
"MUNISH",3,0,1,0,3,1,0,1,0
"MYASIA",0,2,0,1,2,0,1,0,1
"MYCHAEL",4,0,1,0,4,1,0,1,0
"MYCHAL",4,0,1,0,4,1,0,1,0
"MYKAL",3,1,.75,.25,4,0,0,0,0
"MYRLINE",0,3,0,1,3,0,1,0,1
"NAADIRA",0,4,0,1,4,0,1,0,1
"NABEELA",0,2,0,1,2,0,1,0,1
"NABIN",2,0,1,0,2,1,0,1,0
"NACHI",3,0,1,0,3,1,0,1,0
"NACHMAN",3,0,1,0,3,1,0,1,0
"NAD",2,1,.6666667,.3333333,3,0,0,0,0
"NADENE",0,3,0,1,3,0,1,0,1
"NADI",0,2,0,1,2,0,1,0,1
"NADRA",0,3,0,1,3,0,1,0,1
"NADY",3,0,1,0,3,1,0,1,0
"NAFI",1,1,.5,.5,2,0,0,0,0
"NAFISAH",0,3,0,1,3,0,1,0,1
"NAGENDRA",4,0,1,0,4,1,0,1,0
"NAHO",0,3,0,1,3,0,1,0,1
"NAIA",0,3,0,1,3,0,1,0,1
"NAIJA",1,2,.3333333,.6666667,3,0,0,0,0
"NAJIB",3,0,1,0,3,1,0,1,0
"NAJMA",0,2,0,1,2,0,1,0,1
"NAKESHA",0,4,0,1,4,0,1,0,1
"NASHON",4,0,1,0,4,1,0,1,0
"NATASSIA",0,3,0,1,3,0,1,0,1
"NATESHA",0,3,0,1,3,0,1,0,1
"NATHALI",0,3,0,1,3,0,1,0,1
"NATINA",0,3,0,1,3,0,1,0,1
"NATT",2,1,.6666667,.3333333,3,0,0,0,0
"NATURAL",2,2,.5,.5,4,0,0,0,0
"NAZMI",3,0,1,0,3,1,0,1,0
"NECOLE",0,5,0,1,5,0,1,0,1
"NECTOR",4,0,1,0,4,1,0,1,0
"NEHIR",0,3,0,1,3,0,1,0,1
"NEICY",0,5,0,1,5,0,1,0,1
"NEILA",0,4,0,1,4,0,1,0,1
"NELI",0,4,0,1,4,0,1,0,1
"NEON",3,0,1,0,3,1,0,1,0
"NERI",0,2,0,1,2,0,1,0,1
"NERO",3,0,1,0,3,1,0,1,0
"NEVAEH",1,4,.2,.8,5,0,1,0,0
"NEVIL",3,0,1,0,3,1,0,1,0
"NEVINE",0,2,0,1,2,0,1,0,1
"NGA",0,2,0,1,2,0,1,0,1
"NHU",0,2,0,1,2,0,1,0,1
"NIAZ",3,0,1,0,3,1,0,1,0
"NICHELE",0,4,0,1,4,0,1,0,1
"NICHOLLE",0,3,0,1,3,0,1,0,1
"NICI",0,2,0,1,2,0,1,0,1
"NICKA",1,3,.25,.75,4,0,0,0,0
"NICKO",2,0,1,0,2,1,0,1,0
"NIKAURY",0,2,0,1,2,0,1,0,1
"NIKIYA",0,3,0,1,3,0,1,0,1
"NILUFER",0,4,0,1,4,0,1,0,1
"NIRVANA",0,2,0,1,2,0,1,0,1
"NISHAT",0,3,0,1,3,0,1,0,1
"NISHITH",3,0,1,0,3,1,0,1,0
"NISSAN",2,0,1,0,2,1,0,1,0
"NITO",4,0,1,0,4,1,0,1,0
"NITRO",1,2,.3333333,.6666667,3,0,0,0,0
"NITTY",2,1,.6666667,.3333333,3,0,0,0,0
"NIV",4,0,1,0,4,1,0,1,0
"NIVA",0,2,0,1,2,0,1,0,1
"NIZAM",4,0,1,0,4,1,0,1,0
"NNENNA",0,5,0,1,5,0,1,0,1
"NNEOMA",0,3,0,1,3,0,1,0,1
"NOGA",0,4,0,1,4,0,1,0,1
"NOK",0,2,0,1,2,0,1,0,1
"NOORA",0,2,0,1,2,0,1,0,1
"NORE",2,1,.6666667,.3333333,3,0,0,0,0
"NORELL",0,2,0,1,2,0,1,0,1
"NORIE",0,2,0,1,2,0,1,0,1
"NUBE",1,1,.5,.5,2,0,0,0,0
"NYAH",1,3,.25,.75,4,0,0,0,0
"NYLE",1,1,.5,.5,2,0,0,0,0
"OBAID",2,0,1,0,2,1,0,1,0
"OBIE",3,0,1,0,3,1,0,1,0
"ODELYA",0,3,0,1,3,0,1,0,1
"OHM",3,0,1,0,3,1,0,1,0
"OK",1,2,.3333333,.6666667,3,0,0,0,0
"OLABODE",3,0,1,0,3,1,0,1,0
"OLAJIDE",4,0,1,0,4,1,0,1,0
"OLAJUMOKE",0,4,0,1,4,0,1,0,1
"OLALEKAN",4,0,1,0,4,1,0,1,0
"OLHA",0,4,0,1,4,0,1,0,1
"OLIN",3,0,1,0,3,1,0,1,0
"OLISA",2,1,.6666667,.3333333,3,0,0,0,0
"OLIVA",0,3,0,1,3,0,1,0,1
"OMARION",2,0,1,0,2,1,0,1,0
"ONDÅ˜EJ",4,0,1,0,4,1,0,1,0
"ONEIKA",0,2,0,1,2,0,1,0,1
"ONYX",3,0,1,0,3,1,0,1,0
"ORANE",4,0,1,0,4,1,0,1,0
"ORANGE",1,1,.5,.5,2,0,0,0,0
"ORIGINAL",3,0,1,0,3,1,0,1,0
"ORINTHIA",0,3,0,1,3,0,1,0,1
"ORLANDA",0,2,0,1,2,0,1,0,1
"ORR",0,2,0,1,2,0,1,0,1
"ORSOLYA",0,2,0,1,2,0,1,0,1
"OSAGIE",3,0,1,0,3,1,0,1,0
"OSAMU",2,0,1,0,2,1,0,1,0
"OSBORNE",3,0,1,0,3,1,0,1,0
"OSSIE",2,1,.6666667,.3333333,3,0,0,0,0
"OUSMAN",2,0,1,0,2,1,0,1,0
"OVI",3,1,.75,.25,4,0,0,0,0
"OWAIS",4,0,1,0,4,1,0,1,0
"OWOLABI",4,0,1,0,4,1,0,1,0
"OWUSU",2,0,1,0,2,1,0,1,0
"OZCAN",4,0,1,0,4,1,0,1,0
"PACE",4,0,1,0,4,1,0,1,0
"PALLAV",2,0,1,0,2,1,0,1,0
"PANAGIOTA",0,3,0,1,3,0,1,0,1
"PANCHO",2,0,1,0,2,1,0,1,0
"PARISH",3,0,1,0,3,1,0,1,0
"PARITOSH",2,0,1,0,2,1,0,1,0
"PASSION",1,1,.5,.5,2,0,0,0,0
"PATRYCE",0,2,0,1,2,0,1,0,1
"PATY",0,2,0,1,2,0,1,0,1
"PAX",3,2,.6,.4,5,0,0,0,0
"PAXTON",2,0,1,0,2,1,0,1,0
"PEARCE",2,1,.6666667,.3333333,3,0,0,0,0
"PEARLINE",0,4,0,1,4,0,1,0,1
"PEGEEN",0,3,0,1,3,0,1,0,1
"PEGGI",0,3,0,1,3,0,1,0,1
"PEGI",0,3,0,1,3,0,1,0,1
"PELLE",4,0,1,0,4,1,0,1,0
"PENNEY",0,3,0,1,3,0,1,0,1
"PETIA",0,4,0,1,4,0,1,0,1
"PHILICIA",0,5,0,1,5,0,1,0,1
"PHILIPE",1,1,.5,.5,2,0,0,0,0
"PHILIPPINE",1,2,.3333333,.6666667,3,0,0,0,0
"PHILLIPPE",2,1,.6666667,.3333333,3,0,0,0,0
"PHINEAS",2,0,1,0,2,1,0,1,0
"PHYL",0,4,0,1,4,0,1,0,1
"PHYLIS",0,5,0,1,5,0,1,0,1
"PICCOLO",2,2,.5,.5,4,0,0,0,0
"PIERS",2,0,1,0,2,1,0,1,0
"PINCHUS",3,0,1,0,3,1,0,1,0
"PLAXICO",2,0,1,0,2,1,0,1,0
"PLINIO",4,0,1,0,4,1,0,1,0
"POLY",1,2,.3333333,.6666667,3,0,0,0,0
"PORSCHA",0,2,0,1,2,0,1,0,1
"PRADIP",4,0,1,0,4,1,0,1,0
"PRAGYA",0,3,0,1,3,0,1,0,1
"PRANVERA",0,4,0,1,4,0,1,0,1
"PRATT",0,2,0,1,2,0,1,0,1
"PRAVEENA",0,2,0,1,2,0,1,0,1
"PREETY",0,3,0,1,3,0,1,0,1
"PRERANA",0,3,0,1,3,0,1,0,1
"PRIME",3,1,.75,.25,4,0,0,0,0
"PRINCESA",0,3,0,1,3,0,1,0,1
"PRISSY",0,4,0,1,4,0,1,0,1
"PROPHET",5,0,1,0,5,1,0,1,0
"PUDGE",4,0,1,0,4,1,0,1,0
"PUMA",0,3,0,1,3,0,1,0,1
"QUASIA",0,4,0,1,4,0,1,0,1
"QUENTON",2,0,1,0,2,1,0,1,0
"QUIQUE",3,0,1,0,3,1,0,1,0
"QURAN",4,0,1,0,4,1,0,1,0
"RAANAN",3,0,1,0,3,1,0,1,0
"RABIAH",0,2,0,1,2,0,1,0,1
"RACHIE",0,2,0,1,2,0,1,0,1
"RACINE",0,3,0,1,3,0,1,0,1
"RADIANCE",0,3,0,1,3,0,1,0,1
"RADICA",0,3,0,1,3,0,1,0,1
"RADOSLAV",4,0,1,0,4,1,0,1,0
"RAFFAEL",4,0,1,0,4,1,0,1,0
"RAFIA",0,2,0,1,2,0,1,0,1
"RAFIQUE",4,0,1,0,4,1,0,1,0
"RAFY",2,0,1,0,2,1,0,1,0
"RAGINI",0,3,0,1,3,0,1,0,1
"RAGS",3,0,1,0,3,1,0,1,0
"RAHEIM",2,0,1,0,2,1,0,1,0
"RAHIL",2,1,.6666667,.3333333,3,0,0,0,0
"RAINBOW",1,2,.3333333,.6666667,3,0,0,0,0
"RAJANI",0,3,0,1,3,0,1,0,1
"RAJDEEP",3,0,1,0,3,1,0,1,0
"RAJNISH",2,1,.6666667,.3333333,3,0,0,0,0
"RAJVEER",2,1,.6666667,.3333333,3,0,0,0,0
"RAKEL",0,4,0,1,4,0,1,0,1
"RAKHI",0,2,0,1,2,0,1,0,1
"RAKI",2,1,.6666667,.3333333,3,0,0,0,0
"RAMADAN",2,0,1,0,2,1,0,1,0
"RAMBO",2,1,.6666667,.3333333,3,0,0,0,0
"RAMIT",2,0,1,0,2,1,0,1,0
"RANDE",1,2,.3333333,.6666667,3,0,0,0,0
"RANDEEP",4,0,1,0,4,1,0,1,0
"RANEE",0,2,0,1,2,0,1,0,1
"RAPHI",3,0,1,0,3,1,0,1,0
"RASHANA",0,2,0,1,2,0,1,0,1
"RASHAWNA",0,4,0,1,4,0,1,0,1
"RASHED",3,0,1,0,3,1,0,1,0
"RATAN",3,0,1,0,3,1,0,1,0
"RAUNAK",4,0,1,0,4,1,0,1,0
"RAVISH",5,0,1,0,5,1,0,1,0
"RAYE",0,2,0,1,2,0,1,0,1
"RAYHAN",3,0,1,0,3,1,0,1,0
"RAYMAN",4,0,1,0,4,1,0,1,0
"RAYSHON",4,1,.8,.2,5,1,0,0,0
"RAYVON",3,1,.75,.25,4,0,0,0,0
"RAZIEL",4,0,1,0,4,1,0,1,0
"READY",3,0,1,0,3,1,0,1,0
"REANA",0,2,0,1,2,0,1,0,1
"REB",3,1,.75,.25,4,0,0,0,0
"REGAL",4,0,1,0,4,1,0,1,0
"REGINAL",4,0,1,0,4,1,0,1,0
"REGLA",0,2,0,1,2,0,1,0,1
"REISA",0,4,0,1,4,0,1,0,1
"RENAY",0,2,0,1,2,0,1,0,1
"RENEA",0,4,0,1,4,0,1,0,1
"RENIE",2,1,.6666667,.3333333,3,0,0,0,0
"RENNA",0,2,0,1,2,0,1,0,1
"RESHMI",0,3,0,1,3,0,1,0,1
"RETO",3,0,1,0,3,1,0,1,0
"REYMOND",2,0,1,0,2,1,0,1,0
"REZ",3,1,.75,.25,4,0,0,0,0
"RHIANNA",0,4,0,1,4,0,1,0,1
"RICCO",4,0,1,0,4,1,0,1,0
"RIFKA",0,4,0,1,4,0,1,0,1
"RIKKY",2,1,.6666667,.3333333,3,0,0,0,0
"RINALDI",1,1,.5,.5,2,0,0,0,0
"RIYAD",2,0,1,0,2,1,0,1,0
"RIZAN",3,0,1,0,3,1,0,1,0
"RIZWANA",0,2,0,1,2,0,1,0,1
"ROANNE",0,3,0,1,3,0,1,0,1
"ROBENSON",2,0,1,0,2,1,0,1,0
"ROBI",2,1,.6666667,.3333333,3,0,0,0,0
"ROBYNE",0,2,0,1,2,0,1,0,1
"ROBYNNE",0,3,0,1,3,0,1,0,1
"ROCKWELL",3,0,1,0,3,1,0,1,0
"RODMAN",5,0,1,0,5,1,0,1,0
"ROGERIO",3,0,1,0,3,1,0,1,0
"ROHIN",2,0,1,0,2,1,0,1,0
"ROKIA",0,2,0,1,2,0,1,0,1
"ROLLIE",2,1,.6666667,.3333333,3,0,0,0,0
"ROLLIN",3,1,.75,.25,4,0,0,0,0
"ROMARIO",5,0,1,0,5,1,0,1,0
"ROMESH",4,0,1,0,4,1,0,1,0
"RONAL",5,0,1,0,5,1,0,1,0
"RONDEL",2,0,1,0,2,1,0,1,0
"RONELLE",1,1,.5,.5,2,0,0,0,0
"RONISE",0,3,0,1,3,0,1,0,1
"RONNETTE",0,3,0,1,3,0,1,0,1
"RONNEY",4,0,1,0,4,1,0,1,0
"ROOK",3,0,1,0,3,1,0,1,0
"RORO",1,4,.2,.8,5,0,1,0,0
"ROSALEEN",0,3,0,1,3,0,1,0,1
"ROSHINI",0,2,0,1,2,0,1,0,1
"ROSIO",0,4,0,1,4,0,1,0,1
"ROSSINI",1,1,.5,.5,2,0,0,0,0
"ROTIMI",4,0,1,0,4,1,0,1,0
"ROVIN",2,0,1,0,2,1,0,1,0
"ROWEN",2,1,.6666667,.3333333,3,0,0,0,0
"ROX",1,2,.3333333,.6666667,3,0,0,0,0
"RUBIELA",0,3,0,1,3,0,1,0,1
"RUCHY",0,3,0,1,3,0,1,0,1
"RUDO",1,1,.5,.5,2,0,0,0,0
"RUIZ",1,1,.5,.5,2,0,0,0,0
"RUNA",0,4,0,1,4,0,1,0,1
"RUNE",2,0,1,0,2,1,0,1,0
"RUNWAY",0,4,0,1,4,0,1,0,1
"RUS",2,2,.5,.5,4,0,0,0,0
"RUTHANNE",0,4,0,1,4,0,1,0,1
"RUTY",0,2,0,1,2,0,1,0,1
"RYLAND",2,0,1,0,2,1,0,1,0
"SAADET",0,3,0,1,3,0,1,0,1
"SAB",3,2,.6,.4,5,0,0,0,0
"SABAN",3,0,1,0,3,1,0,1,0
"SABASTIAN",1,1,.5,.5,2,0,0,0,0
"SABI",2,1,.6666667,.3333333,3,0,0,0,0
"SADAT",3,0,1,0,3,1,0,1,0
"SAIMIR",3,0,1,0,3,1,0,1,0
"SAJU",2,0,1,0,2,1,0,1,0
"SAKIS",2,0,1,0,2,1,0,1,0
"SALA",0,3,0,1,3,0,1,0,1
"SALAM",2,2,.5,.5,4,0,0,0,0
"SALIHA",0,2,0,1,2,0,1,0,1
"SALVINA",0,2,0,1,2,0,1,0,1
"SAMEEN",0,3,0,1,3,0,1,0,1
"SAMEENA",0,4,0,1,4,0,1,0,1
"SAMEERAH",0,3,0,1,3,0,1,0,1
"SAMIE",2,3,.4,.6,5,0,0,0,0
"SAMPSON",2,0,1,0,2,1,0,1,0
"SAMRA",0,4,0,1,4,0,1,0,1
"SAMRAT",4,0,1,0,4,1,0,1,0
"SAMREEN",0,2,0,1,2,0,1,0,1
"SAMUELE",4,0,1,0,4,1,0,1,0
"SAND",2,1,.6666667,.3333333,3,0,0,0,0
"SANDE",0,4,0,1,4,0,1,0,1
"SANGHEE",0,3,0,1,3,0,1,0,1
"SANGMIN",3,0,1,0,3,1,0,1,0
"SANGWOO",3,0,1,0,3,1,0,1,0
"SANTIA",0,2,0,1,2,0,1,0,1
"SAO",1,1,.5,.5,2,0,0,0,0
"SARAFINA",0,2,0,1,2,0,1,0,1
"SARRAH",0,4,0,1,4,0,1,0,1
"SASH",3,2,.6,.4,5,0,0,0,0
"SATINDER",2,0,1,0,2,1,0,1,0
"SATYEN",4,0,1,0,4,1,0,1,0
"SAUMYA",0,2,0,1,2,0,1,0,1
"SAURIN",3,0,1,0,3,1,0,1,0
"SAVAS",2,0,1,0,2,1,0,1,0
"SAVIOR",3,0,1,0,3,1,0,1,0
"SAW",3,0,1,0,3,1,0,1,0
"SAWAKO",0,4,0,1,4,0,1,0,1
"SAYRA",0,2,0,1,2,0,1,0,1
"SCOOBY",2,1,.6666667,.3333333,3,0,0,0,0
"SEANNA",0,4,0,1,4,0,1,0,1
"SEBASTIAAN",3,0,1,0,3,1,0,1,0
"SEFA",2,0,1,0,2,1,0,1,0
"SEIDAH",0,3,0,1,3,0,1,0,1
"SEJIN",0,3,0,1,3,0,1,0,1
"SEKI",2,1,.6666667,.3333333,3,0,0,0,0
"SELAH",5,0,1,0,5,1,0,1,0
"SELAHATTIN",2,0,1,0,2,1,0,1,0
"SELVA",2,0,1,0,2,1,0,1,0
"SENEM",0,2,0,1,2,0,1,0,1
"SERAFINO",4,0,1,0,4,1,0,1,0
"SEREN",1,3,.25,.75,4,0,0,0,0
"SERGEANT",3,0,1,0,3,1,0,1,0
"SERGIA",0,4,0,1,4,0,1,0,1
"SERGINE",0,2,0,1,2,0,1,0,1
"SERGIY",4,0,1,0,4,1,0,1,0
"SERIGNE",3,0,1,0,3,1,0,1,0
"SEULGI",0,2,0,1,2,0,1,0,1
"SEVI",1,2,.3333333,.6666667,3,0,0,0,0
"SEYDOU",3,1,.75,.25,4,0,0,0,0
"SEYHAN",2,1,.6666667,.3333333,3,0,0,0,0
"SHAFI",2,0,1,0,2,1,0,1,0
"SHAGUN",0,2,0,1,2,0,1,0,1
"SHAHEEDA",0,3,0,1,3,0,1,0,1
"SHAHRUKH",2,0,1,0,2,1,0,1,0
"SHAILY",0,3,0,1,3,0,1,0,1
"SHAINE",2,0,1,0,2,1,0,1,0
"SHAISTA",0,3,0,1,3,0,1,0,1
"SHAKARA",0,2,0,1,2,0,1,0,1
"SHAKEIA",0,3,0,1,3,0,1,0,1
"SHAKERIA",0,4,0,1,4,0,1,0,1
"SHAKIRAH",0,2,0,1,2,0,1,0,1
"SHALANE",0,2,0,1,2,0,1,0,1
"SHALINA",0,3,0,1,3,0,1,0,1
"SHALISA",0,4,0,1,4,0,1,0,1
"SHAMEEZA",0,3,0,1,3,0,1,0,1
"SHAMELL",4,0,1,0,4,1,0,1,0
"SHAMIA",0,4,0,1,4,0,1,0,1
"SHANAAZ",0,3,0,1,3,0,1,0,1
"SHANDEL",0,3,0,1,3,0,1,0,1
"SHANDELL",0,5,0,1,5,0,1,0,1
"SHANINA",0,5,0,1,5,0,1,0,1
"SHANISHA",0,3,0,1,3,0,1,0,1
"SHANTAI",0,2,0,1,2,0,1,0,1
"SHANYCE",0,2,0,1,2,0,1,0,1
"SHAQ",3,0,1,0,3,1,0,1,0
"SHAQUIRA",0,4,0,1,4,0,1,0,1
"SHARAT",2,0,1,0,2,1,0,1,0
"SHARISSA",0,4,0,1,4,0,1,0,1
"SHARJEEL",2,0,1,0,2,1,0,1,0
"SHARLINE",0,3,0,1,3,0,1,0,1
"SHARMAIN",0,3,0,1,3,0,1,0,1
"SHARNELL",1,2,.3333333,.6666667,3,0,0,0,0
"SHARROD",4,0,1,0,4,1,0,1,0
"SHATEEMA",0,2,0,1,2,0,1,0,1
"SHATINA",0,3,0,1,3,0,1,0,1
"SHAUNETTE",0,3,0,1,3,0,1,0,1
"SHAUNTA",0,5,0,1,5,0,1,0,1
"SHAVONN",0,4,0,1,4,0,1,0,1
"SHAWNTA",0,3,0,1,3,0,1,0,1
"SHAWNTE",0,3,0,1,3,0,1,0,1
"SHAZAM",4,0,1,0,4,1,0,1,0
"SHEEBA",0,2,0,1,2,0,1,0,1
"SHEHAN",4,0,1,0,4,1,0,1,0
"SHEILLA",0,2,0,1,2,0,1,0,1
"SHEL",1,1,.5,.5,2,0,0,0,0
"SHELDA",0,2,0,1,2,0,1,0,1
"SHENEKA",0,3,0,1,3,0,1,0,1
"SHENIQUE",0,3,0,1,3,0,1,0,1
"SHERAY",0,3,0,1,3,0,1,0,1
"SHERIL",0,2,0,1,2,0,1,0,1
"SHERLIN",0,4,0,1,4,0,1,0,1
"SHERLON",4,1,.8,.2,5,1,0,0,0
"SHERREE",0,3,0,1,3,0,1,0,1
"SHEVI",0,2,0,1,2,0,1,0,1
"SHIAN",0,4,0,1,4,0,1,0,1
"SHIJO",4,1,.8,.2,5,1,0,0,0
"SHILA",0,2,0,1,2,0,1,0,1
"SHIM",2,1,.6666667,.3333333,3,0,0,0,0
"SHIMSHON",3,0,1,0,3,1,0,1,0
"SHINA",0,2,0,1,2,0,1,0,1
"SHINJI",4,0,1,0,4,1,0,1,0
"SHINTARO",4,0,1,0,4,1,0,1,0
"SHIREE",0,2,0,1,2,0,1,0,1
"SHIRLEE",0,3,0,1,3,0,1,0,1
"SHISHIR",3,0,1,0,3,1,0,1,0
"SHIVAN",2,0,1,0,2,1,0,1,0
"SHIVANAND",3,0,1,0,3,1,0,1,0
"SHONIQUE",0,2,0,1,2,0,1,0,1
"SHONTA",0,4,0,1,4,0,1,0,1
"SHONTEL",0,3,0,1,3,0,1,0,1
"SHPETIM",5,0,1,0,5,1,0,1,0
"SHREY",3,0,1,0,3,1,0,1,0
"SHRI",2,1,.6666667,.3333333,3,0,0,0,0
"SHRIKANT",4,0,1,0,4,1,0,1,0
"SHRUTHI",0,2,0,1,2,0,1,0,1
"SHUAIB",4,0,1,0,4,1,0,1,0
"SHUBHA",0,2,0,1,2,0,1,0,1
"SHUBHRA",0,2,0,1,2,0,1,0,1
"SHUI",1,3,.25,.75,4,0,0,0,0
"SHUK",0,2,0,1,2,0,1,0,1
"SHUYI",0,2,0,1,2,0,1,0,1
"SHYLA",0,3,0,1,3,0,1,0,1
"SIDDIQ",2,0,1,0,2,1,0,1,0
"SIDY",1,1,.5,.5,2,0,0,0,0
"SILK",2,2,.5,.5,4,0,0,0,0
"SILKA",0,3,0,1,3,0,1,0,1
"SILVANO",3,0,1,0,3,1,0,1,0
"SILVERIO",2,0,1,0,2,1,0,1,0
"SINDHU",0,3,0,1,3,0,1,0,1
"SIOUX",0,2,0,1,2,0,1,0,1
"SIRAN",1,3,.25,.75,4,0,0,0,0
"SISSI",0,4,0,1,4,0,1,0,1
"SKANDER",4,0,1,0,4,1,0,1,0
"SLAV",5,0,1,0,5,1,0,1,0
"SLAWEK",3,0,1,0,3,1,0,1,0
"SMITTY",3,0,1,0,3,1,0,1,0
"SOHEE",0,4,0,1,4,0,1,0,1
"SOJIN",0,4,0,1,4,0,1,0,1
"SOLANA",0,4,0,1,4,0,1,0,1
"SOLI",1,3,.25,.75,4,0,0,0,0
"SOMI",0,2,0,1,2,0,1,0,1
"SOOK",0,3,0,1,3,0,1,0,1
"SORAIDA",0,2,0,1,2,0,1,0,1
"SORIBEL",0,3,0,1,3,0,1,0,1
"SOTIRIS",2,0,1,0,2,1,0,1,0
"SOTO",2,1,.6666667,.3333333,3,0,0,0,0
"SOUTH",1,1,.5,.5,2,0,0,0,0
"SPEED",3,1,.75,.25,4,0,0,0,0
"SPLINTER",5,0,1,0,5,1,0,1,0
"SQUARE",2,1,.6666667,.3333333,3,0,0,0,0
"STACKS",3,0,1,0,3,1,0,1,0
"STANISLAS",3,0,1,0,3,1,0,1,0
"STARLENE",0,3,0,1,3,0,1,0,1
"STAVROULA",0,2,0,1,2,0,1,0,1
"STE",1,1,.5,.5,2,0,0,0,0
"STEIN",3,0,1,0,3,1,0,1,0
"STEWARD",3,0,1,0,3,1,0,1,0
"STEWIE",2,0,1,0,2,1,0,1,0
"STORY",1,2,.3333333,.6666667,3,0,0,0,0
"STRANGE",3,0,1,0,3,1,0,1,0
"SUAT",4,0,1,0,4,1,0,1,0
"SUAVE",2,0,1,0,2,1,0,1,0
"SUBHASH",5,0,1,0,5,1,0,1,0
"SUBRATA",3,1,.75,.25,4,0,0,0,0
"SUE-ANN",0,2,0,1,2,0,1,0,1
"SUFIAN",3,0,1,0,3,1,0,1,0
"SUKHJINDER",4,0,1,0,4,1,0,1,0
"SUNA",0,2,0,1,2,0,1,0,1
"SUNGEUN",0,2,0,1,2,0,1,0,1
"SUNGWON",2,1,.6666667,.3333333,3,0,0,0,0
"SUNILDA",0,5,0,1,5,0,1,0,1
"SUNMI",0,2,0,1,2,0,1,0,1
"SURA",0,3,0,1,3,0,1,0,1
"SUSSIE",0,4,0,1,4,0,1,0,1
"SUZ",0,2,0,1,2,0,1,0,1
"SWEENEY",2,0,1,0,2,1,0,1,0
"SWIFT",3,1,.75,.25,4,0,0,0,0
"SYBILLE",0,2,0,1,2,0,1,0,1
"SYNDEE",0,4,0,1,4,0,1,0,1
"TAAJ",4,0,1,0,4,1,0,1,0
"TABISH",5,0,1,0,5,1,0,1,0
"TADASHI",3,0,1,0,3,1,0,1,0
"TADEO",4,0,1,0,4,1,0,1,0
"TAEKO",0,3,0,1,3,0,1,0,1
"TAESHA",0,4,0,1,4,0,1,0,1
"TAHARA",0,4,0,1,4,0,1,0,1
"TAHJ",2,0,1,0,2,1,0,1,0
"TAKIMA",0,4,0,1,4,0,1,0,1
"TAMELA",0,3,0,1,3,0,1,0,1
"TAMIE",0,4,0,1,4,0,1,0,1
"TAMY",0,4,0,1,4,0,1,0,1
"TANDY",0,4,0,1,4,0,1,0,1
"TANEESHA",0,5,0,1,5,0,1,0,1
"TANEQUA",0,4,0,1,4,0,1,0,1
"TANGUY",2,0,1,0,2,1,0,1,0
"TANUJA",0,2,0,1,2,0,1,0,1
"TAQUANNA",0,5,0,1,5,0,1,0,1
"TARANNUM",0,2,0,1,2,0,1,0,1
"TARELL",3,0,1,0,3,1,0,1,0
"TAREN",0,4,0,1,4,0,1,0,1
"TARIN",1,4,.2,.8,5,0,1,0,0
"TARUNA",0,4,0,1,4,0,1,0,1
"TASHAN",1,2,.3333333,.6666667,3,0,0,0,0
"TASHANNA",0,3,0,1,3,0,1,0,1
"TATIANE",0,4,0,1,4,0,1,0,1
"TATSIANA",0,2,0,1,2,0,1,0,1
"TAU",3,0,1,0,3,1,0,1,0
"TAVON",3,0,1,0,3,1,0,1,0
"TAYSHA",0,3,0,1,3,0,1,0,1
"TAYTAY",0,3,0,1,3,0,1,0,1
"TAZZ",2,1,.6666667,.3333333,3,0,0,0,0
"TE",1,1,.5,.5,2,0,0,0,0
"TEAH",0,2,0,1,2,0,1,0,1
"TEMA",0,2,0,1,2,0,1,0,1
"TEMMY",1,3,.25,.75,4,0,0,0,0
"TENAYA",0,3,0,1,3,0,1,0,1
"TENNYSON",3,0,1,0,3,1,0,1,0
"TEOMAN",3,0,1,0,3,1,0,1,0
"TEONA",0,2,0,1,2,0,1,0,1
"TERANCE",3,0,1,0,3,1,0,1,0
"TERREN",2,1,.6666667,.3333333,3,0,0,0,0
"THALITA",0,4,0,1,4,0,1,0,1
"THANASI",3,0,1,0,3,1,0,1,0
"THANOS",3,0,1,0,3,1,0,1,0
"THECLA",0,4,0,1,4,0,1,0,1
"THELONIOUS",3,0,1,0,3,1,0,1,0
"THEODOROS",2,0,1,0,2,1,0,1,0
"THERESIA",0,3,0,1,3,0,1,0,1
"THERESSA",0,2,0,1,2,0,1,0,1
"THINH",3,0,1,0,3,1,0,1,0
"THORIN",3,0,1,0,3,1,0,1,0
"TIASHA",0,2,0,1,2,0,1,0,1
"TIBERIUS",4,0,1,0,4,1,0,1,0
"TIFANY",0,4,0,1,4,0,1,0,1
"TIKESHA",0,3,0,1,3,0,1,0,1
"TIKIA",0,3,0,1,3,0,1,0,1
"TILA",0,3,0,1,3,0,1,0,1
"TILLY",0,4,0,1,4,0,1,0,1
"TINEKA",0,3,0,1,3,0,1,0,1
"TINIKA",0,3,0,1,3,0,1,0,1
"TINNA",0,4,0,1,4,0,1,0,1
"TIO",2,0,1,0,2,1,0,1,0
"TIP",2,2,.5,.5,4,0,0,0,0
"TIPPI",0,4,0,1,4,0,1,0,1
"TIPPY",1,1,.5,.5,2,0,0,0,0
"TIRZA",0,4,0,1,4,0,1,0,1
"TIZIANO",4,0,1,0,4,1,0,1,0
"TOAN",2,0,1,0,2,1,0,1,0
"TOBIE",0,3,0,1,3,0,1,0,1
"TOLANI",0,2,0,1,2,0,1,0,1
"TOMASINA",0,3,0,1,3,0,1,0,1
"TOMMI",1,2,.3333333,.6666667,3,0,0,0,0
"TOMOHIRO",4,0,1,0,4,1,0,1,0
"TOMOYO",0,3,0,1,3,0,1,0,1
"TOMY",4,0,1,0,4,1,0,1,0
"TONATIUH",2,0,1,0,2,1,0,1,0
"TONETTE",0,4,0,1,4,0,1,0,1
"TONI-MARIE",0,2,0,1,2,0,1,0,1
"TOO",2,0,1,0,2,1,0,1,0
"TORA",0,3,0,1,3,0,1,0,1
"TORIE",1,3,.25,.75,4,0,0,0,0
"TORRANCE",2,1,.6666667,.3333333,3,0,0,0,0
"TORRENCE",4,0,1,0,4,1,0,1,0
"TOSHIYUKI",2,0,1,0,2,1,0,1,0
"TRACEY-ANN",0,2,0,1,2,0,1,0,1
"TRAE",3,0,1,0,3,1,0,1,0
"TRESA",0,4,0,1,4,0,1,0,1
"TRIANA",0,3,0,1,3,0,1,0,1
"TRILBY",0,3,0,1,3,0,1,0,1
"TRINY",1,3,.25,.75,4,0,0,0,0
"TRULY",3,1,.75,.25,4,0,0,0,0
"TULA",0,3,0,1,3,0,1,0,1
"TULANI",0,4,0,1,4,0,1,0,1
"TULIN",0,3,0,1,3,0,1,0,1
"TULSI",1,1,.5,.5,2,0,0,0,0
"TUNCAY",2,0,1,0,2,1,0,1,0
"TUNISHA",0,3,0,1,3,0,1,0,1
"TURAN",2,0,1,0,2,1,0,1,0
"TURGAY",3,0,1,0,3,1,0,1,0
"TURK",4,1,.8,.2,5,1,0,0,0
"TWANDA",0,2,0,1,2,0,1,0,1
"TWINKLE",0,3,0,1,3,0,1,0,1
"TYA",0,3,0,1,3,0,1,0,1
"TYRICE",3,0,1,0,3,1,0,1,0
"TYRIQUE",3,0,1,0,3,1,0,1,0
"TYRUS",5,0,1,0,5,1,0,1,0
"TYWAN",4,0,1,0,4,1,0,1,0
"TZACHI",3,0,1,0,3,1,0,1,0
"TZIPPORAH",0,3,0,1,3,0,1,0,1
"UDO",2,0,1,0,2,1,0,1,0
"ULIANA",0,3,0,1,3,0,1,0,1
"ULYANA",0,2,0,1,2,0,1,0,1
"UMME",0,2,0,1,2,0,1,0,1
"UNIQUA",0,3,0,1,3,0,1,0,1
"UPENDRA",3,0,1,0,3,1,0,1,0
"URS",2,0,1,0,2,1,0,1,0
"USHI",2,1,.6666667,.3333333,3,0,0,0,0
"VA",0,2,0,1,2,0,1,0,1
"VAHAN",5,0,1,0,5,1,0,1,0
"VALEN",1,2,.3333333,.6666667,3,0,0,0,0
"VALERI",0,2,0,1,2,0,1,0,1
"VALLERIE",0,2,0,1,2,0,1,0,1
"VANETTA",0,5,0,1,5,0,1,0,1
"VARINDER",4,0,1,0,4,1,0,1,0
"VASILY",2,0,1,0,2,1,0,1,0
"VASKEN",3,0,1,0,3,1,0,1,0
"VASUDHA",0,2,0,1,2,0,1,0,1
"VELINA",0,2,0,1,2,0,1,0,1
"VEN",1,1,.5,.5,2,0,0,0,0
"VENISHA",0,2,0,1,2,0,1,0,1
"VENTURA",4,0,1,0,4,1,0,1,0
"VERITY",1,3,.25,.75,4,0,0,0,0
"VERNEL",3,0,1,0,3,1,0,1,0
"VERNESSA",0,2,0,1,2,0,1,0,1
"VESPER",0,2,0,1,2,0,1,0,1
"VIANNY",0,3,0,1,3,0,1,0,1
"VIBEKE",0,3,0,1,3,0,1,0,1
"VIBHA",0,2,0,1,2,0,1,0,1
"VICKIANA",0,2,0,1,2,0,1,0,1
"VIERA",0,4,0,1,4,0,1,0,1
"VILLA",1,2,.3333333,.6666667,3,0,0,0,0
"VILMARIE",0,3,0,1,3,0,1,0,1
"VINESSA",0,3,0,1,3,0,1,0,1
"VINI",3,0,1,0,3,1,0,1,0
"VINO",1,1,.5,.5,2,0,0,0,0
"VINU",2,0,1,0,2,1,0,1,0
"VISUAL",2,0,1,0,2,1,0,1,0
"VIVETTE",0,3,0,1,3,0,1,0,1
"VJOLLCA",0,3,0,1,3,0,1,0,1
"VOLTAIRE",2,0,1,0,2,1,0,1,0
"VONNIE",1,1,.5,.5,2,0,0,0,0
"VRINDA",0,3,0,1,3,0,1,0,1
"VÃÅSQUEZ",1,2,.3333333,.6666667,3,0,0,0,0
"WAHEED",4,0,1,0,4,1,0,1,0
"WAKANA",0,4,0,1,4,0,1,0,1
"WAKE",3,0,1,0,3,1,0,1,0
"WANDER",4,0,1,0,4,1,0,1,0
"WANDY",0,2,0,1,2,0,1,0,1
"WANITA",0,4,0,1,4,0,1,0,1
"WAR",3,0,1,0,3,1,0,1,0
"WASCAR",2,0,1,0,2,1,0,1,0
"WATARU",2,0,1,0,2,1,0,1,0
"WAVE",2,0,1,0,2,1,0,1,0
"WAYAN",3,0,1,0,3,1,0,1,0
"WEE",3,0,1,0,3,1,0,1,0
"WEILING",0,2,0,1,2,0,1,0,1
"WELL",4,0,1,0,4,1,0,1,0
"WENDE",0,2,0,1,2,0,1,0,1
"WENDYANN",0,5,0,1,5,0,1,0,1
"WHEELER",1,1,.5,.5,2,0,0,0,0
"WHERE",2,1,.6666667,.3333333,3,0,0,0,0
"WHITEY",3,1,.75,.25,4,0,0,0,0
"WILKIN",3,0,1,0,3,1,0,1,0
"WORLD",2,0,1,0,2,1,0,1,0
"WRIGHT",1,2,.3333333,.6666667,3,0,0,0,0
"XAVIERA",0,4,0,1,4,0,1,0,1
"XIAOMIN",1,3,.25,.75,4,0,0,0,0
"YAHIA",4,1,.8,.2,5,1,0,0,0
"YAJAHIRA",0,3,0,1,3,0,1,0,1
"YAKUP",4,0,1,0,4,1,0,1,0
"YAMA",1,2,.3333333,.6666667,3,0,0,0,0
"YAMELL",1,1,.5,.5,2,0,0,0,0
"YAMILKA",0,4,0,1,4,0,1,0,1
"YANILDA",0,2,0,1,2,0,1,0,1
"YANITZA",0,3,0,1,3,0,1,0,1
"YANKEES",3,1,.75,.25,4,0,0,0,0
"YANTI",0,4,0,1,4,0,1,0,1
"YARED",4,0,1,0,4,1,0,1,0
"YAT",2,0,1,0,2,1,0,1,0
"YEA",2,0,1,0,2,1,0,1,0
"YEIMI",1,3,.25,.75,4,0,0,0,0
"YEJI",0,2,0,1,2,0,1,0,1
"YENY",0,3,0,1,3,0,1,0,1
"YERI",0,2,0,1,2,0,1,0,1
"YESSIKA",0,2,0,1,2,0,1,0,1
"YETTA",0,2,0,1,2,0,1,0,1
"YEZENIA",0,2,0,1,2,0,1,0,1
"YIANNA",0,2,0,1,2,0,1,0,1
"YIGIT",3,0,1,0,3,1,0,1,0
"YIMING",2,0,1,0,2,1,0,1,0
"YINGJIE",1,2,.3333333,.6666667,3,0,0,0,0
"YINYIN",0,2,0,1,2,0,1,0,1
"YISSEL",0,4,0,1,4,0,1,0,1
"YIWEN",0,3,0,1,3,0,1,0,1
"YLVA",0,3,0,1,3,0,1,0,1
"YNES",0,4,0,1,4,0,1,0,1
"YOCHANAN",4,0,1,0,4,1,0,1,0
"YOMARA",0,2,0,1,2,0,1,0,1
"YOMARIS",0,4,0,1,4,0,1,0,1
"YONAS",2,0,1,0,2,1,0,1,0
"YOONHEE",0,4,0,1,4,0,1,0,1
"YOONIE",0,3,0,1,3,0,1,0,1
"YOONSUN",0,2,0,1,2,0,1,0,1
"YOSELYN",0,3,0,1,3,0,1,0,1
"YOSHIMI",0,3,0,1,3,0,1,0,1
"YOSHINORI",3,0,1,0,3,1,0,1,0
"YOUCEF",3,0,1,0,3,1,0,1,0
"YOUNGMI",0,3,0,1,3,0,1,0,1
"YUDELCA",0,5,0,1,5,0,1,0,1
"YUTAKA",2,1,.6666667,.3333333,3,0,0,0,0
"YUTING",0,2,0,1,2,0,1,0,1
"YUYU",1,1,.5,.5,2,0,0,0,0
"YVETTA",0,4,0,1,4,0,1,0,1
"ZAHIDA",0,3,0,1,3,0,1,0,1
"ZAHIRA",0,2,0,1,2,0,1,0,1
"ZAINA",0,3,0,1,3,0,1,0,1
"ZAQ",2,0,1,0,2,1,0,1,0
"ZAREEN",0,3,0,1,3,0,1,0,1
"ZARINAH",0,2,0,1,2,0,1,0,1
"ZAYDA",0,4,0,1,4,0,1,0,1
"ZE",3,0,1,0,3,1,0,1,0
"ZEENAT",0,3,0,1,3,0,1,0,1
"ZENO",3,1,.75,.25,4,0,0,0,0
"ZIAUL",4,0,1,0,4,1,0,1,0
"ZIN",0,2,0,1,2,0,1,0,1
"ZINEB",0,2,0,1,2,0,1,0,1
"ZIYA",2,1,.6666667,.3333333,3,0,0,0,0
"ZOILO",4,0,1,0,4,1,0,1,0
"ZULAIKA",0,4,0,1,4,0,1,0,1
"ZUZU",1,1,.5,.5,2,0,0,0,0
"AALAP",3,0,1,0,3,1,0,1,0
"ABDI",2,0,1,0,2,1,0,1,0
"ABDO",3,0,1,0,3,1,0,1,0
"ABDOOL",2,0,1,0,2,1,0,1,0
"ABEBA",0,2,0,1,2,0,1,0,1
"ABIDEMI",1,2,.3333333,.6666667,3,0,0,0,0
"ABISHAI",3,0,1,0,3,1,0,1,0
"ABO",2,0,1,0,2,1,0,1,0
"ABRAHAN",3,0,1,0,3,1,0,1,0
"ADAR",1,2,.3333333,.6666667,3,0,0,0,0
"ADARA",0,4,0,1,4,0,1,0,1
"ADEBISI",2,1,.6666667,.3333333,3,0,0,0,0
"ADEDOTUN",3,0,1,0,3,1,0,1,0
"ADEJOKE",0,3,0,1,3,0,1,0,1
"ADEKEMI",1,1,.5,.5,2,0,0,0,0
"ADEPEJU",0,3,0,1,3,0,1,0,1
"ADIKA",3,0,1,0,3,1,0,1,0
"ADINE",0,2,0,1,2,0,1,0,1
"ADNANE",4,0,1,0,4,1,0,1,0
"ADREANA",0,2,0,1,2,0,1,0,1
"ADRENA",0,3,0,1,3,0,1,0,1
"ADRINA",0,2,0,1,2,0,1,0,1
"ADRION",2,0,1,0,2,1,0,1,0
"AE",1,1,.5,.5,2,0,0,0,0
"AERIN",0,3,0,1,3,0,1,0,1
"AFEISHA",0,3,0,1,3,0,1,0,1
"AFREEN",0,2,0,1,2,0,1,0,1
"AGYEI",3,0,1,0,3,1,0,1,0
"AHLEM",0,3,0,1,3,0,1,0,1
"AHMAR",2,0,1,0,2,1,0,1,0
"AHNA",0,2,0,1,2,0,1,0,1
"AIDE",0,4,0,1,4,0,1,0,1
"AIMAN",3,0,1,0,3,1,0,1,0
"AIRAM",2,2,.5,.5,4,0,0,0,0
"AISSA",2,2,.5,.5,4,0,0,0,0
"AIZHAN",0,3,0,1,3,0,1,0,1
"AJAX",4,0,1,0,4,1,0,1,0
"AJDIN",3,0,1,0,3,1,0,1,0
"AJOY",3,0,1,0,3,1,0,1,0
"AKASHA",0,2,0,1,2,0,1,0,1
"AKIBA",1,1,.5,.5,2,0,0,0,0
"AKILI",3,0,1,0,3,1,0,1,0
"AKINYELE",2,0,1,0,2,1,0,1,0
"AKISHA",0,4,0,1,4,0,1,0,1
"AKSANA",0,2,0,1,2,0,1,0,1
"ALAMIN",2,0,1,0,2,1,0,1,0
"ALANI",1,1,.5,.5,2,0,0,0,0
"ALASSANE",4,0,1,0,4,1,0,1,0
"ALBANE",0,3,0,1,3,0,1,0,1
"ALBEIRO",3,0,1,0,3,1,0,1,0
"ALBUS",2,0,1,0,2,1,0,1,0
"ALDANA",1,2,.3333333,.6666667,3,0,0,0,0
"ALDON",3,0,1,0,3,1,0,1,0
"ALEKSEI",3,0,1,0,3,1,0,1,0
"ALELI",0,2,0,1,2,0,1,0,1
"ALEXANDAR",3,0,1,0,3,1,0,1,0
"ALEXANDRINE",0,4,0,1,4,0,1,0,1
"ALEXCIA",0,3,0,1,3,0,1,0,1
"ALEXY",4,0,1,0,4,1,0,1,0
"ALEYA",0,3,0,1,3,0,1,0,1
"ALFI",3,1,.75,.25,4,0,0,0,0
"ALGER",2,0,1,0,2,1,0,1,0
"ALICYN",0,4,0,1,4,0,1,0,1
"ALLENE",0,2,0,1,2,0,1,0,1
"ALLIS",0,2,0,1,2,0,1,0,1
"ALLISEN",0,4,0,1,4,0,1,0,1
"ALLYSA",0,2,0,1,2,0,1,0,1
"ALMAMY",3,0,1,0,3,1,0,1,0
"ALONZA",4,0,1,0,4,1,0,1,0
"ALTAN",3,0,1,0,3,1,0,1,0
"ALUKO",2,0,1,0,2,1,0,1,0
"ALUN",2,0,1,0,2,1,0,1,0
"ALX",2,0,1,0,2,1,0,1,0
"AMADEUS",4,0,1,0,4,1,0,1,0
"AMANY",0,3,0,1,3,0,1,0,1
"AMARILDO",2,0,1,0,2,1,0,1,0
"AMBERLYNN",0,3,0,1,3,0,1,0,1
"AMBRA",0,2,0,1,2,0,1,0,1
"AMESHA",0,4,0,1,4,0,1,0,1
"AMIA",0,3,0,1,3,0,1,0,1
"AMIKA",0,3,0,1,3,0,1,0,1
"AMINTA",0,2,0,1,2,0,1,0,1
"AMO",3,1,.75,.25,4,0,0,0,0
"AMORE",1,2,.3333333,.6666667,3,0,0,0,0
"AMRAN",3,0,1,0,3,1,0,1,0
"AMRIK",3,0,1,0,3,1,0,1,0
"AMRINDER",2,0,1,0,2,1,0,1,0
"AMRISH",2,0,1,0,2,1,0,1,0
"ANAEL",1,1,.5,.5,2,0,0,0,0
"ANAIDA",0,3,0,1,3,0,1,0,1
"ANALIZA",0,3,0,1,3,0,1,0,1
"ANAMARI",0,2,0,1,2,0,1,0,1
"ANASS",3,0,1,0,3,1,0,1,0
"ANASTASYA",0,2,0,1,2,0,1,0,1
"ANATOLE",3,0,1,0,3,1,0,1,0
"ANAYANSI",0,2,0,1,2,0,1,0,1
"ANCHALEE",0,3,0,1,3,0,1,0,1
"ANDILE",1,1,.5,.5,2,0,0,0,0
"ANDRIJA",3,0,1,0,3,1,0,1,0
"ANDROMEDA",1,1,.5,.5,2,0,0,0,0
"ANECIA",0,2,0,1,2,0,1,0,1
"ANEESAH",0,2,0,1,2,0,1,0,1
"ANEISHA",0,2,0,1,2,0,1,0,1
"ANGELLO",4,0,1,0,4,1,0,1,0
"ANGELYS",0,3,0,1,3,0,1,0,1
"ANGERY",4,0,1,0,4,1,0,1,0
"ANIEKA",0,3,0,1,3,0,1,0,1
"ANISIA",0,3,0,1,3,0,1,0,1
"ANJ",0,2,0,1,2,0,1,0,1
"ANJAN",2,0,1,0,2,1,0,1,0
"ANJELIKA",0,2,0,1,2,0,1,0,1
"ANJELIQUE",0,4,0,1,4,0,1,0,1
"ANNA-KAY",0,4,0,1,4,0,1,0,1
"ANNALEE",0,2,0,1,2,0,1,0,1
"ANNASTASIA",0,4,0,1,4,0,1,0,1
"ANN-MARGARET",0,2,0,1,2,0,1,0,1
"ANOUCK",0,2,0,1,2,0,1,0,1
"ANOUSH",0,2,0,1,2,0,1,0,1
"ANRI",2,0,1,0,2,1,0,1,0
"ANSAR",2,0,1,0,2,1,0,1,0
"ANSLEM",2,0,1,0,2,1,0,1,0
"ANTHONEY",3,0,1,0,3,1,0,1,0
"ANTIA",0,4,0,1,4,0,1,0,1
"ANTOIN",2,0,1,0,2,1,0,1,0
"ANTONIN",3,0,1,0,3,1,0,1,0
"ANTWANN",4,0,1,0,4,1,0,1,0
"ANVAR",2,1,.6666667,.3333333,3,0,0,0,0
"ANZHELA",0,4,0,1,4,0,1,0,1
"AO",1,1,.5,.5,2,0,0,0,0
"APHRODITE",0,2,0,1,2,0,1,0,1
"APOLONIA",0,3,0,1,3,0,1,0,1
"AQUANETTA",0,2,0,1,2,0,1,0,1
"AQUEELAH",0,3,0,1,3,0,1,0,1
"ARADHANA",1,1,.5,.5,2,0,0,0,0
"ARATHI",0,2,0,1,2,0,1,0,1
"ARATI",0,3,0,1,3,0,1,0,1
"ARBY",1,1,.5,.5,2,0,0,0,0
"ARCADIO",2,0,1,0,2,1,0,1,0
"ARCENIO",3,1,.75,.25,4,0,0,0,0
"ARDIANA",0,2,0,1,2,0,1,0,1
"ARE",2,0,1,0,2,1,0,1,0
"AREUM",0,3,0,1,3,0,1,0,1
"ARGELIA",0,3,0,1,3,0,1,0,1
"ARIAS",2,1,.6666667,.3333333,3,0,0,0,0
"ARIJIT",3,0,1,0,3,1,0,1,0
"ARINZE",2,0,1,0,2,1,0,1,0
"ARITA",0,3,0,1,3,0,1,0,1
"ARLA",0,3,0,1,3,0,1,0,1
"ARLET",0,2,0,1,2,0,1,0,1
"ARLETT",0,2,0,1,2,0,1,0,1
"ARLO",3,1,.75,.25,4,0,0,0,0
"ARLYNNE",0,2,0,1,2,0,1,0,1
"ARMI",1,1,.5,.5,2,0,0,0,0
"ARMINDA",0,4,0,1,4,0,1,0,1
"ARNI",4,0,1,0,4,1,0,1,0
"AROLDO",3,0,1,0,3,1,0,1,0
"ARVINDER",4,0,1,0,4,1,0,1,0
"ASAEL",3,0,1,0,3,1,0,1,0
"ASHAKI",0,3,0,1,3,0,1,0,1
"ASHFORD",3,0,1,0,3,1,0,1,0
"ASHIA",0,2,0,1,2,0,1,0,1
"ASHLEEN",0,2,0,1,2,0,1,0,1
"ASHNA",0,2,0,1,2,0,1,0,1
"ASIL",2,0,1,0,2,1,0,1,0
"ASTLEY",2,0,1,0,2,1,0,1,0
"ASUNCION",1,1,.5,.5,2,0,0,0,0
"AT",1,1,.5,.5,2,0,0,0,0
"ATASHA",0,3,0,1,3,0,1,0,1
"ATHAN",3,0,1,0,3,1,0,1,0
"ATHENIA",0,3,0,1,3,0,1,0,1
"ATIQ",3,0,1,0,3,1,0,1,0
"ATLANTIC",1,1,.5,.5,2,0,0,0,0
"AU",0,2,0,1,2,0,1,0,1
"AUDRIUS",3,0,1,0,3,1,0,1,0
"AURY",0,4,0,1,4,0,1,0,1
"AUSAR",1,1,.5,.5,2,0,0,0,0
"AUTHOR",3,0,1,0,3,1,0,1,0
"AVANTI",0,2,0,1,2,0,1,0,1
"AVELINO",4,0,1,0,4,1,0,1,0
"AVERIE",0,2,0,1,2,0,1,0,1
"AVICHAI",2,0,1,0,2,1,0,1,0
"AVIJIT",3,0,1,0,3,1,0,1,0
"AVRA",0,2,0,1,2,0,1,0,1
"AVROMI",3,0,1,0,3,1,0,1,0
"AYNUR",0,3,0,1,3,0,1,0,1
"AYOUB",4,0,1,0,4,1,0,1,0
"AZZAM",4,0,1,0,4,1,0,1,0
"BABACAR",3,0,1,0,3,1,0,1,0
"BADRI",3,0,1,0,3,1,0,1,0
"BAE",0,3,0,1,3,0,1,0,1
"BALL",1,1,.5,.5,2,0,0,0,0
"BALTHAZAR",3,0,1,0,3,1,0,1,0
"BANNY",1,1,.5,.5,2,0,0,0,0
"BARAKA",2,0,1,0,2,1,0,1,0
"BARBOSA",1,1,.5,.5,2,0,0,0,0
"BARRET",2,1,.6666667,.3333333,3,0,0,0,0
"BAS",2,0,1,0,2,1,0,1,0
"BATES",2,0,1,0,2,1,0,1,0
"BATU",2,0,1,0,2,1,0,1,0
"BAYARD",2,0,1,0,2,1,0,1,0
"BAYRAM",2,0,1,0,2,1,0,1,0
"BAYU",3,0,1,0,3,1,0,1,0
"BEACH",2,0,1,0,2,1,0,1,0
"BEAN",2,0,1,0,2,1,0,1,0
"BEBO",3,0,1,0,3,1,0,1,0
"BECCI",0,2,0,1,2,0,1,0,1
"BECKETT",2,0,1,0,2,1,0,1,0
"BEDFORD",3,1,.75,.25,4,0,0,0,0
"BEHNAM",3,0,1,0,3,1,0,1,0
"BEK",1,2,.3333333,.6666667,3,0,0,0,0
"BEKI",0,3,0,1,3,0,1,0,1
"BELKY",0,3,0,1,3,0,1,0,1
"BELTRAN",2,1,.6666667,.3333333,3,0,0,0,0
"BENA",0,2,0,1,2,0,1,0,1
"BENEDIKT",3,0,1,0,3,1,0,1,0
"BENT",1,1,.5,.5,2,0,0,0,0
"BERIL",0,3,0,1,3,0,1,0,1
"BERIT",0,2,0,1,2,0,1,0,1
"BERKE",2,0,1,0,2,1,0,1,0
"BERNARDA",0,3,0,1,3,0,1,0,1
"BERTON",4,0,1,0,4,1,0,1,0
"BERTY",2,0,1,0,2,1,0,1,0
"BETHEL",0,3,0,1,3,0,1,0,1
"BETHSAIDA",0,3,0,1,3,0,1,0,1
"BETHZAIDA",0,3,0,1,3,0,1,0,1
"BETSAIDA",0,4,0,1,4,0,1,0,1
"BETTSY",0,3,0,1,3,0,1,0,1
"BEZALEL",2,0,1,0,2,1,0,1,0
"BHASH",3,0,1,0,3,1,0,1,0
"BHAVANA",0,2,0,1,2,0,1,0,1
"BHAVANI",0,4,0,1,4,0,1,0,1
"BHUMIKA",0,2,0,1,2,0,1,0,1
"BIANNY",1,2,.3333333,.6666667,3,0,0,0,0
"BIBO",1,1,.5,.5,2,0,0,0,0
"BIGGY",2,0,1,0,2,1,0,1,0
"BILGIN",2,0,1,0,2,1,0,1,0
"BILLUR",0,3,0,1,3,0,1,0,1
"BIRDIE",1,3,.25,.75,4,0,0,0,0
"BIRDY",1,2,.3333333,.6666667,3,0,0,0,0
"BJOERN",2,0,1,0,2,1,0,1,0
"BLAIN",3,0,1,0,3,1,0,1,0
"BLENDI",4,0,1,0,4,1,0,1,0
"BLEU",2,0,1,0,2,1,0,1,0
"BLIMIE",0,2,0,1,2,0,1,0,1
"BLIND",3,1,.75,.25,4,0,0,0,0
"BLING",2,0,1,0,2,1,0,1,0
"BLOCK",2,0,1,0,2,1,0,1,0
"BOBAN",4,0,1,0,4,1,0,1,0
"BOCA",2,1,.6666667,.3333333,3,0,0,0,0
"BODE",3,0,1,0,3,1,0,1,0
"BODIE",3,0,1,0,3,1,0,1,0
"BOLAJI",3,0,1,0,3,1,0,1,0
"BOLANLE",0,3,0,1,3,0,1,0,1
"BONIFACIO",2,0,1,0,2,1,0,1,0
"BOOTH",2,0,1,0,2,1,0,1,0
"BORJA",4,0,1,0,4,1,0,1,0
"BOSTON",3,0,1,0,3,1,0,1,0
"BRAVO",1,2,.3333333,.6666667,3,0,0,0,0
"BRENDALEE",0,2,0,1,2,0,1,0,1
"BRENDALIZ",0,2,0,1,2,0,1,0,1
"BRIANDA",0,3,0,1,3,0,1,0,1
"BRIGHID",0,2,0,1,2,0,1,0,1
"BRISTOL",0,2,0,1,2,0,1,0,1
"BRITTANEY",0,3,0,1,3,0,1,0,1
"BRKLYN",2,1,.6666667,.3333333,3,0,0,0,0
"BROWNIE",0,3,0,1,3,0,1,0,1
"BRUNIE",0,2,0,1,2,0,1,0,1
"BRYNNA",0,3,0,1,3,0,1,0,1
"BUDDA",2,0,1,0,2,1,0,1,0
"BUG",1,1,.5,.5,2,0,0,0,0
"BULLET",4,0,1,0,4,1,0,1,0
"BURGESS",1,2,.3333333,.6666667,3,0,0,0,0
"BURNS",2,0,1,0,2,1,0,1,0
"BUSTA",2,0,1,0,2,1,0,1,0
"BUTT",2,1,.6666667,.3333333,3,0,0,0,0
"BUTTERS",2,1,.6666667,.3333333,3,0,0,0,0
"BÃÅLINT",2,0,1,0,2,1,0,1,0
"CAGNEY",1,1,.5,.5,2,0,0,0,0
"CAGRI",2,1,.6666667,.3333333,3,0,0,0,0
"CAITLYNN",0,2,0,1,2,0,1,0,1
"CALISHA",0,3,0,1,3,0,1,0,1
"CALISTA",0,3,0,1,3,0,1,0,1
"CAMBRIA",0,2,0,1,2,0,1,0,1
"CAMMI",0,2,0,1,2,0,1,0,1
"CANDELA",1,1,.5,.5,2,0,0,0,0
"CANINE",2,1,.6666667,.3333333,3,0,0,0,0
"CANO",2,0,1,0,2,1,0,1,0
"CARDELL",3,0,1,0,3,1,0,1,0
"CAREEN",0,3,0,1,3,0,1,0,1
"CARENE",0,3,0,1,3,0,1,0,1
"CARESS",0,4,0,1,4,0,1,0,1
"CARLETTA",0,2,0,1,2,0,1,0,1
"CARLSON",2,0,1,0,2,1,0,1,0
"CARLYNE",0,2,0,1,2,0,1,0,1
"CARRIEANN",0,3,0,1,3,0,1,0,1
"CASE",1,1,.5,.5,2,0,0,0,0
"CASSIS",0,2,0,1,2,0,1,0,1
"CATHERIN",0,2,0,1,2,0,1,0,1
"CAVELLE",0,3,0,1,3,0,1,0,1
"CEA",0,2,0,1,2,0,1,0,1
"CEASER",2,0,1,0,2,1,0,1,0
"CEFERINO",4,0,1,0,4,1,0,1,0
"CELEST",0,2,0,1,2,0,1,0,1
"CELESTINO",3,0,1,0,3,1,0,1,0
"CELIL",3,0,1,0,3,1,0,1,0
"CELISE",0,4,0,1,4,0,1,0,1
"CERRONE",2,2,.5,.5,4,0,0,0,0
"CEVDET",2,0,1,0,2,1,0,1,0
"CHABAD",2,0,1,0,2,1,0,1,0
"CHADI",2,0,1,0,2,1,0,1,0
"CHAGIT",0,2,0,1,2,0,1,0,1
"CHAK",2,0,1,0,2,1,0,1,0
"CHAND",1,2,.3333333,.6666667,3,0,0,0,0
"CHANE",1,2,.3333333,.6666667,3,0,0,0,0
"CHANNELL",0,3,0,1,3,0,1,0,1
"CHANTALLE",0,2,0,1,2,0,1,0,1
"CHARA",0,3,0,1,3,0,1,0,1
"CHARELLE",0,2,0,1,2,0,1,0,1
"CHARLISE",0,3,0,1,3,0,1,0,1
"CHARMAGNE",0,2,0,1,2,0,1,0,1
"CHARMIN",0,2,0,1,2,0,1,0,1
"CHARNISE",0,4,0,1,4,0,1,0,1
"CHASSIDY",0,3,0,1,3,0,1,0,1
"CHAVIVA",0,3,0,1,3,0,1,0,1
"CHAVONNE",0,2,0,1,2,0,1,0,1
"CHAVY",0,3,0,1,3,0,1,0,1
"CHAYIM",2,0,1,0,2,1,0,1,0
"CHEILA",0,2,0,1,2,0,1,0,1
"CHENELL",0,4,0,1,4,0,1,0,1
"CHENEQUA",0,2,0,1,2,0,1,0,1
"CHEREESE",0,2,0,1,2,0,1,0,1
"CHERIF",2,0,1,0,2,1,0,1,0
"CHERISA",0,2,0,1,2,0,1,0,1
"CHERLYN",0,2,0,1,2,0,1,0,1
"CHERRELLE",0,3,0,1,3,0,1,0,1
"CHERYLLE",0,3,0,1,3,0,1,0,1
"CHETNA",0,2,0,1,2,0,1,0,1
"CHEVY",0,2,0,1,2,0,1,0,1
"CHEW",2,1,.6666667,.3333333,3,0,0,0,0
"CHEYNE",1,1,.5,.5,2,0,0,0,0
"CHIARRA",0,4,0,1,4,0,1,0,1
"CHIDINMA",0,4,0,1,4,0,1,0,1
"CHIH-WEI",2,0,1,0,2,1,0,1,0
"CHIINA",1,2,.3333333,.6666667,3,0,0,0,0
"CHILI",2,1,.6666667,.3333333,3,0,0,0,0
"CHINITA",0,2,0,1,2,0,1,0,1
"CHIPPY",2,2,.5,.5,4,0,0,0,0
"CHIZOBA",0,2,0,1,2,0,1,0,1
"CHRISELLE",0,3,0,1,3,0,1,0,1
"CHRISSA",0,2,0,1,2,0,1,0,1
"CHRISTER",3,0,1,0,3,1,0,1,0
"CHRISTIA",0,2,0,1,2,0,1,0,1
"CHRISTIEN",1,2,.3333333,.6666667,3,0,0,0,0
"CHRISTOF",2,0,1,0,2,1,0,1,0
"CHRYSTINE",0,2,0,1,2,0,1,0,1
"CHUAN",2,0,1,0,2,1,0,1,0
"CHUL",2,0,1,0,2,1,0,1,0
"CI",3,0,1,0,3,1,0,1,0
"CINDA",0,2,0,1,2,0,1,0,1
"CINTRA",0,3,0,1,3,0,1,0,1
"CIRILO",4,0,1,0,4,1,0,1,0
"CITA",0,2,0,1,2,0,1,0,1
"CLAIBORNE",1,1,.5,.5,2,0,0,0,0
"CLARIS",0,3,0,1,3,0,1,0,1
"CLARIZA",0,3,0,1,3,0,1,0,1
"CLAUDENE",0,3,0,1,3,0,1,0,1
"CLAUDIU",4,0,1,0,4,1,0,1,0
"CLAUDIUS",4,0,1,0,4,1,0,1,0
"CLAUS",2,0,1,0,2,1,0,1,0
"CLEARY",1,3,.25,.75,4,0,0,0,0
"CLODAGH",0,3,0,1,3,0,1,0,1
"CLOUD",2,0,1,0,2,1,0,1,0
"CONNELL",3,1,.75,.25,4,0,0,0,0
"CORBY",1,1,.5,.5,2,0,0,0,0
"COREE",0,3,0,1,3,0,1,0,1
"CORKY",2,1,.6666667,.3333333,3,0,0,0,0
"CORNELIO",2,0,1,0,2,1,0,1,0
"CORNELIU",4,0,1,0,4,1,0,1,0
"CORRIN",0,2,0,1,2,0,1,0,1
"COSTIN",2,0,1,0,2,1,0,1,0
"COURTLAND",2,0,1,0,2,1,0,1,0
"COURTNIE",0,2,0,1,2,0,1,0,1
"COUSIN",3,1,.75,.25,4,0,0,0,0
"COZY",1,2,.3333333,.6666667,3,0,0,0,0
"CRAWFORD",2,0,1,0,2,1,0,1,0
"CRES",0,2,0,1,2,0,1,0,1
"CRISTOPHER",4,0,1,0,4,1,0,1,0
"CRIZ",2,1,.6666667,.3333333,3,0,0,0,0
"CROSS",3,0,1,0,3,1,0,1,0
"CROWN",3,0,1,0,3,1,0,1,0
"CUCA",0,3,0,1,3,0,1,0,1
"CURTISS",2,0,1,0,2,1,0,1,0
"CYNDEE",0,2,0,1,2,0,1,0,1
"CYNDIA",0,3,0,1,3,0,1,0,1
"CYRENE",0,2,0,1,2,0,1,0,1
"CYRIELLE",0,2,0,1,2,0,1,0,1
"CZARINA",0,3,0,1,3,0,1,0,1
"DADO",1,1,.5,.5,2,0,0,0,0
"DAGAN",3,0,1,0,3,1,0,1,0
"DAGNY",0,2,0,1,2,0,1,0,1
"DALEY",1,1,.5,.5,2,0,0,0,0
"DAMANY",3,0,1,0,3,1,0,1,0
"DAMIANA",0,2,0,1,2,0,1,0,1
"DAMOND",4,0,1,0,4,1,0,1,0
"DANAMARIE",0,2,0,1,2,0,1,0,1
"DANAY",0,2,0,1,2,0,1,0,1
"DANII",0,3,0,1,3,0,1,0,1
"DANNIELLA",0,2,0,1,2,0,1,0,1
"DANQING",0,3,0,1,3,0,1,0,1
"DAO",2,1,.6666667,.3333333,3,0,0,0,0
"DAPHANE",1,2,.3333333,.6666667,3,0,0,0,0
"DAPPA",4,0,1,0,4,1,0,1,0
"DAQUON",3,0,1,0,3,1,0,1,0
"DARCEY",0,3,0,1,3,0,1,0,1
"DARE",3,0,1,0,3,1,0,1,0
"DAREL",0,2,0,1,2,0,1,0,1
"DARIC",4,0,1,0,4,1,0,1,0
"DARILYN",0,2,0,1,2,0,1,0,1
"DARITZA",0,3,0,1,3,0,1,0,1
"DARLIN",1,1,.5,.5,2,0,0,0,0
"DARLYN",1,2,.3333333,.6666667,3,0,0,0,0
"DARRIAN",2,0,1,0,2,1,0,1,0
"DARRYLE",1,1,.5,.5,2,0,0,0,0
"DARSHANA",0,3,0,1,3,0,1,0,1
"DARSHANIE",0,3,0,1,3,0,1,0,1
"DARYLE",2,1,.6666667,.3333333,3,0,0,0,0
"DASEAN",2,0,1,0,2,1,0,1,0
"DASHIA",0,2,0,1,2,0,1,0,1
"DASI",0,2,0,1,2,0,1,0,1
"DAV",3,0,1,0,3,1,0,1,0
"DAVA",0,3,0,1,3,0,1,0,1
"DAVISON",3,0,1,0,3,1,0,1,0
"DAVUT",2,0,1,0,2,1,0,1,0
"DAWAN",2,1,.6666667,.3333333,3,0,0,0,0
"DAWN-MARIE",0,2,0,1,2,0,1,0,1
"DAYQUAN",2,0,1,0,2,1,0,1,0
"DEANDREA",0,4,0,1,4,0,1,0,1
"DEBASHISH",2,0,1,0,2,1,0,1,0
"DEBBE",0,3,0,1,3,0,1,0,1
"DEBIE",0,2,0,1,2,0,1,0,1
"DEBS",0,2,0,1,2,0,1,0,1
"DEBY",0,2,0,1,2,0,1,0,1
"DEE-DEE",0,2,0,1,2,0,1,0,1
"DELAINE",0,3,0,1,3,0,1,0,1
"DELBERT",4,0,1,0,4,1,0,1,0
"DELIMAR",0,2,0,1,2,0,1,0,1
"DELVON",4,0,1,0,4,1,0,1,0
"DEMARCO",3,0,1,0,3,1,0,1,0
"DEMARIS",0,2,0,1,2,0,1,0,1
"DEMETRIOUS",2,0,1,0,2,1,0,1,0
"DEMITRIUS",3,0,1,0,3,1,0,1,0
"DEMO",3,0,1,0,3,1,0,1,0
"DENEAN",0,4,0,1,4,0,1,0,1
"DENEE",0,3,0,1,3,0,1,0,1
"DENIESHA",0,3,0,1,3,0,1,0,1
"DENITA",0,3,0,1,3,0,1,0,1
"DENO",2,0,1,0,2,1,0,1,0
"DEONNE",0,2,0,1,2,0,1,0,1
"DERBY",3,0,1,0,3,1,0,1,0
"DERLY",1,2,.3333333,.6666667,3,0,0,0,0
"DERREK",2,0,1,0,2,1,0,1,0
"DERRIN",1,1,.5,.5,2,0,0,0,0
"DESA",0,4,0,1,4,0,1,0,1
"DESIREA",0,3,0,1,3,0,1,0,1
"DESLYN",0,2,0,1,2,0,1,0,1
"DESTA",2,1,.6666667,.3333333,3,0,0,0,0
"DESY",0,2,0,1,2,0,1,0,1
"DEVAL",3,0,1,0,3,1,0,1,0
"DEVANSHI",0,2,0,1,2,0,1,0,1
"DEVINE",1,1,.5,.5,2,0,0,0,0
"DEVORY",2,1,.6666667,.3333333,3,0,0,0,0
"DEYANIRIS",0,2,0,1,2,0,1,0,1
"DEZI",1,1,.5,.5,2,0,0,0,0
"DGANIT",0,2,0,1,2,0,1,0,1
"DIAMANTE",1,3,.25,.75,4,0,0,0,0
"DIARRA",1,1,.5,.5,2,0,0,0,0
"DIEDERIK",2,0,1,0,2,1,0,1,0
"DIETRA",0,4,0,1,4,0,1,0,1
"DIG",2,1,.6666667,.3333333,3,0,0,0,0
"DIGI",1,1,.5,.5,2,0,0,0,0
"DIKE",2,0,1,0,2,1,0,1,0
"DILENIA",0,3,0,1,3,0,1,0,1
"DILIANA",0,4,0,1,4,0,1,0,1
"DILMA",0,2,0,1,2,0,1,0,1
"DILYARA",0,3,0,1,3,0,1,0,1
"DINDO",3,0,1,0,3,1,0,1,0
"DIONDRA",0,3,0,1,3,0,1,0,1
"DIPEN",2,0,1,0,2,1,0,1,0
"DIPO",2,0,1,0,2,1,0,1,0
"DIPU",4,0,1,0,4,1,0,1,0
"DOAN",2,1,.6666667,.3333333,3,0,0,0,0
"DODD",3,0,1,0,3,1,0,1,0
"DOLAN",3,0,1,0,3,1,0,1,0
"DOLKAR",0,3,0,1,3,0,1,0,1
"DOLLA",1,1,.5,.5,2,0,0,0,0
"DOLLIE",0,4,0,1,4,0,1,0,1
"DONETTA",0,4,0,1,4,0,1,0,1
"DONGHEE",1,1,.5,.5,2,0,0,0,0
"DORIEN",1,2,.3333333,.6666667,3,0,0,0,0
"DORKA",0,2,0,1,2,0,1,0,1
"DORU",3,0,1,0,3,1,0,1,0
"DOTUN",3,0,1,0,3,1,0,1,0
"DOVE",0,2,0,1,2,0,1,0,1
"DRAGO",4,0,1,0,4,1,0,1,0
"DRAYTON",3,0,1,0,3,1,0,1,0
"DREY",4,0,1,0,4,1,0,1,0
"DRO",4,0,1,0,4,1,0,1,0
"DRUCILLA",0,3,0,1,3,0,1,0,1
"DU",2,1,.6666667,.3333333,3,0,0,0,0
"DUANA",0,2,0,1,2,0,1,0,1
"DUCK",2,0,1,0,2,1,0,1,0
"DUCKY",2,2,.5,.5,4,0,0,0,0
"DULAL",3,0,1,0,3,1,0,1,0
"DUNSTAN",4,0,1,0,4,1,0,1,0
"DUO",2,1,.6666667,.3333333,3,0,0,0,0
"DUPREE",2,0,1,0,2,1,0,1,0
"DUTTY",2,1,.6666667,.3333333,3,0,0,0,0
"DVORAH",0,2,0,1,2,0,1,0,1
"DWANA",0,2,0,1,2,0,1,0,1
"DWI",1,3,.25,.75,4,0,0,0,0
"DYAMOND",0,3,0,1,3,0,1,0,1
"DYLLAN",3,0,1,0,3,1,0,1,0
"EBI",1,1,.5,.5,2,0,0,0,0
"EBON",1,1,.5,.5,2,0,0,0,0
"EDANIA",0,2,0,1,2,0,1,0,1
"EDE",1,1,.5,.5,2,0,0,0,0
"EDELIN",0,2,0,1,2,0,1,0,1
"EDELINE",0,3,0,1,3,0,1,0,1
"EDENA",0,2,0,1,2,0,1,0,1
"EDILBERTO",2,0,1,0,2,1,0,1,0
"EDLIRA",0,3,0,1,3,0,1,0,1
"EDLYN",0,2,0,1,2,0,1,0,1
"EDMAR",4,0,1,0,4,1,0,1,0
"EDRICK",3,0,1,0,3,1,0,1,0
"EDSEL",2,0,1,0,2,1,0,1,0
"EDU",2,0,1,0,2,1,0,1,0
"EDWIDGE",2,2,.5,.5,4,0,0,0,0
"EDZ",3,1,.75,.25,4,0,0,0,0
"EGOR",3,0,1,0,3,1,0,1,0
"EIGO",2,0,1,0,2,1,0,1,0
"EIJI",2,0,1,0,2,1,0,1,0
"EILYN",0,3,0,1,3,0,1,0,1
"EINAR",2,0,1,0,2,1,0,1,0
"EIRINI",0,3,0,1,3,0,1,0,1
"EJAY",2,0,1,0,2,1,0,1,0
"EKATERINE",0,2,0,1,2,0,1,0,1
"ELAZAR",1,1,.5,.5,2,0,0,0,0
"ELDINA",0,2,0,1,2,0,1,0,1
"ELDWIN",3,0,1,0,3,1,0,1,0
"ELEANORA",0,3,0,1,3,0,1,0,1
"ELECIA",0,2,0,1,2,0,1,0,1
"ELENITA",0,3,0,1,3,0,1,0,1
"ELHADJI",4,0,1,0,4,1,0,1,0
"ELIAD",2,0,1,0,2,1,0,1,0
"ELINDA",0,2,0,1,2,0,1,0,1
"ELINORE",0,2,0,1,2,0,1,0,1
"ELIOTT",3,0,1,0,3,1,0,1,0
"ELISHAMA",0,2,0,1,2,0,1,0,1
"ELISIA",0,3,0,1,3,0,1,0,1
"ELKY",0,2,0,1,2,0,1,0,1
"ELLINA",0,2,0,1,2,0,1,0,1
"ELLINGTON",2,0,1,0,2,1,0,1,0
"ELMAR",4,0,1,0,4,1,0,1,0
"ELMIR",2,0,1,0,2,1,0,1,0
"ELORA",0,2,0,1,2,0,1,0,1
"ELPIDIO",4,0,1,0,4,1,0,1,0
"ELYA",1,1,.5,.5,2,0,0,0,0
"ELYNN",0,2,0,1,2,0,1,0,1
"ELYSHA",1,1,.5,.5,2,0,0,0,0
"EMBER",0,3,0,1,3,0,1,0,1
"EMELIN",1,2,.3333333,.6666667,3,0,0,0,0
"EMEM",2,2,.5,.5,4,0,0,0,0
"EMERITA",0,2,0,1,2,0,1,0,1
"EMILCE",0,3,0,1,3,0,1,0,1
"EMILIYA",0,2,0,1,2,0,1,0,1
"EMIRHAN",4,0,1,0,4,1,0,1,0
"EMMYLOU",0,4,0,1,4,0,1,0,1
"EMPERATRIZ",0,2,0,1,2,0,1,0,1
"EMRAN",3,0,1,0,3,1,0,1,0
"ENI",0,2,0,1,2,0,1,0,1
"ENNA",0,3,0,1,3,0,1,0,1
"EPHIE",1,1,.5,.5,2,0,0,0,0
"ERALD",2,0,1,0,2,1,0,1,0
"ERASMO",2,0,1,0,2,1,0,1,0
"ERGIN",3,0,1,0,3,1,0,1,0
"ERGYS",4,0,1,0,4,1,0,1,0
"ERLYN",2,0,1,0,2,1,0,1,0
"ERMIN",3,0,1,0,3,1,0,1,0
"ERON",2,0,1,0,2,1,0,1,0
"ERRIN",0,2,0,1,2,0,1,0,1
"ERVIS",4,0,1,0,4,1,0,1,0
"ERYKAH",0,2,0,1,2,0,1,0,1
"ESHWAR",2,0,1,0,2,1,0,1,0
"ESLYN",0,3,0,1,3,0,1,0,1
"ESMIR",2,0,1,0,2,1,0,1,0
"ESMOND",3,0,1,0,3,1,0,1,0
"ESSAM",2,0,1,0,2,1,0,1,0
"ESTEPHANIE",0,3,0,1,3,0,1,0,1
"ESTEPHANY",0,3,0,1,3,0,1,0,1
"ESTRELLITA",0,2,0,1,2,0,1,0,1
"ETERNAL",2,0,1,0,2,1,0,1,0
"ETY",1,3,.25,.75,4,0,0,0,0
"EUGINE",2,1,.6666667,.3333333,3,0,0,0,0
"EULALIA",0,2,0,1,2,0,1,0,1
"EUNHEE",0,3,0,1,3,0,1,0,1
"EUNJEE",0,2,0,1,2,0,1,0,1
"EURY",2,0,1,0,2,1,0,1,0
"EVARISTO",2,0,1,0,2,1,0,1,0
"EVERLYN",0,3,0,1,3,0,1,0,1
"EVIL",4,0,1,0,4,1,0,1,0
"EVRIM",1,1,.5,.5,2,0,0,0,0
"EVYAN",0,2,0,1,2,0,1,0,1
"EVYN",1,1,.5,.5,2,0,0,0,0
"EXPEDITO",3,0,1,0,3,1,0,1,0
"EYON",4,0,1,0,4,1,0,1,0
"FABRIZIA",0,2,0,1,2,0,1,0,1
"FADWA",0,2,0,1,2,0,1,0,1
"FAIK",3,0,1,0,3,1,0,1,0
"FAMILIA",0,2,0,1,2,0,1,0,1
"FANFAN",1,3,.25,.75,4,0,0,0,0
"FANYA",0,2,0,1,2,0,1,0,1
"FARIDUN",2,0,1,0,2,1,0,1,0
"FARON",1,1,.5,.5,2,0,0,0,0
"FARRA",0,2,0,1,2,0,1,0,1
"FARRON",1,1,.5,.5,2,0,0,0,0
"FARUQUE",3,0,1,0,3,1,0,1,0
"FARYN",0,2,0,1,2,0,1,0,1
"FATEEMA",0,2,0,1,2,0,1,0,1
"FATHIMA",0,3,0,1,3,0,1,0,1
"FATI",1,3,.25,.75,4,0,0,0,0
"FATU",0,4,0,1,4,0,1,0,1
"FAUZIA",0,2,0,1,2,0,1,0,1
"FELA",1,1,.5,.5,2,0,0,0,0
"FELINA",0,2,0,1,2,0,1,0,1
"FELIPPE",2,0,1,0,2,1,0,1,0
"FELITA",0,3,0,1,3,0,1,0,1
"FENNY",0,2,0,1,2,0,1,0,1
"FENTON",2,0,1,0,2,1,0,1,0
"FERDI",2,0,1,0,2,1,0,1,0
"FERGUSON",0,3,0,1,3,0,1,0,1
"FERIT",3,0,1,0,3,1,0,1,0
"FEROZ",3,1,.75,.25,4,0,0,0,0
"FERRY",2,0,1,0,2,1,0,1,0
"FESTUS",4,0,1,0,4,1,0,1,0
"FEY",1,1,.5,.5,2,0,0,0,0
"FEZ",2,0,1,0,2,1,0,1,0
"FIDES",0,2,0,1,2,0,1,0,1
"FIFTH",3,0,1,0,3,1,0,1,0
"FIGUEROA",1,3,.25,.75,4,0,0,0,0
"FILIPP",2,0,1,0,2,1,0,1,0
"FILTHY",2,2,.5,.5,4,0,0,0,0
"FINOLA",0,2,0,1,2,0,1,0,1
"FIONNA",0,3,0,1,3,0,1,0,1
"FIRUZ",4,0,1,0,4,1,0,1,0
"FLACA",0,3,0,1,3,0,1,0,1
"FLACO",3,0,1,0,3,1,0,1,0
"FLAVIUS",3,0,1,0,3,1,0,1,0
"FLERIDA",0,2,0,1,2,0,1,0,1
"FLINT",2,0,1,0,2,1,0,1,0
"FLORANGEL",0,2,0,1,2,0,1,0,1
"FLORDELIZA",0,3,0,1,3,0,1,0,1
"FLORENTINA",0,3,0,1,3,0,1,0,1
"FLORIDA",0,3,0,1,3,0,1,0,1
"FLORY",0,3,0,1,3,0,1,0,1
"FOAD",4,0,1,0,4,1,0,1,0
"FOLARIN",2,0,1,0,2,1,0,1,0
"FOTO",2,1,.6666667,.3333333,3,0,0,0,0
"FRANCKY",3,0,1,0,3,1,0,1,0
"FRANCOIS-XAVIER",2,0,1,0,2,1,0,1,0
"FRANCYS",2,2,.5,.5,4,0,0,0,0
"FRANDY",4,0,1,0,4,1,0,1,0
"FRANI",0,3,0,1,3,0,1,0,1
"FRANKO",3,0,1,0,3,1,0,1,0
"FRANTZY",2,0,1,0,2,1,0,1,0
"FRAUKE",0,2,0,1,2,0,1,0,1
"FREDDI",0,3,0,1,3,0,1,0,1
"FREDERICKA",0,4,0,1,4,0,1,0,1
"FREDRIKA",0,2,0,1,2,0,1,0,1
"FREIDA",0,2,0,1,2,0,1,0,1
"FRIDAY",2,2,.5,.5,4,0,0,0,0
"FRIEND",1,2,.3333333,.6666667,3,0,0,0,0
"FRITZIE",1,2,.3333333,.6666667,3,0,0,0,0
"FUJI",2,0,1,0,2,1,0,1,0
"FUMIE",0,4,0,1,4,0,1,0,1
"GABBI",0,3,0,1,3,0,1,0,1
"GABO",3,0,1,0,3,1,0,1,0
"GADDY",2,0,1,0,2,1,0,1,0
"GAE",0,2,0,1,2,0,1,0,1
"GAETANA",0,2,0,1,2,0,1,0,1
"GAITREE",0,4,0,1,4,0,1,0,1
"GALLAGHER",1,1,.5,.5,2,0,0,0,0
"GAN",2,1,.6666667,.3333333,3,0,0,0,0
"GANG",2,0,1,0,2,1,0,1,0
"GANI",2,0,1,0,2,1,0,1,0
"GARET",3,0,1,0,3,1,0,1,0
"GATO",3,0,1,0,3,1,0,1,0
"GAWAYNE",3,0,1,0,3,1,0,1,0
"GAYATHRI",0,3,0,1,3,0,1,0,1
"GBEMISOLA",0,3,0,1,3,0,1,0,1
"GEANETTE",0,2,0,1,2,0,1,0,1
"GEERT",2,0,1,0,2,1,0,1,0
"GENENE",0,3,0,1,3,0,1,0,1
"GENEVE",0,4,0,1,4,0,1,0,1
"GENEVIVE",0,3,0,1,3,0,1,0,1
"GENIENE",0,2,0,1,2,0,1,0,1
"GENNINE",0,3,0,1,3,0,1,0,1
"GEORGEANNE",0,2,0,1,2,0,1,0,1
"GEORGIY",2,0,1,0,2,1,0,1,0
"GEORGY",2,0,1,0,2,1,0,1,0
"GERALDE",0,3,0,1,3,0,1,0,1
"GERBER",2,0,1,0,2,1,0,1,0
"GERGANA",0,2,0,1,2,0,1,0,1
"GERMANA",0,3,0,1,3,0,1,0,1
"GERRON",3,0,1,0,3,1,0,1,0
"GERT",2,1,.6666667,.3333333,3,0,0,0,0
"GEZA",3,0,1,0,3,1,0,1,0
"GHALI",3,0,1,0,3,1,0,1,0
"GHAZALA",0,2,0,1,2,0,1,0,1
"GHISLAIN",2,0,1,0,2,1,0,1,0
"GIANG",1,2,.3333333,.6666667,3,0,0,0,0
"GIANNE",1,1,.5,.5,2,0,0,0,0
"GIANNY",1,2,.3333333,.6666667,3,0,0,0,0
"GILDARDO",3,0,1,0,3,1,0,1,0
"GILMAR",3,0,1,0,3,1,0,1,0
"GIM",3,0,1,0,3,1,0,1,0
"GIRI",2,0,1,0,2,1,0,1,0
"GISSELA",0,2,0,1,2,0,1,0,1
"GITIT",0,3,0,1,3,0,1,0,1
"GIUSEPPA",0,2,0,1,2,0,1,0,1
"GIUSI",0,2,0,1,2,0,1,0,1
"GIZ",4,0,1,0,4,1,0,1,0
"GIZEL",0,2,0,1,2,0,1,0,1
"GIZELLA",0,2,0,1,2,0,1,0,1
"GLENA",0,3,0,1,3,0,1,0,1
"GLENDALIZ",0,3,0,1,3,0,1,0,1
"GLENFORD",3,0,1,0,3,1,0,1,0
"GLORIE",0,4,0,1,4,0,1,0,1
"GLYNNIS",0,2,0,1,2,0,1,0,1
"GOH",1,1,.5,.5,2,0,0,0,0
"GORDY",2,0,1,0,2,1,0,1,0
"GRACEY",0,3,0,1,3,0,1,0,1
"GRACIA",0,2,0,1,2,0,1,0,1
"GRACIANO",3,0,1,0,3,1,0,1,0
"GRANIT",3,0,1,0,3,1,0,1,0
"GRANNY",0,2,0,1,2,0,1,0,1
"GRANTLEY",2,0,1,0,2,1,0,1,0
"GRAZIELA",0,2,0,1,2,0,1,0,1
"GRECO",2,1,.6666667,.3333333,3,0,0,0,0
"GREIG",2,0,1,0,2,1,0,1,0
"GRETHEL",0,2,0,1,2,0,1,0,1
"GRISHMA",0,2,0,1,2,0,1,0,1
"GRISSELLE",0,3,0,1,3,0,1,0,1
"GULAM",2,0,1,0,2,1,0,1,0
"GULSEN",0,3,0,1,3,0,1,0,1
"GURJIT",2,0,1,0,2,1,0,1,0
"GURJOT",3,1,.75,.25,4,0,0,0,0
"GWENDOLEN",0,2,0,1,2,0,1,0,1
"GYM",1,1,.5,.5,2,0,0,0,0
"GYNA",0,3,0,1,3,0,1,0,1
"HAEJIN",0,3,0,1,3,0,1,0,1
"HAFSA",0,3,0,1,3,0,1,0,1
"HAGOP",2,0,1,0,2,1,0,1,0
"HAIK",3,0,1,0,3,1,0,1,0
"HAILEE",1,1,.5,.5,2,0,0,0,0
"HAILY",1,1,.5,.5,2,0,0,0,0
"HAINING",2,0,1,0,2,1,0,1,0
"HAJI",2,0,1,0,2,1,0,1,0
"HAKIEM",4,0,1,0,4,1,0,1,0
"HAKIMA",0,3,0,1,3,0,1,0,1
"HALIS",3,0,1,0,3,1,0,1,0
"HALO",2,0,1,0,2,1,0,1,0
"HALONA",0,3,0,1,3,0,1,0,1
"HAMIT",4,0,1,0,4,1,0,1,0
"HAMZAH",3,0,1,0,3,1,0,1,0
"HANANE",0,2,0,1,2,0,1,0,1
"HANDY",2,0,1,0,2,1,0,1,0
"HANEEF",2,0,1,0,2,1,0,1,0
"HANIFAH",0,2,0,1,2,0,1,0,1
"HANZ",3,0,1,0,3,1,0,1,0
"HAPPY",1,1,.5,.5,2,0,0,0,0
"HARESH",2,0,1,0,2,1,0,1,0
"HARIKA",0,2,0,1,2,0,1,0,1
"HARITH",3,0,1,0,3,1,0,1,0
"HARLEE",0,2,0,1,2,0,1,0,1
"HARLOW",0,3,0,1,3,0,1,0,1
"HARMEET",3,0,1,0,3,1,0,1,0
"HAROL",4,0,1,0,4,1,0,1,0
"HARRINGTON",3,0,1,0,3,1,0,1,0
"HARSHAL",3,0,1,0,3,1,0,1,0
"HARSHIT",2,0,1,0,2,1,0,1,0
"HARVINDER",2,0,1,0,2,1,0,1,0
"HASIM",2,0,1,0,2,1,0,1,0
"HAVI",0,2,0,1,2,0,1,0,1
"HAWWAH",0,4,0,1,4,0,1,0,1
"HAYAL",2,2,.5,.5,4,0,0,0,0
"HAYAN",0,3,0,1,3,0,1,0,1
"HAZE",2,1,.6666667,.3333333,3,0,0,0,0
"HEART",0,2,0,1,2,0,1,0,1
"HEAT",2,1,.6666667,.3333333,3,0,0,0,0
"HEDLEY",2,0,1,0,2,1,0,1,0
"HEKTOR",3,0,1,0,3,1,0,1,0
"HELINA",0,2,0,1,2,0,1,0,1
"HELL",2,0,1,0,2,1,0,1,0
"HELMI",3,1,.75,.25,4,0,0,0,0
"HELOISA",0,2,0,1,2,0,1,0,1
"HERARD",3,0,1,0,3,1,0,1,0
"HERMANN",2,0,1,0,2,1,0,1,0
"HERON",4,0,1,0,4,1,0,1,0
"HERRERA",2,1,.6666667,.3333333,3,0,0,0,0
"HERRY",4,0,1,0,4,1,0,1,0
"HETTIE",0,2,0,1,2,0,1,0,1
"HEZI",2,0,1,0,2,1,0,1,0
"HIDALGO",1,1,.5,.5,2,0,0,0,0
"HIEU",2,0,1,0,2,1,0,1,0
"HIKMET",1,1,.5,.5,2,0,0,0,0
"HILMA",0,2,0,1,2,0,1,0,1
"HIROKAZU",4,0,1,0,4,1,0,1,0
"HIRONORI",2,0,1,0,2,1,0,1,0
"HISAKO",0,2,0,1,2,0,1,0,1
"HITOSHI",2,0,1,0,2,1,0,1,0
"HNIN",0,2,0,1,2,0,1,0,1
"HOAI",0,2,0,1,2,0,1,0,1
"HOFSTRA",1,1,.5,.5,2,0,0,0,0
"HOMMY",3,1,.75,.25,4,0,0,0,0
"HONORE",2,1,.6666667,.3333333,3,0,0,0,0
"HOU",2,0,1,0,2,1,0,1,0
"HOUDA",0,2,0,1,2,0,1,0,1
"HUCK",2,0,1,0,2,1,0,1,0
"HUMBERT",1,1,.5,.5,2,0,0,0,0
"HYERI",0,2,0,1,2,0,1,0,1
"HYLA",0,2,0,1,2,0,1,0,1
"HYOJUNG",0,3,0,1,3,0,1,0,1
"HYOUNG",0,2,0,1,2,0,1,0,1
"HYPER",3,0,1,0,3,1,0,1,0
"HYUK",3,0,1,0,3,1,0,1,0
"HYUNWOO",3,0,1,0,3,1,0,1,0
"IASIA",0,3,0,1,3,0,1,0,1
"IB",3,0,1,0,3,1,0,1,0
"ICY",1,1,.5,.5,2,0,0,0,0
"IDEL",1,1,.5,.5,2,0,0,0,0
"IDRISSA",3,1,.75,.25,4,0,0,0,0
"IFTIKHAR",3,0,1,0,3,1,0,1,0
"IKECHUKWU",3,0,1,0,3,1,0,1,0
"ILENA",0,2,0,1,2,0,1,0,1
"ILENIA",0,3,0,1,3,0,1,0,1
"ILHAM",1,2,.3333333,.6666667,3,0,0,0,0
"ILIANNA",0,2,0,1,2,0,1,0,1
"ILLANA",0,2,0,1,2,0,1,0,1
"ILZE",0,3,0,1,3,0,1,0,1
"IMAM",4,0,1,0,4,1,0,1,0
"IMARI",0,3,0,1,3,0,1,0,1
"IMED",3,0,1,0,3,1,0,1,0
"IMRANA",1,1,.5,.5,2,0,0,0,0
"INDER",2,0,1,0,2,1,0,1,0
"INDIE",1,2,.3333333,.6666667,3,0,0,0,0
"INE",0,4,0,1,4,0,1,0,1
"INESA",0,3,0,1,3,0,1,0,1
"ING",2,1,.6666667,.3333333,3,0,0,0,0
"INGRAM",1,2,.3333333,.6666667,3,0,0,0,0
"INKYUNG",0,2,0,1,2,0,1,0,1
"INSAF",1,2,.3333333,.6666667,3,0,0,0,0
"IRAJ",3,0,1,0,3,1,0,1,0
"IRAN",1,1,.5,.5,2,0,0,0,0
"IRELAND",1,1,.5,.5,2,0,0,0,0
"ISAC",2,0,1,0,2,1,0,1,0
"ISHAAN",3,0,1,0,3,1,0,1,0
"ISHTIAQ",2,0,1,0,2,1,0,1,0
"ISIOMA",0,4,0,1,4,0,1,0,1
"ISKANDAR",4,0,1,0,4,1,0,1,0
"ISOLINA",0,3,0,1,3,0,1,0,1
"ISRAA",0,2,0,1,2,0,1,0,1
"ISSAKA",3,0,1,0,3,1,0,1,0
"ISUF",3,0,1,0,3,1,0,1,0
"IYABO",0,2,0,1,2,0,1,0,1
"IZAK",2,0,1,0,2,1,0,1,0
"IZETTA",0,2,0,1,2,0,1,0,1
"IÃ‘AKI",2,0,1,0,2,1,0,1,0
"JACKELIN",0,3,0,1,3,0,1,0,1
"JACKS",2,1,.6666667,.3333333,3,0,0,0,0
"JACQ",1,2,.3333333,.6666667,3,0,0,0,0
"JACQUETTA",0,4,0,1,4,0,1,0,1
"JACQULINE",0,3,0,1,3,0,1,0,1
"JADON",3,0,1,0,3,1,0,1,0
"JADY",2,0,1,0,2,1,0,1,0
"JAESUN",4,0,1,0,4,1,0,1,0
"JAFET",2,0,1,0,2,1,0,1,0
"JAFOR",2,0,1,0,2,1,0,1,0
"JAGAN",3,0,1,0,3,1,0,1,0
"JAHN",2,1,.6666667,.3333333,3,0,0,0,0
"JAHSON",2,0,1,0,2,1,0,1,0
"JAIMME",0,3,0,1,3,0,1,0,1
"JAKA",3,0,1,0,3,1,0,1,0
"JAKEEM",3,0,1,0,3,1,0,1,0
"JAKKI",0,3,0,1,3,0,1,0,1
"JALYN",3,0,1,0,3,1,0,1,0
"JAMEEKA",0,4,0,1,4,0,1,0,1
"JAMELAH",0,2,0,1,2,0,1,0,1
"JAMELLE",4,0,1,0,4,1,0,1,0
"JAMILY",1,1,.5,.5,2,0,0,0,0
"JAMSHID",3,0,1,0,3,1,0,1,0
"JAMYANG",1,2,.3333333,.6666667,3,0,0,0,0
"JANETTA",0,4,0,1,4,0,1,0,1
"JANEVA",0,4,0,1,4,0,1,0,1
"JANIA",0,2,0,1,2,0,1,0,1
"JANIL",0,2,0,1,2,0,1,0,1
"JANISA",0,3,0,1,3,0,1,0,1
"JANITZA",0,3,0,1,3,0,1,0,1
"JANNAH",0,3,0,1,3,0,1,0,1
"JANNER",2,1,.6666667,.3333333,3,0,0,0,0
"JAO",2,0,1,0,2,1,0,1,0
"JAPHET",3,0,1,0,3,1,0,1,0
"JARITZA",0,3,0,1,3,0,1,0,1
"JAROSLAW",2,0,1,0,2,1,0,1,0
"JASDEEP",3,0,1,0,3,1,0,1,0
"JASKARAN",0,2,0,1,2,0,1,0,1
"JASLENE",0,2,0,1,2,0,1,0,1
"JASMAINE",0,3,0,1,3,0,1,0,1
"JASMEN",0,4,0,1,4,0,1,0,1
"JASSICA",0,2,0,1,2,0,1,0,1
"JASSMIN",0,3,0,1,3,0,1,0,1
"JASSON",4,0,1,0,4,1,0,1,0
"JAV",3,0,1,0,3,1,0,1,0
"JAVAD",2,0,1,0,2,1,0,1,0
"JAVAUGHN",2,0,1,0,2,1,0,1,0
"JAVIERA",0,2,0,1,2,0,1,0,1
"JAXON",2,0,1,0,2,1,0,1,0
"JAYANTA",3,0,1,0,3,1,0,1,0
"JAYLEEN",0,3,0,1,3,0,1,0,1
"JAYLIN",0,2,0,1,2,0,1,0,1
"JAYMZ",4,0,1,0,4,1,0,1,0
"JAYOUNG",0,2,0,1,2,0,1,0,1
"JAY-R",4,0,1,0,4,1,0,1,0
"JAZEL",0,4,0,1,4,0,1,0,1
"JAZMEN",0,2,0,1,2,0,1,0,1
"JEAN-JACQUES",2,0,1,0,2,1,0,1,0
"JEANNEMARIE",0,2,0,1,2,0,1,0,1
"JEANNE-MARIE",0,2,0,1,2,0,1,0,1
"JEANPAUL",2,0,1,0,2,1,0,1,0
"JEAN-YVES",2,0,1,0,2,1,0,1,0
"JEENA",0,3,0,1,3,0,1,0,1
"JEEWAN",2,0,1,0,2,1,0,1,0
"JEFREY",3,0,1,0,3,1,0,1,0
"JEFRY",4,0,1,0,4,1,0,1,0
"JEHANZEB",4,0,1,0,4,1,0,1,0
"JEISSON",2,0,1,0,2,1,0,1,0
"JELLISA",0,2,0,1,2,0,1,0,1
"JEMELL",2,0,1,0,2,1,0,1,0
"JENELLY",0,2,0,1,2,0,1,0,1
"JENISSA",0,3,0,1,3,0,1,0,1
"JENITA",0,2,0,1,2,0,1,0,1
"JENY",0,2,0,1,2,0,1,0,1
"JENYFFER",0,2,0,1,2,0,1,0,1
"JEORGE",4,0,1,0,4,1,0,1,0
"JERE",1,1,.5,.5,2,0,0,0,0
"JERELYN",0,3,0,1,3,0,1,0,1
"JERON",3,0,1,0,3,1,0,1,0
"JERUSHA",0,2,0,1,2,0,1,0,1
"JESSIICA",1,1,.5,.5,2,0,0,0,0
"JESSYE",0,2,0,1,2,0,1,0,1
"JETA",0,3,0,1,3,0,1,0,1
"JEURY",3,0,1,0,3,1,0,1,0
"JEVAUGHN",3,0,1,0,3,1,0,1,0
"JEVONNE",0,3,0,1,3,0,1,0,1
"JEWAN",3,0,1,0,3,1,0,1,0
"JEYLA",0,3,0,1,3,0,1,0,1
"JEÅ»",1,1,.5,.5,2,0,0,0,0
"JHOJAN",3,0,1,0,3,1,0,1,0
"JHONN",2,0,1,0,2,1,0,1,0
"JHONNATAN",4,0,1,0,4,1,0,1,0
"JHUN",4,0,1,0,4,1,0,1,0
"JIALIANG",2,0,1,0,2,1,0,1,0
"JIANING",1,1,.5,.5,2,0,0,0,0
"JIIN",0,2,0,1,2,0,1,0,1
"JILLIANN",0,2,0,1,2,0,1,0,1
"JIMENEZ",1,1,.5,.5,2,0,0,0,0
"JIMM",3,0,1,0,3,1,0,1,0
"JINET",0,2,0,1,2,0,1,0,1
"JINGWEN",1,1,.5,.5,2,0,0,0,0
"JIRI",2,0,1,0,2,1,0,1,0
"JISEON",0,2,0,1,2,0,1,0,1
"JISHAN",3,0,1,0,3,1,0,1,0
"JISSELL",0,3,0,1,3,0,1,0,1
"JITKA",0,2,0,1,2,0,1,0,1
"JOANI",0,3,0,1,3,0,1,0,1
"JOBIE",1,2,.3333333,.6666667,3,0,0,0,0
"JOBIN",3,0,1,0,3,1,0,1,0
"JOCHEM",3,0,1,0,3,1,0,1,0
"JOETTE",0,3,0,1,3,0,1,0,1
"JOHNELL",2,2,.5,.5,4,0,0,0,0
"JOICE",0,4,0,1,4,0,1,0,1
"JOLITA",0,2,0,1,2,0,1,0,1
"JOLYN",0,2,0,1,2,0,1,0,1
"JONN",3,0,1,0,3,1,0,1,0
"JONOTHON",2,0,1,0,2,1,0,1,0
"JONTHAN",3,0,1,0,3,1,0,1,0
"JOONHO",2,0,1,0,2,1,0,1,0
"JORELL",4,0,1,0,4,1,0,1,0
"JORIE",0,2,0,1,2,0,1,0,1
"JOSEAN",2,0,1,0,2,1,0,1,0
"JOSELLE",0,2,0,1,2,0,1,0,1
"JOSELO",4,0,1,0,4,1,0,1,0
"JOSELUIS",2,0,1,0,2,1,0,1,0
"JOSHIE",2,2,.5,.5,4,0,0,0,0
"JOSPEH",3,0,1,0,3,1,0,1,0
"JOSSUE",3,0,1,0,3,1,0,1,0
"JOURNEE",0,3,0,1,3,0,1,0,1
"JOYELL",0,3,0,1,3,0,1,0,1
"JOZSEF",3,0,1,0,3,1,0,1,0
"JUHA",2,0,1,0,2,1,0,1,0
"JUHEE",0,2,0,1,2,0,1,0,1
"JULIENE",0,2,0,1,2,0,1,0,1
"JULIETT",0,3,0,1,3,0,1,0,1
"JULIZA",0,4,0,1,4,0,1,0,1
"JUMANNE",2,0,1,0,2,1,0,1,0
"JUMEL",2,1,.6666667,.3333333,3,0,0,0,0
"JUNELLE",0,4,0,1,4,0,1,0,1
"JUNGHOON",2,1,.6666667,.3333333,3,0,0,0,0
"JUNSIK",2,0,1,0,2,1,0,1,0
"JUNYA",3,0,1,0,3,1,0,1,0
"KADEEN",0,2,0,1,2,0,1,0,1
"KADINE",0,2,0,1,2,0,1,0,1
"KAH",3,1,.75,.25,4,0,0,0,0
"KAHLIA",0,3,0,1,3,0,1,0,1
"KAHORI",0,2,0,1,2,0,1,0,1
"KAIJA",0,2,0,1,2,0,1,0,1
"KAILEE",0,3,0,1,3,0,1,0,1
"KAINE",3,0,1,0,3,1,0,1,0
"KAJSA",0,2,0,1,2,0,1,0,1
"KALAM",4,0,1,0,4,1,0,1,0
"KALILAH",0,2,0,1,2,0,1,0,1
"KALINKA",0,2,0,1,2,0,1,0,1
"KALIPH",3,0,1,0,3,1,0,1,0
"KALOYAN",2,0,1,0,2,1,0,1,0
"KAMAAL",2,0,1,0,2,1,0,1,0
"KAMEELAH",0,2,0,1,2,0,1,0,1
"KAOS",3,0,1,0,3,1,0,1,0
"KARANDEEP",2,0,1,0,2,1,0,1,0
"KAREE",0,2,0,1,2,0,1,0,1
"KAREMA",0,2,0,1,2,0,1,0,1
"KARINNA",0,2,0,1,2,0,1,0,1
"KARIZMA",1,1,.5,.5,2,0,0,0,0
"KARLEY",0,3,0,1,3,0,1,0,1
"KARYL",0,2,0,1,2,0,1,0,1
"KASARA",0,2,0,1,2,0,1,0,1
"KASHA",0,3,0,1,3,0,1,0,1
"KASHANA",0,3,0,1,3,0,1,0,1
"KASHIA",0,2,0,1,2,0,1,0,1
"KASMIRA",0,3,0,1,3,0,1,0,1
"KASON",2,0,1,0,2,1,0,1,0
"KASPAR",2,0,1,0,2,1,0,1,0
"KASSEM",4,0,1,0,4,1,0,1,0
"KASUMI",0,2,0,1,2,0,1,0,1
"KATARA",0,3,0,1,3,0,1,0,1
"KATERIN",0,3,0,1,3,0,1,0,1
"KATIMA",0,2,0,1,2,0,1,0,1
"KATRICIA",0,4,0,1,4,0,1,0,1
"KATSUMI",1,1,.5,.5,2,0,0,0,0
"KATTIE",0,3,0,1,3,0,1,0,1
"KAVEN",3,0,1,0,3,1,0,1,0
"KAWAI",1,2,.3333333,.6666667,3,0,0,0,0
"KAWSAR",3,0,1,0,3,1,0,1,0
"KAYHAN",2,1,.6666667,.3333333,3,0,0,0,0
"KAYLEN",0,2,0,1,2,0,1,0,1
"KAYNE",1,1,.5,.5,2,0,0,0,0
"KAYSHAWN",4,0,1,0,4,1,0,1,0
"KAZUKI",1,1,.5,.5,2,0,0,0,0
"KAZUO",3,0,1,0,3,1,0,1,0
"KAZUYA",3,0,1,0,3,1,0,1,0
"KEBA",2,1,.6666667,.3333333,3,0,0,0,0
"KEELIN",0,2,0,1,2,0,1,0,1
"KEEMA",0,4,0,1,4,0,1,0,1
"KEEN",3,0,1,0,3,1,0,1,0
"KEIA",1,1,.5,.5,2,0,0,0,0
"KEIGO",3,0,1,0,3,1,0,1,0
"KEISHLA",0,3,0,1,3,0,1,0,1
"KEIYA",1,2,.3333333,.6666667,3,0,0,0,0
"KELL",3,0,1,0,3,1,0,1,0
"KELLON",3,0,1,0,3,1,0,1,0
"KELSI",0,3,0,1,3,0,1,0,1
"KENDA",0,2,0,1,2,0,1,0,1
"KENDREA",0,3,0,1,3,0,1,0,1
"KENGO",3,0,1,0,3,1,0,1,0
"KENLYN",1,3,.25,.75,4,0,0,0,0
"KENNON",2,0,1,0,2,1,0,1,0
"KENO",4,0,1,0,4,1,0,1,0
"KENSINGTON",1,2,.3333333,.6666667,3,0,0,0,0
"KENSLEY",4,0,1,0,4,1,0,1,0
"KENZO",2,0,1,0,2,1,0,1,0
"KERBIE",1,1,.5,.5,2,0,0,0,0
"KERITH",0,3,0,1,3,0,1,0,1
"KERLIN",3,0,1,0,3,1,0,1,0
"KERLYNE",0,3,0,1,3,0,1,0,1
"KERT",3,0,1,0,3,1,0,1,0
"KESHAWNA",0,4,0,1,4,0,1,0,1
"KESHON",2,1,.6666667,.3333333,3,0,0,0,0
"KETURA",0,2,0,1,2,0,1,0,1
"KEWANNA",0,2,0,1,2,0,1,0,1
"KEYSER",3,0,1,0,3,1,0,1,0
"KEYSHIA",0,2,0,1,2,0,1,0,1
"KHANG",3,0,1,0,3,1,0,1,0
"KHARL",2,0,1,0,2,1,0,1,0
"KHARLA",0,3,0,1,3,0,1,0,1
"KIANDRA",0,2,0,1,2,0,1,0,1
"KIF",2,0,1,0,2,1,0,1,0
"KIID",2,1,.6666667,.3333333,3,0,0,0,0
"KILO",1,1,.5,.5,2,0,0,0,0
"KILSY",0,3,0,1,3,0,1,0,1
"KIMBERELY",0,3,0,1,3,0,1,0,1
"KIMIA",0,2,0,1,2,0,1,0,1
"KIMO",2,0,1,0,2,1,0,1,0
"KIMONA",0,3,0,1,3,0,1,0,1
"KINGS",3,0,1,0,3,1,0,1,0
"KINSLEY",1,1,.5,.5,2,0,0,0,0
"KION",2,1,.6666667,.3333333,3,0,0,0,0
"KIPP",3,0,1,0,3,1,0,1,0
"KIRTH",3,0,1,0,3,1,0,1,0
"KISH",0,2,0,1,2,0,1,0,1
"KIVANÃ‡",3,0,1,0,3,1,0,1,0
"KIVI",2,1,.6666667,.3333333,3,0,0,0,0
"KIWON",1,1,.5,.5,2,0,0,0,0
"KIYOMI",0,2,0,1,2,0,1,0,1
"KIZZIE",0,3,0,1,3,0,1,0,1
"KJELL",3,0,1,0,3,1,0,1,0
"KLAUDIO",2,0,1,0,2,1,0,1,0
"KOFO",2,0,1,0,2,1,0,1,0
"KOL",1,1,.5,.5,2,0,0,0,0
"KOLLEEN",0,2,0,1,2,0,1,0,1
"KOMI",1,1,.5,.5,2,0,0,0,0
"KORAB",3,0,1,0,3,1,0,1,0
"KORBIN",3,0,1,0,3,1,0,1,0
"KORD",2,1,.6666667,.3333333,3,0,0,0,0
"KOSHY",3,0,1,0,3,1,0,1,0
"KOSTANTINOS",2,0,1,0,2,1,0,1,0
"KOW",2,0,1,0,2,1,0,1,0
"KOYA",0,2,0,1,2,0,1,0,1
"KOZUE",0,3,0,1,3,0,1,0,1
"KREE",1,1,.5,.5,2,0,0,0,0
"KREMENA",0,2,0,1,2,0,1,0,1
"KUM",2,1,.6666667,.3333333,3,0,0,0,0
"KUNJAN",2,1,.6666667,.3333333,3,0,0,0,0
"KURLEIGH",4,0,1,0,4,1,0,1,0
"KUSUM",1,3,.25,.75,4,0,0,0,0
"KWA",2,0,1,0,2,1,0,1,0
"KWANZA",1,1,.5,.5,2,0,0,0,0
"KYANA",0,4,0,1,4,0,1,0,1
"KYESHA",0,2,0,1,2,0,1,0,1
"KYRIAKI",0,2,0,1,2,0,1,0,1
"KYRIE",0,4,0,1,4,0,1,0,1
"KYRSTEN",0,2,0,1,2,0,1,0,1
"LAARNI",0,2,0,1,2,0,1,0,1
"LADIE",0,2,0,1,2,0,1,0,1
"LAFLEUR",1,2,.3333333,.6666667,3,0,0,0,0
"LAGINA",0,3,0,1,3,0,1,0,1
"LAINI",0,2,0,1,2,0,1,0,1
"LAKEEMA",0,3,0,1,3,0,1,0,1
"LAKEESHA",0,3,0,1,3,0,1,0,1
"LAKEIA",0,3,0,1,3,0,1,0,1
"LAL",2,0,1,0,2,1,0,1,0
"LAMESHA",0,2,0,1,2,0,1,0,1
"LANNETTE",0,2,0,1,2,0,1,0,1
"LANY",0,2,0,1,2,0,1,0,1
"LAP",4,0,1,0,4,1,0,1,0
"LAQUITA",0,4,0,1,4,0,1,0,1
"LAR",1,1,.5,.5,2,0,0,0,0
"LARUE",2,1,.6666667,.3333333,3,0,0,0,0
"LAS",0,2,0,1,2,0,1,0,1
"LASANA",2,0,1,0,2,1,0,1,0
"LASANDRA",0,2,0,1,2,0,1,0,1
"LASHAUNA",0,4,0,1,4,0,1,0,1
"LASHELL",0,2,0,1,2,0,1,0,1
"LASHONE",1,2,.3333333,.6666667,3,0,0,0,0
"LASHONNE",0,2,0,1,2,0,1,0,1
"LASONYA",0,3,0,1,3,0,1,0,1
"LATANIA",0,3,0,1,3,0,1,0,1
"LATI",1,2,.3333333,.6666667,3,0,0,0,0
"LATISE",0,2,0,1,2,0,1,0,1
"LATISHIA",0,3,0,1,3,0,1,0,1
"LATORIA",0,2,0,1,2,0,1,0,1
"LA-TOYA",0,2,0,1,2,0,1,0,1
"LATROY",4,0,1,0,4,1,0,1,0
"LAURABETH",0,4,0,1,4,0,1,0,1
"LAURANCE",3,0,1,0,3,1,0,1,0
"LAURIS",2,1,.6666667,.3333333,3,0,0,0,0
"LAVANDA",0,3,0,1,3,0,1,0,1
"LAVI",1,1,.5,.5,2,0,0,0,0
"LAWANNA",0,4,0,1,4,0,1,0,1
"LAYDEE",0,2,0,1,2,0,1,0,1
"LAYNA",0,3,0,1,3,0,1,0,1
"LEAF",2,0,1,0,2,1,0,1,0
"LEAHA",0,3,0,1,3,0,1,0,1
"LEAL",2,0,1,0,2,1,0,1,0
"LEANETTE",0,3,0,1,3,0,1,0,1
"LE-ANN",0,3,0,1,3,0,1,0,1
"LEARIE",2,0,1,0,2,1,0,1,0
"LEASIA",0,2,0,1,2,0,1,0,1
"LEIB",2,0,1,0,2,1,0,1,0
"LEKEISHA",0,2,0,1,2,0,1,0,1
"LEKS",3,0,1,0,3,1,0,1,0
"LELY",0,2,0,1,2,0,1,0,1
"LENIS",0,3,0,1,3,0,1,0,1
"LENNARD",2,0,1,0,2,1,0,1,0
"LESHA",0,4,0,1,4,0,1,0,1
"LESHAUN",2,0,1,0,2,1,0,1,0
"LESLIEANN",0,2,0,1,2,0,1,0,1
"LESSIE",0,2,0,1,2,0,1,0,1
"LESZEK",2,0,1,0,2,1,0,1,0
"LETTICIA",0,2,0,1,2,0,1,0,1
"LEVIS",3,0,1,0,3,1,0,1,0
"LEWIN",2,0,1,0,2,1,0,1,0
"LEYTON",2,0,1,0,2,1,0,1,0
"LIAH",0,2,0,1,2,0,1,0,1
"LIALA",0,2,0,1,2,0,1,0,1
"LIBIN",2,0,1,0,2,1,0,1,0
"LIBRA",1,1,.5,.5,2,0,0,0,0
"LIBRADO",3,0,1,0,3,1,0,1,0
"LICET",0,3,0,1,3,0,1,0,1
"LIES",1,2,.3333333,.6666667,3,0,0,0,0
"LIJUN",0,2,0,1,2,0,1,0,1
"LIL",1,1,.5,.5,2,0,0,0,0
"LILJA",1,1,.5,.5,2,0,0,0,0
"LILYAN",0,2,0,1,2,0,1,0,1
"LINDELL",2,0,1,0,2,1,0,1,0
"LINNET",0,2,0,1,2,0,1,0,1
"LINVAL",3,1,.75,.25,4,0,0,0,0
"LIRIDON",3,0,1,0,3,1,0,1,0
"LIRIM",2,0,1,0,2,1,0,1,0
"LISBET",0,3,0,1,3,0,1,0,1
"LISETT",0,3,0,1,3,0,1,0,1
"LISSET",0,3,0,1,3,0,1,0,1
"LITSA",0,2,0,1,2,0,1,0,1
"LIWEN",0,2,0,1,2,0,1,0,1
"LIYAN",0,2,0,1,2,0,1,0,1
"LIZANNE",0,3,0,1,3,0,1,0,1
"LJILJANA",0,2,0,1,2,0,1,0,1
"LOCA",0,4,0,1,4,0,1,0,1
"LOCK",3,0,1,0,3,1,0,1,0
"LOCKE",2,0,1,0,2,1,0,1,0
"LOES",0,3,0,1,3,0,1,0,1
"LOLADE",0,3,0,1,3,0,1,0,1
"LOOSE",2,0,1,0,2,1,0,1,0
"LOR",2,1,.6666667,.3333333,3,0,0,0,0
"LORESA",0,2,0,1,2,0,1,0,1
"LORIANA",0,3,0,1,3,0,1,0,1
"LORILEE",0,2,0,1,2,0,1,0,1
"LORING",1,2,.3333333,.6666667,3,0,0,0,0
"LORYN",0,2,0,1,2,0,1,0,1
"LOUKIA",0,3,0,1,3,0,1,0,1
"LOVEY",2,1,.6666667,.3333333,3,0,0,0,0
"LUBOS",3,0,1,0,3,1,0,1,0
"LUCE",1,2,.3333333,.6666667,3,0,0,0,0
"LUCILLA",0,3,0,1,3,0,1,0,1
"LUCK",3,1,.75,.25,4,0,0,0,0
"LUCYNA",0,2,0,1,2,0,1,0,1
"LUDOVICA",0,2,0,1,2,0,1,0,1
"LUDOVICO",2,0,1,0,2,1,0,1,0
"LUKMAN",4,0,1,0,4,1,0,1,0
"LUMINITA",0,2,0,1,2,0,1,0,1
"LUO",1,2,.3333333,.6666667,3,0,0,0,0
"LUZY",0,2,0,1,2,0,1,0,1
"LYDELL",2,0,1,0,2,1,0,1,0
"LYNDIA",0,2,0,1,2,0,1,0,1
"LYNNELLE",0,2,0,1,2,0,1,0,1
"LYNNIE",0,2,0,1,2,0,1,0,1
"LYONEL",3,0,1,0,3,1,0,1,0
"LYUDMYLA",0,2,0,1,2,0,1,0,1
"MABLE",0,3,0,1,3,0,1,0,1
"MACARIO",2,0,1,0,2,1,0,1,0
"MACHLI",4,0,1,0,4,1,0,1,0
"MACIEL",0,3,0,1,3,0,1,0,1
"MADAN",2,1,.6666667,.3333333,3,0,0,0,0
"MADDISON",0,2,0,1,2,0,1,0,1
"MADHUR",1,1,.5,.5,2,0,0,0,0
"MADLYN",0,2,0,1,2,0,1,0,1
"MAEL",3,0,1,0,3,1,0,1,0
"MAESTRO",2,0,1,0,2,1,0,1,0
"MAGAN",0,2,0,1,2,0,1,0,1
"MAGDALINA",0,2,0,1,2,0,1,0,1
"MAGO",2,1,.6666667,.3333333,3,0,0,0,0
"MAGUS",4,0,1,0,4,1,0,1,0
"MAH",1,2,.3333333,.6666667,3,0,0,0,0
"MAHBUB",3,0,1,0,3,1,0,1,0
"MAHIMA",0,2,0,1,2,0,1,0,1
"MAHIRA",0,2,0,1,2,0,1,0,1
"MAHLON",2,0,1,0,2,1,0,1,0
"MAIKE",0,2,0,1,2,0,1,0,1
"MAIMOUNA",0,3,0,1,3,0,1,0,1
"MAIYA",0,3,0,1,3,0,1,0,1
"MAIYSHA",0,3,0,1,3,0,1,0,1
"MAJDI",3,0,1,0,3,1,0,1,0
"MAJORIE",0,4,0,1,4,0,1,0,1
"MAKAVELI",3,0,1,0,3,1,0,1,0
"MAKAYLA",0,2,0,1,2,0,1,0,1
"MALCA",0,2,0,1,2,0,1,0,1
"MALIAKA",0,3,0,1,3,0,1,0,1
"MALKAH",0,2,0,1,2,0,1,0,1
"MALY",0,2,0,1,2,0,1,0,1
"MAMBO",2,1,.6666667,.3333333,3,0,0,0,0
"MAMDOUH",2,0,1,0,2,1,0,1,0
"MAMIKO",0,2,0,1,2,0,1,0,1
"MANETTE",0,2,0,1,2,0,1,0,1
"MANIKA",0,2,0,1,2,0,1,0,1
"MANJOLA",0,4,0,1,4,0,1,0,1
"MANUSHKA",0,2,0,1,2,0,1,0,1
"MARCHELLE",0,3,0,1,3,0,1,0,1
"MARCINE",0,2,0,1,2,0,1,0,1
"MARESSA",0,2,0,1,2,0,1,0,1
"MARGARETA",0,3,0,1,3,0,1,0,1
"MARGARETANN",0,2,0,1,2,0,1,0,1
"MARGARETE",0,3,0,1,3,0,1,0,1
"MARGARETTE",0,3,0,1,3,0,1,0,1
"MARGRIT",0,2,0,1,2,0,1,0,1
"MARIBELLE",0,3,0,1,3,0,1,0,1
"MARICRIS",0,2,0,1,2,0,1,0,1
"MARIELLEN",0,3,0,1,3,0,1,0,1
"MARIJANE",0,2,0,1,2,0,1,0,1
"MARIJO",1,2,.3333333,.6666667,3,0,0,0,0
"MARINNA",0,3,0,1,3,0,1,0,1
"MARITE",0,2,0,1,2,0,1,0,1
"MARITSA",0,2,0,1,2,0,1,0,1
"MARIXSA",0,2,0,1,2,0,1,0,1
"MARIZ",0,3,0,1,3,0,1,0,1
"MARKITA",0,3,0,1,3,0,1,0,1
"MARLENIS",0,2,0,1,2,0,1,0,1
"MARLIES",0,2,0,1,2,0,1,0,1
"MARLOS",3,0,1,0,3,1,0,1,0
"MARLYNE",0,4,0,1,4,0,1,0,1
"MARNEE",0,2,0,1,2,0,1,0,1
"MARQUETTA",0,2,0,1,2,0,1,0,1
"MARQUETTE",0,2,0,1,2,0,1,0,1
"MARQUEZ",2,0,1,0,2,1,0,1,0
"MARSELA",0,2,0,1,2,0,1,0,1
"MARSH",1,1,.5,.5,2,0,0,0,0
"MARSHALEE",0,3,0,1,3,0,1,0,1
"MART",4,0,1,0,4,1,0,1,0
"MARTEN",3,0,1,0,3,1,0,1,0
"MARTINI",1,1,.5,.5,2,0,0,0,0
"MARTITA",0,2,0,1,2,0,1,0,1
"MARX",2,1,.6666667,.3333333,3,0,0,0,0
"MARYAN",0,3,0,1,3,0,1,0,1
"MARY-ANNE",0,3,0,1,3,0,1,0,1
"MARYBEL",0,2,0,1,2,0,1,0,1
"MARYLINE",0,4,0,1,4,0,1,0,1
"MARYLUZ",0,2,0,1,2,0,1,0,1
"MARY-LYNN",0,3,0,1,3,0,1,0,1
"MARYNA",0,3,0,1,3,0,1,0,1
"MARYORY",0,4,0,1,4,0,1,0,1
"MARYSUE",0,2,0,1,2,0,1,0,1
"MAS",2,0,1,0,2,1,0,1,0
"MASAAKI",2,0,1,0,2,1,0,1,0
"MASAE",0,2,0,1,2,0,1,0,1
"MASANORI",3,0,1,0,3,1,0,1,0
"MASASHI",2,0,1,0,2,1,0,1,0
"MASAYA",2,0,1,0,2,1,0,1,0
"MASSI",1,1,.5,.5,2,0,0,0,0
"MASSY",0,2,0,1,2,0,1,0,1
"MASTA",2,1,.6666667,.3333333,3,0,0,0,0
"MATSON",3,0,1,0,3,1,0,1,0
"MAURINE",0,3,0,1,3,0,1,0,1
"MAURIZIA",0,3,0,1,3,0,1,0,1
"MAV",1,1,.5,.5,2,0,0,0,0
"MAXENCE",2,0,1,0,2,1,0,1,0
"MAXENE",0,3,0,1,3,0,1,0,1
"MAYE",0,3,0,1,3,0,1,0,1
"MAYELIN",0,2,0,1,2,0,1,0,1
"MAYERLING",0,3,0,1,3,0,1,0,1
"MAYOR",3,0,1,0,3,1,0,1,0
"MAZE",2,0,1,0,2,1,0,1,0
"MAZIAR",2,0,1,0,2,1,0,1,0
"MAÃ‹LLE",0,2,0,1,2,0,1,0,1
"MEADE",2,1,.6666667,.3333333,3,0,0,0,0
"MEADOW",1,1,.5,.5,2,0,0,0,0
"MED",3,0,1,0,3,1,0,1,0
"MEDA",0,2,0,1,2,0,1,0,1
"MEDEA",0,3,0,1,3,0,1,0,1
"MEDIC",3,0,1,0,3,1,0,1,0
"MEDRANO",1,1,.5,.5,2,0,0,0,0
"MEENAKSHI",0,3,0,1,3,0,1,0,1
"MEER",1,1,.5,.5,2,0,0,0,0
"MEET",2,0,1,0,2,1,0,1,0
"MEETU",1,2,.3333333,.6666667,3,0,0,0,0
"MEGIN",0,2,0,1,2,0,1,0,1
"MEHAK",0,2,0,1,2,0,1,0,1
"MEIGHAN",0,2,0,1,2,0,1,0,1
"MEIKA",0,2,0,1,2,0,1,0,1
"MELANA",0,2,0,1,2,0,1,0,1
"MELANEE",0,2,0,1,2,0,1,0,1
"MELECIA",0,2,0,1,2,0,1,0,1
"MELICA",0,3,0,1,3,0,1,0,1
"MELISHA",0,2,0,1,2,0,1,0,1
"MELODI",0,3,0,1,3,0,1,0,1
"MELQUAN",2,0,1,0,2,1,0,1,0
"MELYSA",0,4,0,1,4,0,1,0,1
"MEMUNA",0,2,0,1,2,0,1,0,1
"MENDEZ",2,2,.5,.5,4,0,0,0,0
"MENY",2,0,1,0,2,1,0,1,0
"MERCEDEZ",0,2,0,1,2,0,1,0,1
"MERIÃ‡",3,0,1,0,3,1,0,1,0
"MERLY",0,2,0,1,2,0,1,0,1
"MERRIL",0,3,0,1,3,0,1,0,1
"MERSIM",4,0,1,0,4,1,0,1,0
"MERYLE",0,3,0,1,3,0,1,0,1
"MESHELL",0,3,0,1,3,0,1,0,1
"METI",2,0,1,0,2,1,0,1,0
"MICAEL",2,0,1,0,2,1,0,1,0
"MICHALA",0,2,0,1,2,0,1,0,1
"MICHIO",4,0,1,0,4,1,0,1,0
"MICHOEL",4,0,1,0,4,1,0,1,0
"MICKA",1,1,.5,.5,2,0,0,0,0
"MICRO",2,0,1,0,2,1,0,1,0
"MIDHUN",2,0,1,0,2,1,0,1,0
"MIGGZ",2,0,1,0,2,1,0,1,0
"MIGUELITO",4,0,1,0,4,1,0,1,0
"MIGZ",2,0,1,0,2,1,0,1,0
"MIHAIL",3,0,1,0,3,1,0,1,0
"MIKALA",0,3,0,1,3,0,1,0,1
"MIKU",1,2,.3333333,.6666667,3,0,0,0,0
"MIKY",0,2,0,1,2,0,1,0,1
"MILCO",4,0,1,0,4,1,0,1,0
"MILDRE",0,4,0,1,4,0,1,0,1
"MILINDA",0,3,0,1,3,0,1,0,1
"MILOSZ",2,1,.6666667,.3333333,3,0,0,0,0
"MILVIA",0,3,0,1,3,0,1,0,1
"MINJEONG",0,2,0,1,2,0,1,0,1
"MINJOO",0,3,0,1,3,0,1,0,1
"MINJU",1,2,.3333333,.6666667,3,0,0,0,0
"MINKYU",4,0,1,0,4,1,0,1,0
"MINYA",0,2,0,1,2,0,1,0,1
"MIOSOTY",0,3,0,1,3,0,1,0,1
"MIRJETA",0,2,0,1,2,0,1,0,1
"MIRROR",1,2,.3333333,.6666667,3,0,0,0,0
"MISATO",0,2,0,1,2,0,1,0,1
"MISHI",0,2,0,1,2,0,1,0,1
"MISTI",0,3,0,1,3,0,1,0,1
"MITHAT",4,0,1,0,4,1,0,1,0
"MITSU",2,0,1,0,2,1,0,1,0
"MITZY",0,3,0,1,3,0,1,0,1
"MIWAKO",0,2,0,1,2,0,1,0,1
"MIYOKO",0,2,0,1,2,0,1,0,1
"MOA",1,2,.3333333,.6666667,3,0,0,0,0
"MOEY",1,1,.5,.5,2,0,0,0,0
"MOMODOU",4,0,1,0,4,1,0,1,0
"MONDAY",3,0,1,0,3,1,0,1,0
"MONNA",0,3,0,1,3,0,1,0,1
"MORDI",2,0,1,0,2,1,0,1,0
"MOSELLE",0,2,0,1,2,0,1,0,1
"MOSHEH",4,0,1,0,4,1,0,1,0
"MOUSA",2,0,1,0,2,1,0,1,0
"MOWGLI",2,1,.6666667,.3333333,3,0,0,0,0
"MUBEEN",4,0,1,0,4,1,0,1,0
"MUDASSAR",4,0,1,0,4,1,0,1,0
"MUFFIE",0,4,0,1,4,0,1,0,1
"MUFFY",1,2,.3333333,.6666667,3,0,0,0,0
"MUHSIN",3,0,1,0,3,1,0,1,0
"MUNEER",2,0,1,0,2,1,0,1,0
"MUSHKIE",0,2,0,1,2,0,1,0,1
"MUSSY",0,2,0,1,2,0,1,0,1
"MUTSUMI",0,3,0,1,3,0,1,0,1
"MWENDE",0,2,0,1,2,0,1,0,1
"MYAT",2,1,.6666667,.3333333,3,0,0,0,0
"MYO",2,1,.6666667,.3333333,3,0,0,0,0
"MYONG",1,1,.5,.5,2,0,0,0,0
"MYRIAN",0,2,0,1,2,0,1,0,1
"MYRLANDE",0,3,0,1,3,0,1,0,1
"MYSTIQUE",1,1,.5,.5,2,0,0,0,0
"MYUNGJIN",1,2,.3333333,.6666667,3,0,0,0,0
"NADEJDA",0,2,0,1,2,0,1,0,1
"NADJIA",0,3,0,1,3,0,1,0,1
"NAFEES",3,0,1,0,3,1,0,1,0
"NAFIS",3,0,1,0,3,1,0,1,0
"NAGY",1,2,.3333333,.6666667,3,0,0,0,0
"NAHOMIE",0,3,0,1,3,0,1,0,1
"NAILYA",0,2,0,1,2,0,1,0,1
"NAIQUAN",4,0,1,0,4,1,0,1,0
"NAIROBY",1,1,.5,.5,2,0,0,0,0
"NAKEYA",0,3,0,1,3,0,1,0,1
"NAKIMA",0,3,0,1,3,0,1,0,1
"NAKIYA",0,3,0,1,3,0,1,0,1
"NALAN",0,2,0,1,2,0,1,0,1
"NALANI",0,2,0,1,2,0,1,0,1
"NALDA",0,2,0,1,2,0,1,0,1
"NAMIK",3,0,1,0,3,1,0,1,0
"NANDANA",2,1,.6666667,.3333333,3,0,0,0,0
"NANO",3,1,.75,.25,4,0,0,0,0
"NAOTO",3,0,1,0,3,1,0,1,0
"NAPHTALI",2,0,1,0,2,1,0,1,0
"NAREESA",0,4,0,1,4,0,1,0,1
"NASEER",2,0,1,0,2,1,0,1,0
"NASIMA",0,2,0,1,2,0,1,0,1
"NASREEN",0,4,0,1,4,0,1,0,1
"NASSIM",2,1,.6666667,.3333333,3,0,0,0,0
"NATEISHA",0,2,0,1,2,0,1,0,1
"NATHALEE",0,3,0,1,3,0,1,0,1
"NATHEN",3,0,1,0,3,1,0,1,0
"NATIVE",2,0,1,0,2,1,0,1,0
"NATTI",1,1,.5,.5,2,0,0,0,0
"NAUM",2,0,1,0,2,1,0,1,0
"NAVE",1,2,.3333333,.6666667,3,0,0,0,0
"NAYSA",0,2,0,1,2,0,1,0,1
"NAZANIN",0,3,0,1,3,0,1,0,1
"NAZARIO",1,1,.5,.5,2,0,0,0,0
"NAZILA",0,2,0,1,2,0,1,0,1
"NAZIMA",0,2,0,1,2,0,1,0,1
"NAZISH",0,2,0,1,2,0,1,0,1
"NAZRA",0,2,0,1,2,0,1,0,1
"NDIDI",1,1,.5,.5,2,0,0,0,0
"NEEKA",0,3,0,1,3,0,1,0,1
"NEESH",0,4,0,1,4,0,1,0,1
"NEETHU",0,2,0,1,2,0,1,0,1
"NEFTALY",3,0,1,0,3,1,0,1,0
"NEGRA",0,2,0,1,2,0,1,0,1
"NEJLA",0,2,0,1,2,0,1,0,1
"NEKESHA",0,2,0,1,2,0,1,0,1
"NEKITA",0,3,0,1,3,0,1,0,1
"NELISSA",0,2,0,1,2,0,1,0,1
"NELLO",2,0,1,0,2,1,0,1,0
"NELLZ",0,4,0,1,4,0,1,0,1
"NELVA",1,2,.3333333,.6666667,3,0,0,0,0
"NENO",2,1,.6666667,.3333333,3,0,0,0,0
"NERIDA",0,2,0,1,2,0,1,0,1
"NESE",0,2,0,1,2,0,1,0,1
"NETFA",2,0,1,0,2,1,0,1,0
"NEVENA",0,2,0,1,2,0,1,0,1
"NEVENKA",0,2,0,1,2,0,1,0,1
"NEYSHA",0,3,0,1,3,0,1,0,1
"NIATIA",0,4,0,1,4,0,1,0,1
"NICCO",3,0,1,0,3,1,0,1,0
"NICHOLS",0,2,0,1,2,0,1,0,1
"NICKISHA",0,3,0,1,3,0,1,0,1
"NICKLAS",2,0,1,0,2,1,0,1,0
"NICOLAE",3,0,1,0,3,1,0,1,0
"NICOLEE",0,2,0,1,2,0,1,0,1
"NIECEY",0,2,0,1,2,0,1,0,1
"NIGERIA",1,1,.5,.5,2,0,0,0,0
"NIHARIKA",0,2,0,1,2,0,1,0,1
"NIINA",0,3,0,1,3,0,1,0,1
"NIKKITA",0,2,0,1,2,0,1,0,1
"NIKKOLE",0,3,0,1,3,0,1,0,1
"NILAJA",0,4,0,1,4,0,1,0,1
"NILOOFAR",0,2,0,1,2,0,1,0,1
"NILSON",3,0,1,0,3,1,0,1,0
"NIMIT",2,0,1,0,2,1,0,1,0
"NINAD",4,0,1,0,4,1,0,1,0
"NIQ",3,1,.75,.25,4,0,0,0,0
"NIQUAN",1,1,.5,.5,2,0,0,0,0
"NIQUE",2,0,1,0,2,1,0,1,0
"NIRO",3,0,1,0,3,1,0,1,0
"NISARG",3,0,1,0,3,1,0,1,0
"NISHANI",0,3,0,1,3,0,1,0,1
"NISSON",2,0,1,0,2,1,0,1,0
"NITYA",0,2,0,1,2,0,1,0,1
"NIVES",0,2,0,1,2,0,1,0,1
"NIX",2,1,.6666667,.3333333,3,0,0,0,0
"NOBU",2,0,1,0,2,1,0,1,0
"NOBUYUKI",3,0,1,0,3,1,0,1,0
"NOELE",0,2,0,1,2,0,1,0,1
"NOELLA",0,3,0,1,3,0,1,0,1
"NOHELIA",0,4,0,1,4,0,1,0,1
"NONIE",0,3,0,1,3,0,1,0,1
"NORDA",0,2,0,1,2,0,1,0,1
"NORIYUKI",3,0,1,0,3,1,0,1,0
"NORTH",2,1,.6666667,.3333333,3,0,0,0,0
"NOTOYA",0,4,0,1,4,0,1,0,1
"NOWSHAD",2,0,1,0,2,1,0,1,0
"NOX",3,0,1,0,3,1,0,1,0
"NUCH",1,1,.5,.5,2,0,0,0,0
"NUH",2,0,1,0,2,1,0,1,0
"NUMBER",2,1,.6666667,.3333333,3,0,0,0,0
"NURETTIN",2,0,1,0,2,1,0,1,0
"NURU",1,1,.5,.5,2,0,0,0,0
"NYE",2,1,.6666667,.3333333,3,0,0,0,0
"NYIMA",1,2,.3333333,.6666667,3,0,0,0,0
"NYNA",0,4,0,1,4,0,1,0,1
"NYOMI",0,3,0,1,3,0,1,0,1
"NZINGHA",0,3,0,1,3,0,1,0,1
"OC",2,0,1,0,2,1,0,1,0
"OCHIE",0,2,0,1,2,0,1,0,1
"OCTOBER",0,3,0,1,3,0,1,0,1
"ODAIN",4,0,1,0,4,1,0,1,0
"OFF",2,1,.6666667,.3333333,3,0,0,0,0
"OG",2,1,.6666667,.3333333,3,0,0,0,0
"OGECHI",0,4,0,1,4,0,1,0,1
"OJAS",2,0,1,0,2,1,0,1,0
"OLAITAN",1,1,.5,.5,2,0,0,0,0
"OLAKUNLE",2,0,1,0,2,1,0,1,0
"OLANIYI",3,0,1,0,3,1,0,1,0
"OLATOKUNBO",2,1,.6666667,.3333333,3,0,0,0,0
"OLATUNJI",3,0,1,0,3,1,0,1,0
"OLIVENE",0,4,0,1,4,0,1,0,1
"OLJA",0,2,0,1,2,0,1,0,1
"OLOF",2,0,1,0,2,1,0,1,0
"OLUCHI",0,2,0,1,2,0,1,0,1
"OLUWAKEMI",0,2,0,1,2,0,1,0,1
"OLUWATOYIN",0,2,0,1,2,0,1,0,1
"OLUYEMI",2,0,1,0,2,1,0,1,0
"OMARA",0,2,0,1,2,0,1,0,1
"OMO",1,1,.5,.5,2,0,0,0,0
"ONEL",1,1,.5,.5,2,0,0,0,0
"ONYEKA",1,1,.5,.5,2,0,0,0,0
"ORNELA",0,2,0,1,2,0,1,0,1
"ORRIE",0,2,0,1,2,0,1,0,1
"OS",1,2,.3333333,.6666667,3,0,0,0,0
"OSHER",2,0,1,0,2,1,0,1,0
"OSI",2,1,.6666667,.3333333,3,0,0,0,0
"OSMOND",4,0,1,0,4,1,0,1,0
"OSWIN",3,0,1,0,3,1,0,1,0
"OTELIA",0,3,0,1,3,0,1,0,1
"OTERO",1,1,.5,.5,2,0,0,0,0
"OUR",1,1,.5,.5,2,0,0,0,0
"OVA",4,0,1,0,4,1,0,1,0
"OVIE",3,0,1,0,3,1,0,1,0
"OYUNA",0,2,0,1,2,0,1,0,1
"OZAIR",2,0,1,0,2,1,0,1,0
"OZDEN",1,1,.5,.5,2,0,0,0,0
"PAATA",3,0,1,0,3,1,0,1,0
"PABLITO",3,0,1,0,3,1,0,1,0
"PACEY",3,0,1,0,3,1,0,1,0
"PADMAJA",0,4,0,1,4,0,1,0,1
"PAID",2,1,.6666667,.3333333,3,0,0,0,0
"PAMALA",0,2,0,1,2,0,1,0,1
"PANG",4,0,1,0,4,1,0,1,0
"PARIJAT",1,1,.5,.5,2,0,0,0,0
"PARNELL",1,1,.5,.5,2,0,0,0,0
"PARSA",1,1,.5,.5,2,0,0,0,0
"PARVINA",0,3,0,1,3,0,1,0,1
"PARVIZ",4,0,1,0,4,1,0,1,0
"PATCHES",3,0,1,0,3,1,0,1,0
"PATRISHA",0,4,0,1,4,0,1,0,1
"PATRIZIO",3,0,1,0,3,1,0,1,0
"PAULENE",0,2,0,1,2,0,1,0,1
"PAULET",0,3,0,1,3,0,1,0,1
"PAVLOS",2,0,1,0,2,1,0,1,0
"PEANUT",1,1,.5,.5,2,0,0,0,0
"PEARSON",2,0,1,0,2,1,0,1,0
"PEEWEE",3,0,1,0,3,1,0,1,0
"PELLEGRINO",3,0,1,0,3,1,0,1,0
"PEP",2,0,1,0,2,1,0,1,0
"PERALTA",2,1,.6666667,.3333333,3,0,0,0,0
"PERRIE",1,1,.5,.5,2,0,0,0,0
"PETAGAY",0,3,0,1,3,0,1,0,1
"PHUNG",2,2,.5,.5,4,0,0,0,0
"PI",2,1,.6666667,.3333333,3,0,0,0,0
"PICO",3,0,1,0,3,1,0,1,0
"PIERRE-ANTOINE",3,0,1,0,3,1,0,1,0
"PIET",2,0,1,0,2,1,0,1,0
"PIN",2,0,1,0,2,1,0,1,0
"PINKEY",0,2,0,1,2,0,1,0,1
"PIOTREK",3,0,1,0,3,1,0,1,0
"PIPO",3,0,1,0,3,1,0,1,0
"PLAN",2,0,1,0,2,1,0,1,0
"POETRY",0,2,0,1,2,0,1,0,1
"POLASH",2,0,1,0,2,1,0,1,0
"PONY",1,3,.25,.75,4,0,0,0,0
"POPEYE",4,0,1,0,4,1,0,1,0
"POUL",3,0,1,0,3,1,0,1,0
"POUYA",2,0,1,0,2,1,0,1,0
"POYRAZ",4,0,1,0,4,1,0,1,0
"PRAPTI",0,2,0,1,2,0,1,0,1
"PREMA",0,3,0,1,3,0,1,0,1
"PRENTISS",4,0,1,0,4,1,0,1,0
"PRESCOTT",3,0,1,0,3,1,0,1,0
"PREZ",4,0,1,0,4,1,0,1,0
"PRICILLA",0,3,0,1,3,0,1,0,1
"PRINCETON",1,1,.5,.5,2,0,0,0,0
"PRISCELLA",0,2,0,1,2,0,1,0,1
"PRISMA",1,2,.3333333,.6666667,3,0,0,0,0
"PROF",2,1,.6666667,.3333333,3,0,0,0,0
"PROPHETESS",0,3,0,1,3,0,1,0,1
"PUN",2,0,1,0,2,1,0,1,0
"PUNCH",2,1,.6666667,.3333333,3,0,0,0,0
"PUNJABI",1,1,.5,.5,2,0,0,0,0
"PUTU",2,0,1,0,2,1,0,1,0
"QADIR",2,0,1,0,2,1,0,1,0
"QAISAR",2,0,1,0,2,1,0,1,0
"QUACY",4,0,1,0,4,1,0,1,0
"QUANEESHA",0,2,0,1,2,0,1,0,1
"QUILVIO",3,0,1,0,3,1,0,1,0
"QUINT",4,0,1,0,4,1,0,1,0
"QUITA",0,2,0,1,2,0,1,0,1
"RAB",3,0,1,0,3,1,0,1,0
"RABIH",4,0,1,0,4,1,0,1,0
"RABIN",2,0,1,0,2,1,0,1,0
"RABINDRA",3,0,1,0,3,1,0,1,0
"RADIKA",0,3,0,1,3,0,1,0,1
"RADKA",0,3,0,1,3,0,1,0,1
"RADLEY",3,0,1,0,3,1,0,1,0
"RAECHEL",0,2,0,1,2,0,1,0,1
"RAED",2,0,1,0,2,1,0,1,0
"RAFEEK",3,0,1,0,3,1,0,1,0
"RAFFIE",3,0,1,0,3,1,0,1,0
"RAGHAVAN",3,0,1,0,3,1,0,1,0
"RAGNAR",2,0,1,0,2,1,0,1,0
"RAHIMA",0,2,0,1,2,0,1,0,1
"RAHMELL",3,0,1,0,3,1,0,1,0
"RAIMONDA",0,2,0,1,2,0,1,0,1
"RAIMUND",2,0,1,0,2,1,0,1,0
"RAINEY",0,3,0,1,3,0,1,0,1
"RAISHA",0,3,0,1,3,0,1,0,1
"RAJBIR",2,0,1,0,2,1,0,1,0
"RAKAN",2,0,1,0,2,1,0,1,0
"RAKIB",4,0,1,0,4,1,0,1,0
"RAKIEM",3,0,1,0,3,1,0,1,0
"RALFY",3,0,1,0,3,1,0,1,0
"RAMELLE",3,0,1,0,3,1,0,1,0
"RANGEL",4,0,1,0,4,1,0,1,0
"RANJANA",0,2,0,1,2,0,1,0,1
"RANJEETA",0,2,0,1,2,0,1,0,1
"RAO",3,0,1,0,3,1,0,1,0
"RAPHY",3,0,1,0,3,1,0,1,0
"RASCAL",1,2,.3333333,.6666667,3,0,0,0,0
"RASHEENA",0,3,0,1,3,0,1,0,1
"RASHEIDA",0,2,0,1,2,0,1,0,1
"RASHIEM",2,0,1,0,2,1,0,1,0
"RASHIM",2,1,.6666667,.3333333,3,0,0,0,0
"RASHONDA",0,2,0,1,2,0,1,0,1
"RASIM",3,0,1,0,3,1,0,1,0
"RASTA",3,0,1,0,3,1,0,1,0
"RASUL",4,0,1,0,4,1,0,1,0
"RATUL",2,0,1,0,2,1,0,1,0
"RAUF",2,0,1,0,2,1,0,1,0
"RAVENA",0,3,0,1,3,0,1,0,1
"RAVID",1,1,.5,.5,2,0,0,0,0
"RAW",2,0,1,0,2,1,0,1,0
"RAWLINS",3,0,1,0,3,1,0,1,0
"RAYANNA",0,2,0,1,2,0,1,0,1
"RAYMI",3,0,1,0,3,1,0,1,0
"READ",1,1,.5,.5,2,0,0,0,0
"REDMOND",2,0,1,0,2,1,0,1,0
"REDZO",3,0,1,0,3,1,0,1,0
"REEMO",2,0,1,0,2,1,0,1,0
"REEN",0,4,0,1,4,0,1,0,1
"RENANA",0,2,0,1,2,0,1,0,1
"RENDA",0,2,0,1,2,0,1,0,1
"RENFORD",2,0,1,0,2,1,0,1,0
"RENIA",0,2,0,1,2,0,1,0,1
"RENISE",0,2,0,1,2,0,1,0,1
"REON",3,1,.75,.25,4,0,0,0,0
"REXFORD",2,0,1,0,2,1,0,1,0
"REYHAN",0,2,0,1,2,0,1,0,1
"RHADAMES",2,0,1,0,2,1,0,1,0
"RHAPSODY",0,2,0,1,2,0,1,0,1
"RHESA",0,2,0,1,2,0,1,0,1
"RHODES",2,0,1,0,2,1,0,1,0
"RHODESIA",0,3,0,1,3,0,1,0,1
"RHYAN",2,0,1,0,2,1,0,1,0
"RICARD",3,0,1,0,3,1,0,1,0
"RICHEL",0,2,0,1,2,0,1,0,1
"RICHELE",0,2,0,1,2,0,1,0,1
"RICHI",2,0,1,0,2,1,0,1,0
"RIDDICK",1,1,.5,.5,2,0,0,0,0
"RIDVAN",2,0,1,0,2,1,0,1,0
"RIGEL",2,0,1,0,2,1,0,1,0
"RIKKE",0,2,0,1,2,0,1,0,1
"RIMON",3,0,1,0,3,1,0,1,0
"RINGO",4,0,1,0,4,1,0,1,0
"RIOT",2,1,.6666667,.3333333,3,0,0,0,0
"RIVERDALE",1,1,.5,.5,2,0,0,0,0
"RIVI",0,2,0,1,2,0,1,0,1
"RIZAL",2,0,1,0,2,1,0,1,0
"RIZKI",2,1,.6666667,.3333333,3,0,0,0,0
"ROBERTS",1,1,.5,.5,2,0,0,0,0
"ROC",3,0,1,0,3,1,0,1,0
"ROCH",2,0,1,0,2,1,0,1,0
"ROCKI",2,1,.6666667,.3333333,3,0,0,0,0
"RODD",4,0,1,0,4,1,0,1,0
"RODI",3,1,.75,.25,4,0,0,0,0
"RODY",3,0,1,0,3,1,0,1,0
"ROEI",2,0,1,0,2,1,0,1,0
"ROGGER",4,0,1,0,4,1,0,1,0
"ROHANA",0,2,0,1,2,0,1,0,1
"ROHANIE",0,2,0,1,2,0,1,0,1
"ROJAS",1,2,.3333333,.6666667,3,0,0,0,0
"ROKHAYA",0,4,0,1,4,0,1,0,1
"ROKSANA",0,4,0,1,4,0,1,0,1
"ROLA",0,3,0,1,3,0,1,0,1
"ROLFE",2,0,1,0,2,1,0,1,0
"ROLY",2,1,.6666667,.3333333,3,0,0,0,0
"ROMER",4,0,1,0,4,1,0,1,0
"ROMMY",2,1,.6666667,.3333333,3,0,0,0,0
"RONAY",0,2,0,1,2,0,1,0,1
"RONETTA",0,3,0,1,3,0,1,0,1
"RONIN",1,1,.5,.5,2,0,0,0,0
"ROONEY",3,1,.75,.25,4,0,0,0,0
"ROOPESH",2,0,1,0,2,1,0,1,0
"ROSABEL",0,4,0,1,4,0,1,0,1
"ROSAMUND",0,3,0,1,3,0,1,0,1
"ROSEN",2,0,1,0,2,1,0,1,0
"ROSSEN",3,0,1,0,3,1,0,1,0
"ROUDY",3,0,1,0,3,1,0,1,0
"ROVSHAN",3,0,1,0,3,1,0,1,0
"ROWE",3,0,1,0,3,1,0,1,0
"ROWELL",3,0,1,0,3,1,0,1,0
"ROXAN",0,2,0,1,2,0,1,0,1
"ROXI",0,3,0,1,3,0,1,0,1
"ROYAN",3,0,1,0,3,1,0,1,0
"ROYDEN",2,0,1,0,2,1,0,1,0
"ROZLYN",0,3,0,1,3,0,1,0,1
"ROZY",0,2,0,1,2,0,1,0,1
"RUCHAMA",0,3,0,1,3,0,1,0,1
"RUCHITA",0,2,0,1,2,0,1,0,1
"RUDIE",2,0,1,0,2,1,0,1,0
"RUEBEN",2,0,1,0,2,1,0,1,0
"RUFAT",2,0,1,0,2,1,0,1,0
"RUIFENG",3,0,1,0,3,1,0,1,0
"RUM",1,2,.3333333,.6666667,3,0,0,0,0
"RUMY",2,0,1,0,2,1,0,1,0
"RUSHANE",4,0,1,0,4,1,0,1,0
"RYEN",1,1,.5,.5,2,0,0,0,0
"RYUJI",2,0,1,0,2,1,0,1,0
"SAADIQ",4,0,1,0,4,1,0,1,0
"SAAM",2,0,1,0,2,1,0,1,0
"SABU",4,0,1,0,4,1,0,1,0
"SADDIE",1,1,.5,.5,2,0,0,0,0
"SADIQUE",1,1,.5,.5,2,0,0,0,0
"SADY",0,2,0,1,2,0,1,0,1
"SAED",2,0,1,0,2,1,0,1,0
"SAFIYAH",0,3,0,1,3,0,1,0,1
"SAHAN",4,0,1,0,4,1,0,1,0
"SAHEED",3,0,1,0,3,1,0,1,0
"SAIFUR",3,0,1,0,3,1,0,1,0
"SAJIB",2,0,1,0,2,1,0,1,0
"SALAMI",3,0,1,0,3,1,0,1,0
"SALIF",4,0,1,0,4,1,0,1,0
"SALIMAH",0,2,0,1,2,0,1,0,1
"SAMARIA",0,4,0,1,4,0,1,0,1
"SAMARIS",0,2,0,1,2,0,1,0,1
"SAMATHA",0,3,0,1,3,0,1,0,1
"SAMMUEL",3,0,1,0,3,1,0,1,0
"SANCHO",4,0,1,0,4,1,0,1,0
"SANCIA",0,2,0,1,2,0,1,0,1
"SANDA",0,3,0,1,3,0,1,0,1
"SANEL",3,0,1,0,3,1,0,1,0
"SANGHOON",4,0,1,0,4,1,0,1,0
"SANGITA",0,3,0,1,3,0,1,0,1
"SANIL",3,0,1,0,3,1,0,1,0
"SANJAYA",3,0,1,0,3,1,0,1,0
"SANJU",1,1,.5,.5,2,0,0,0,0
"SAPANA",0,2,0,1,2,0,1,0,1
"SAPHIRA",0,4,0,1,4,0,1,0,1
"SAPO",2,0,1,0,2,1,0,1,0
"SAQUANA",0,2,0,1,2,0,1,0,1
"SARABJIT",2,0,1,0,2,1,0,1,0
"SARDAR",2,0,1,0,2,1,0,1,0
"SARE",1,2,.3333333,.6666667,3,0,0,0,0
"SARENE",0,2,0,1,2,0,1,0,1
"SARIE",0,2,0,1,2,0,1,0,1
"SARINE",0,3,0,1,3,0,1,0,1
"SAROJ",2,1,.6666667,.3333333,3,0,0,0,0
"SATCH",2,0,1,0,2,1,0,1,0
"SATHISH",2,0,1,0,2,1,0,1,0
"SATI",1,2,.3333333,.6666667,3,0,0,0,0
"SATO",3,0,1,0,3,1,0,1,0
"SATSUKI",0,2,0,1,2,0,1,0,1
"SATTIE",0,3,0,1,3,0,1,0,1
"SATU",0,3,0,1,3,0,1,0,1
"SATVINDER",2,0,1,0,2,1,0,1,0
"SAVIO",2,0,1,0,2,1,0,1,0
"SAX",3,0,1,0,3,1,0,1,0
"SCHERRIE",0,2,0,1,2,0,1,0,1
"SEAN-MICHAEL",3,0,1,0,3,1,0,1,0
"SEANY",1,1,.5,.5,2,0,0,0,0
"SEBAS",2,0,1,0,2,1,0,1,0
"SEBY",2,0,1,0,2,1,0,1,0
"SEGEV",2,0,1,0,2,1,0,1,0
"SELA",1,1,.5,.5,2,0,0,0,0
"SELAMAWIT",0,2,0,1,2,0,1,0,1
"SELBY",0,2,0,1,2,0,1,0,1
"SELEENA",0,2,0,1,2,0,1,0,1
"SELIMA",0,3,0,1,3,0,1,0,1
"SENOL",4,0,1,0,4,1,0,1,0
"SEQUOYAH",1,1,.5,.5,2,0,0,0,0
"SERAPHIN",1,2,.3333333,.6666667,3,0,0,0,0
"SERHIY",3,0,1,0,3,1,0,1,0
"SERI",0,3,0,1,3,0,1,0,1
"SERPIL",0,2,0,1,2,0,1,0,1
"SERVET",3,0,1,0,3,1,0,1,0
"SETO",3,0,1,0,3,1,0,1,0
"SEUL",0,2,0,1,2,0,1,0,1
"SEUNGHEE",0,2,0,1,2,0,1,0,1
"SEVERO",3,0,1,0,3,1,0,1,0
"SEVIM",0,3,0,1,3,0,1,0,1
"SEYFI",3,0,1,0,3,1,0,1,0
"SHABI",2,0,1,0,2,1,0,1,0
"SHABIR",3,0,1,0,3,1,0,1,0
"SHACHI",0,4,0,1,4,0,1,0,1
"SHADA",0,3,0,1,3,0,1,0,1
"SHADAB",3,0,1,0,3,1,0,1,0
"SHADIE",1,1,.5,.5,2,0,0,0,0
"SHAEL",2,1,.6666667,.3333333,3,0,0,0,0
"SHAENA",0,2,0,1,2,0,1,0,1
"SHAFIQUL",3,0,1,0,3,1,0,1,0
"SHAHANAZ",0,2,0,1,2,0,1,0,1
"SHAHREEN",0,2,0,1,2,0,1,0,1
"SHAHRYAR",2,0,1,0,2,1,0,1,0
"SHAHRZAD",0,2,0,1,2,0,1,0,1
"SHAHZADA",4,0,1,0,4,1,0,1,0
"SHAIDA",0,3,0,1,3,0,1,0,1
"SHAIKH",2,0,1,0,2,1,0,1,0
"SHAIRA",0,3,0,1,3,0,1,0,1
"SHAKARI",0,2,0,1,2,0,1,0,1
"SHAKE",3,0,1,0,3,1,0,1,0
"SHAKEIMA",0,2,0,1,2,0,1,0,1
"SHAKER",4,0,1,0,4,1,0,1,0
"SHAKI",0,2,0,1,2,0,1,0,1
"SHAKIARA",0,2,0,1,2,0,1,0,1
"SHAKOYA",0,2,0,1,2,0,1,0,1
"SHALEMA",0,2,0,1,2,0,1,0,1
"SHALISHA",0,4,0,1,4,0,1,0,1
"SHAMAINE",0,3,0,1,3,0,1,0,1
"SHAMAL",2,0,1,0,2,1,0,1,0
"SHAMEEM",1,2,.3333333,.6666667,3,0,0,0,0
"SHAMI",2,0,1,0,2,1,0,1,0
"SHAMICKA",0,3,0,1,3,0,1,0,1
"SHAMILA",0,3,0,1,3,0,1,0,1
"SHAMIMA",0,3,0,1,3,0,1,0,1
"SHAMSU",2,0,1,0,2,1,0,1,0
"SHANEEKA",0,3,0,1,3,0,1,0,1
"SHANEEQUA",0,2,0,1,2,0,1,0,1
"SHANEEZA",0,3,0,1,3,0,1,0,1
"SHANEICE",0,3,0,1,3,0,1,0,1
"SHANIEKA",0,2,0,1,2,0,1,0,1
"SHANNELL",0,3,0,1,3,0,1,0,1
"SHANNETTE",0,3,0,1,3,0,1,0,1
"SHANTIA",0,2,0,1,2,0,1,0,1
"SHANTICE",0,2,0,1,2,0,1,0,1
"SHAOLIN",3,1,.75,.25,4,0,0,0,0
"SHAQUAYA",0,3,0,1,3,0,1,0,1
"SHARAH",0,3,0,1,3,0,1,0,1
"SHARAREH",0,3,0,1,3,0,1,0,1
"SHARDAE",0,3,0,1,3,0,1,0,1
"SHARDE",0,2,0,1,2,0,1,0,1
"SHAREEMA",0,2,0,1,2,0,1,0,1
"SHARIEF",2,0,1,0,2,1,0,1,0
"SHARLETTE",0,4,0,1,4,0,1,0,1
"SHARMAYNE",0,3,0,1,3,0,1,0,1
"SHARMI",0,2,0,1,2,0,1,0,1
"SHARMINA",0,2,0,1,2,0,1,0,1
"SHAUNDEL",1,2,.3333333,.6666667,3,0,0,0,0
"SHAUNDELL",1,3,.25,.75,4,0,0,0,0
"SHAUNE",3,0,1,0,3,1,0,1,0
"SHAUNTEE",0,2,0,1,2,0,1,0,1
"SHAVETTE",0,3,0,1,3,0,1,0,1
"SHENEE",0,4,0,1,4,0,1,0,1
"SHENICE",0,4,0,1,4,0,1,0,1
"SHENNA",0,3,0,1,3,0,1,0,1
"SHERAE",0,3,0,1,3,0,1,0,1
"SHERECE",0,3,0,1,3,0,1,0,1
"SHERIEF",2,0,1,0,2,1,0,1,0
"SHERLOCK",4,0,1,0,4,1,0,1,0
"SHEROD",2,0,1,0,2,1,0,1,0
"SHERONA",0,3,0,1,3,0,1,0,1
"SHERRAINE",0,3,0,1,3,0,1,0,1
"SHERRELLE",0,2,0,1,2,0,1,0,1
"SHERRIL",0,2,0,1,2,0,1,0,1
"SHERRIN",0,2,0,1,2,0,1,0,1
"SHERRINE",0,2,0,1,2,0,1,0,1
"SHERRISE",0,3,0,1,3,0,1,0,1
"SHERWYN",2,0,1,0,2,1,0,1,0
"SHIKA",0,3,0,1,3,0,1,0,1
"SHINELL",0,2,0,1,2,0,1,0,1
"SHINIQUA",0,3,0,1,3,0,1,0,1
"SHIRELL",0,2,0,1,2,0,1,0,1
"SHIRO",3,0,1,0,3,1,0,1,0
"SHIU",1,1,.5,.5,2,0,0,0,0
"SHIVANA",0,3,0,1,3,0,1,0,1
"SHIVAUN",0,2,0,1,2,0,1,0,1
"SHLOMY",3,0,1,0,3,1,0,1,0
"SHOBHIT",2,0,1,0,2,1,0,1,0
"SHOE",2,0,1,0,2,1,0,1,0
"SHONDEL",0,2,0,1,2,0,1,0,1
"SHORENA",0,2,0,1,2,0,1,0,1
"SHORN",4,0,1,0,4,1,0,1,0
"SHPEND",2,0,1,0,2,1,0,1,0
"SHREYAS",2,0,1,0,2,1,0,1,0
"SHUAI",2,0,1,0,2,1,0,1,0
"SHUHEI",2,0,1,0,2,1,0,1,0
"SHUKI",2,0,1,0,2,1,0,1,0
"SHUKURA",0,3,0,1,3,0,1,0,1
"SHURA",0,2,0,1,2,0,1,0,1
"SHYNE",3,0,1,0,3,1,0,1,0
"SIANA",0,2,0,1,2,0,1,0,1
"SIBYLLE",0,3,0,1,3,0,1,0,1
"SICK",1,1,.5,.5,2,0,0,0,0
"SIDONIE",0,2,0,1,2,0,1,0,1
"SIDRAH",0,3,0,1,3,0,1,0,1
"SIERA",0,3,0,1,3,0,1,0,1
"SIFAT",2,1,.6666667,.3333333,3,0,0,0,0
"SIG",4,0,1,0,4,1,0,1,0
"SIGOURNEY",0,3,0,1,3,0,1,0,1
"SIJI",2,1,.6666667,.3333333,3,0,0,0,0
"SILIA",0,2,0,1,2,0,1,0,1
"SILJA",0,2,0,1,2,0,1,0,1
"SILKIA",0,3,0,1,3,0,1,0,1
"SILVAN",3,0,1,0,3,1,0,1,0
"SILVIJA",0,2,0,1,2,0,1,0,1
"SILVIU",3,0,1,0,3,1,0,1,0
"SIMHA",2,1,.6666667,.3333333,3,0,0,0,0
"SINDEE",0,2,0,1,2,0,1,0,1
"SINTHIA",0,4,0,1,4,0,1,0,1
"SIOMARA",0,4,0,1,4,0,1,0,1
"SIRA",1,2,.3333333,.6666667,3,0,0,0,0
"SIRISHA",0,2,0,1,2,0,1,0,1
"SISLEY",0,2,0,1,2,0,1,0,1
"SITAL",1,3,.25,.75,4,0,0,0,0
"SIYA",1,1,.5,.5,2,0,0,0,0
"SKI",3,0,1,0,3,1,0,1,0
"SKULLY",2,0,1,0,2,1,0,1,0
"SLADE",2,0,1,0,2,1,0,1,0
"SLAVICA",0,3,0,1,3,0,1,0,1
"SLAVKA",0,4,0,1,4,0,1,0,1
"SMILEZ",2,1,.6666667,.3333333,3,0,0,0,0
"SNJEZANA",0,2,0,1,2,0,1,0,1
"SNUGGLES",2,1,.6666667,.3333333,3,0,0,0,0
"SOHEILA",0,2,0,1,2,0,1,0,1
"SOJUNG",0,2,0,1,2,0,1,0,1
"SOLANGEL",0,2,0,1,2,0,1,0,1
"SOLANGIE",0,3,0,1,3,0,1,0,1
"SOLANLLY",0,3,0,1,3,0,1,0,1
"SONIE",1,1,.5,.5,2,0,0,0,0
"SONJIA",0,3,0,1,3,0,1,0,1
"SONNIA",0,3,0,1,3,0,1,0,1
"SOOHYUN",0,3,0,1,3,0,1,0,1
"SORY",1,2,.3333333,.6666667,3,0,0,0,0
"SOSA",2,2,.5,.5,4,0,0,0,0
"SOTERIA",0,4,0,1,4,0,1,0,1
"SPANK",4,0,1,0,4,1,0,1,0
"SPARKLES",0,2,0,1,2,0,1,0,1
"SPARTAK",3,0,1,0,3,1,0,1,0
"SPORT",3,0,1,0,3,1,0,1,0
"SPYRIDON",2,0,1,0,2,1,0,1,0
"SRILAKSHMI",0,2,0,1,2,0,1,0,1
"STARASIA",0,2,0,1,2,0,1,0,1
"STARK",2,1,.6666667,.3333333,3,0,0,0,0
"STARLETT",0,3,0,1,3,0,1,0,1
"STARLING",1,1,.5,.5,2,0,0,0,0
"STASI",1,1,.5,.5,2,0,0,0,0
"STATENISLAND",0,2,0,1,2,0,1,0,1
"STATHIS",3,0,1,0,3,1,0,1,0
"STEPHAINE",0,3,0,1,3,0,1,0,1
"STEPHANNIE",0,2,0,1,2,0,1,0,1
"STERLIN",3,0,1,0,3,1,0,1,0
"STERN",2,0,1,0,2,1,0,1,0
"STEV",3,0,1,0,3,1,0,1,0
"STEVEO",4,0,1,0,4,1,0,1,0
"STEVEY",1,1,.5,.5,2,0,0,0,0
"STEVY",3,0,1,0,3,1,0,1,0
"STINE",0,2,0,1,2,0,1,0,1
"STITCH",3,0,1,0,3,1,0,1,0
"STIVEN",2,0,1,0,2,1,0,1,0
"STONY",1,1,.5,.5,2,0,0,0,0
"STOYAN",3,0,1,0,3,1,0,1,0
"STRETCH",2,1,.6666667,.3333333,3,0,0,0,0
"SUANN",0,3,0,1,3,0,1,0,1
"SUBBU",3,0,1,0,3,1,0,1,0
"SUBHANKAR",3,0,1,0,3,1,0,1,0
"SUBIR",3,0,1,0,3,1,0,1,0
"SUDAN",0,4,0,1,4,0,1,0,1
"SUDHEER",2,0,1,0,2,1,0,1,0
"SUEDE",3,0,1,0,3,1,0,1,0
"SUEN",1,1,.5,.5,2,0,0,0,0
"SUFIA",0,2,0,1,2,0,1,0,1
"SUH",0,2,0,1,2,0,1,0,1
"SUHEL",2,0,1,0,2,1,0,1,0
"SUJITH",2,0,1,0,2,1,0,1,0
"SUKAINA",0,2,0,1,2,0,1,0,1
"SUKHWINDER",2,0,1,0,2,1,0,1,0
"SULAIMAN",3,0,1,0,3,1,0,1,0
"SULEIDY",0,2,0,1,2,0,1,0,1
"SULLIVAN",1,2,.3333333,.6666667,3,0,0,0,0
"SUMIKO",0,2,0,1,2,0,1,0,1
"SUMIN",0,2,0,1,2,0,1,0,1
"SUMINTRA",0,3,0,1,3,0,1,0,1
"SUMITA",0,2,0,1,2,0,1,0,1
"SUNDER",2,1,.6666667,.3333333,3,0,0,0,0
"SUNDIATA",3,0,1,0,3,1,0,1,0
"SUNGHO",3,0,1,0,3,1,0,1,0
"SUNGJIN",2,0,1,0,2,1,0,1,0
"SUNGJUN",3,0,1,0,3,1,0,1,0
"SUNHEE",0,3,0,1,3,0,1,0,1
"SUNHWA",0,4,0,1,4,0,1,0,1
"SUNRISE",2,2,.5,.5,4,0,0,0,0
"SUPER",2,0,1,0,2,1,0,1,0
"SUPRENA",0,2,0,1,2,0,1,0,1
"SURANGA",2,0,1,0,2,1,0,1,0
"SURIE",0,3,0,1,3,0,1,0,1
"SURITA",0,3,0,1,3,0,1,0,1
"SUSHILA",0,2,0,1,2,0,1,0,1
"SUSUMU",3,0,1,0,3,1,0,1,0
"SUYEON",0,3,0,1,3,0,1,0,1
"SUZANE",0,3,0,1,3,0,1,0,1
"SVA",0,2,0,1,2,0,1,0,1
"SWAIN",3,0,1,0,3,1,0,1,0
"SWAROOP",3,0,1,0,3,1,0,1,0
"SWEETS",1,2,.3333333,.6666667,3,0,0,0,0
"SWISS",1,2,.3333333,.6666667,3,0,0,0,0
"SYMA",0,2,0,1,2,0,1,0,1
"SYNDI",0,3,0,1,3,0,1,0,1
"TAARIQ",2,0,1,0,2,1,0,1,0
"TABASSUM",0,4,0,1,4,0,1,0,1
"TABIA",0,2,0,1,2,0,1,0,1
"TACHA",0,2,0,1,2,0,1,0,1
"TAIS",0,3,0,1,3,0,1,0,1
"TAISIYA",0,2,0,1,2,0,1,0,1
"TAIWAN",4,0,1,0,4,1,0,1,0
"TAJAH",0,3,0,1,3,0,1,0,1
"TAKESHA",0,4,0,1,4,0,1,0,1
"TAKI",2,0,1,0,2,1,0,1,0
"TALAT",1,1,.5,.5,2,0,0,0,0
"TALIN",0,2,0,1,2,0,1,0,1
"TALLEY",1,2,.3333333,.6666667,3,0,0,0,0
"TALY",0,3,0,1,3,0,1,0,1
"TAMA",3,1,.75,.25,4,0,0,0,0
"TAMBA",3,0,1,0,3,1,0,1,0
"TAMESHWAR",4,0,1,0,4,1,0,1,0
"TAMIKKA",0,2,0,1,2,0,1,0,1
"TAMINA",0,2,0,1,2,0,1,0,1
"TAMMARA",0,2,0,1,2,0,1,0,1
"TAMORA",0,4,0,1,4,0,1,0,1
"TAMSEN",0,3,0,1,3,0,1,0,1
"TAMUNA",0,2,0,1,2,0,1,0,1
"TAMYKA",0,2,0,1,2,0,1,0,1
"TANAIRI",0,3,0,1,3,0,1,0,1
"TANAISHA",0,2,0,1,2,0,1,0,1
"TANAZ",0,4,0,1,4,0,1,0,1
"TANGELA",0,3,0,1,3,0,1,0,1
"TANGERINE",1,3,.25,.75,4,0,0,0,0
"TANGIE",0,2,0,1,2,0,1,0,1
"TANICIA",0,2,0,1,2,0,1,0,1
"TANIEKA",0,2,0,1,2,0,1,0,1
"TANINA",0,3,0,1,3,0,1,0,1
"TANITA",0,2,0,1,2,0,1,0,1
"TANK",3,0,1,0,3,1,0,1,0
"TANYIA",0,3,0,1,3,0,1,0,1
"TANYSHA",0,2,0,1,2,0,1,0,1
"TARAN",1,1,.5,.5,2,0,0,0,0
"TARNISHA",0,3,0,1,3,0,1,0,1
"TASHAUN",4,0,1,0,4,1,0,1,0
"TASHEEN",1,1,.5,.5,2,0,0,0,0
"TASHEENA",0,3,0,1,3,0,1,0,1
"TASMIA",0,2,0,1,2,0,1,0,1
"TATO",3,0,1,0,3,1,0,1,0
"TAULANT",2,0,1,0,2,1,0,1,0
"TAURUS",3,1,.75,.25,4,0,0,0,0
"TAVARES",2,0,1,0,2,1,0,1,0
"TAVERAS",0,2,0,1,2,0,1,0,1
"TAVO",3,0,1,0,3,1,0,1,0
"TAWANIA",0,3,0,1,3,0,1,0,1
"TAWN",0,3,0,1,3,0,1,0,1
"TAYEB",2,1,.6666667,.3333333,3,0,0,0,0
"TAYLER",0,2,0,1,2,0,1,0,1
"TAYYABA",0,2,0,1,2,0,1,0,1
"TEATRO",2,0,1,0,2,1,0,1,0
"TEBOGO",1,2,.3333333,.6666667,3,0,0,0,0
"TECK",1,1,.5,.5,2,0,0,0,0
"TEHILLA",0,2,0,1,2,0,1,0,1
"TEMEKA",0,2,0,1,2,0,1,0,1
"TEMIMA",0,2,0,1,2,0,1,0,1
"TEMMA",0,3,0,1,3,0,1,0,1
"TEMPEST",1,1,.5,.5,2,0,0,0,0
"TENESHIA",0,2,0,1,2,0,1,0,1
"TENIQUA",0,3,0,1,3,0,1,0,1
"TENNIS",2,0,1,0,2,1,0,1,0
"TEODORO",2,0,1,0,2,1,0,1,0
"TEON",3,0,1,0,3,1,0,1,0
"TERAH",0,2,0,1,2,0,1,0,1
"TERRYN",0,3,0,1,3,0,1,0,1
"TERU",4,0,1,0,4,1,0,1,0
"TESA",0,3,0,1,3,0,1,0,1
"TEUTA",0,2,0,1,2,0,1,0,1
"TEYA",0,2,0,1,2,0,1,0,1
"THAMAR",0,2,0,1,2,0,1,0,1
"THAMARA",0,3,0,1,3,0,1,0,1
"THAMER",3,0,1,0,3,1,0,1,0
"THARA",0,3,0,1,3,0,1,0,1
"THATS",1,2,.3333333,.6666667,3,0,0,0,0
"THET",3,0,1,0,3,1,0,1,0
"THIA",0,2,0,1,2,0,1,0,1
"THOMAZ",2,0,1,0,2,1,0,1,0
"THORA",0,3,0,1,3,0,1,0,1
"THUAN",4,0,1,0,4,1,0,1,0
"TIANDRA",0,3,0,1,3,0,1,0,1
"TICIA",0,2,0,1,2,0,1,0,1
"TIFA",0,4,0,1,4,0,1,0,1
"TIHESHA",0,3,0,1,3,0,1,0,1
"TIIA",0,4,0,1,4,0,1,0,1
"TIKO",0,3,0,1,3,0,1,0,1
"TIMES",1,1,.5,.5,2,0,0,0,0
"TIMOTEO",4,0,1,0,4,1,0,1,0
"TINA-MARIE",0,2,0,1,2,0,1,0,1
"TINEA",0,4,0,1,4,0,1,0,1
"TIOMBE",0,2,0,1,2,0,1,0,1
"TIONNA",0,3,0,1,3,0,1,0,1
"TIWANA",0,2,0,1,2,0,1,0,1
"TIYE",0,2,0,1,2,0,1,0,1
"TOBBY",1,1,.5,.5,2,0,0,0,0
"TOME",2,1,.6666667,.3333333,3,0,0,0,0
"TOMIWA",2,0,1,0,2,1,0,1,0
"TOMOE",0,3,0,1,3,0,1,0,1
"TOP",2,1,.6666667,.3333333,3,0,0,0,0
"TOPPER",2,0,1,0,2,1,0,1,0
"TORIAN",2,0,1,0,2,1,0,1,0
"TORO",3,1,.75,.25,4,0,0,0,0
"TORRELL",3,0,1,0,3,1,0,1,0
"TOSHIRO",3,0,1,0,3,1,0,1,0
"TOUFIK",3,0,1,0,3,1,0,1,0
"TOYOTA",1,2,.3333333,.6666667,3,0,0,0,0
"TRA",2,0,1,0,2,1,0,1,0
"TRACEYANN",0,3,0,1,3,0,1,0,1
"TRADE",3,0,1,0,3,1,0,1,0
"TRAMEL",3,0,1,0,3,1,0,1,0
"TRAORE",1,1,.5,.5,2,0,0,0,0
"TREISHA",0,2,0,1,2,0,1,0,1
"TRELL",4,0,1,0,4,1,0,1,0
"TRENISE",0,3,0,1,3,0,1,0,1
"TRIONA",0,4,0,1,4,0,1,0,1
"TRON",2,1,.6666667,.3333333,3,0,0,0,0
"TSAHAI",0,2,0,1,2,0,1,0,1
"TSIVIA",0,4,0,1,4,0,1,0,1
"TSUKASA",1,2,.3333333,.6666667,3,0,0,0,0
"TSVI",2,0,1,0,2,1,0,1,0
"TUERE",0,2,0,1,2,0,1,0,1
"TUFFY",2,0,1,0,2,1,0,1,0
"TUG",2,0,1,0,2,1,0,1,0
"TUPAC",3,0,1,0,3,1,0,1,0
"TURAL",2,0,1,0,2,1,0,1,0
"TURTLE",2,2,.5,.5,4,0,0,0,0
"TWILA",0,3,0,1,3,0,1,0,1
"TYANA",0,2,0,1,2,0,1,0,1
"TYEASHA",0,2,0,1,2,0,1,0,1
"TYHEEM",4,0,1,0,4,1,0,1,0
"TYHESHA",0,2,0,1,2,0,1,0,1
"TYLISHA",0,3,0,1,3,0,1,0,1
"TYRE",1,1,.5,.5,2,0,0,0,0
"TYREESE",0,2,0,1,2,0,1,0,1
"TYREKE",2,0,1,0,2,1,0,1,0
"TYRINA",0,4,0,1,4,0,1,0,1
"TYRRELL",3,0,1,0,3,1,0,1,0
"TYSEAN",3,0,1,0,3,1,0,1,0
"TYWANA",0,2,0,1,2,0,1,0,1
"TYWANDA",0,2,0,1,2,0,1,0,1
"TZE",1,1,.5,.5,2,0,0,0,0
"UBA",2,1,.6666667,.3333333,3,0,0,0,0
"UBALDO",2,0,1,0,2,1,0,1,0
"UGOCHUKWU",2,0,1,0,2,1,0,1,0
"ULAS",2,0,1,0,2,1,0,1,0
"ULRIK",2,0,1,0,2,1,0,1,0
"UME",0,3,0,1,3,0,1,0,1
"UMM",0,4,0,1,4,0,1,0,1
"UNAL",2,0,1,0,2,1,0,1,0
"UNDINE",0,3,0,1,3,0,1,0,1
"UNIS",1,1,.5,.5,2,0,0,0,0
"UNNATI",0,2,0,1,2,0,1,0,1
"UTKARSH",2,0,1,0,2,1,0,1,0
"UTOPIA",1,1,.5,.5,2,0,0,0,0
"UTSAV",3,0,1,0,3,1,0,1,0
"UTTAM",3,0,1,0,3,1,0,1,0
"VALISSA",0,2,0,1,2,0,1,0,1
"VALLEN",1,1,.5,.5,2,0,0,0,0
"VANIE",0,2,0,1,2,0,1,0,1
"VANNY",0,2,0,1,2,0,1,0,1
"VARUNA",2,1,.6666667,.3333333,3,0,0,0,0
"VASHON",2,0,1,0,2,1,0,1,0
"VASKO",3,0,1,0,3,1,0,1,0
"VASU",2,0,1,0,2,1,0,1,0
"VEDESH",4,0,1,0,4,1,0,1,0
"VELI",3,0,1,0,3,1,0,1,0
"VENANCIO",3,0,1,0,3,1,0,1,0
"VENKAT",2,0,1,0,2,1,0,1,0
"VENKATESWARA",2,0,1,0,2,1,0,1,0
"VERDI",2,1,.6666667,.3333333,3,0,0,0,0
"VERENICE",0,3,0,1,3,0,1,0,1
"VERNE",3,0,1,0,3,1,0,1,0
"VERNETTE",0,4,0,1,4,0,1,0,1
"VERON",3,0,1,0,3,1,0,1,0
"VES",3,0,1,0,3,1,0,1,0
"VETON",2,0,1,0,2,1,0,1,0
"VIANEY",0,3,0,1,3,0,1,0,1
"VICKO",1,1,.5,.5,2,0,0,0,0
"VICTORIO",2,0,1,0,2,1,0,1,0
"VIDHYA",0,3,0,1,3,0,1,0,1
"VIDUR",2,0,1,0,2,1,0,1,0
"VIKRAMJIT",2,0,1,0,2,1,0,1,0
"VIKY",0,3,0,1,3,0,1,0,1
"VILSON",3,0,1,0,3,1,0,1,0
"VINAYA",0,2,0,1,2,0,1,0,1
"VINCENTE",3,0,1,0,3,1,0,1,0
"VINCENTIUS",4,0,1,0,4,1,0,1,0
"VINESH",3,0,1,0,3,1,0,1,0
"VINKO",2,0,1,0,2,1,0,1,0
"VINTON",2,0,1,0,2,1,0,1,0
"VIRA",0,3,0,1,3,0,1,0,1
"VIRGEN",0,2,0,1,2,0,1,0,1
"VIVIA",0,3,0,1,3,0,1,0,1
"VLADAN",2,0,1,0,2,1,0,1,0
"VO",1,2,.3333333,.6666667,3,0,0,0,0
"VONNETTA",0,3,0,1,3,0,1,0,1
"WAFAA",0,3,0,1,3,0,1,0,1
"WAHAB",2,0,1,0,2,1,0,1,0
"WAJID",4,0,1,0,4,1,0,1,0
"WALLIE",1,1,.5,.5,2,0,0,0,0
"WARIS",2,1,.6666667,.3333333,3,0,0,0,0
"WATCH",2,0,1,0,2,1,0,1,0
"WATKINS",2,2,.5,.5,4,0,0,0,0
"WAVERLY",2,0,1,0,2,1,0,1,0
"WEDNESDAY",1,1,.5,.5,2,0,0,0,0
"WEIFENG",4,0,1,0,4,1,0,1,0
"WEI-JEN",3,0,1,0,3,1,0,1,0
"WEISS",1,1,.5,.5,2,0,0,0,0
"WELTON",2,0,1,0,2,1,0,1,0
"WENJIE",2,2,.5,.5,4,0,0,0,0
"WENJING",0,2,0,1,2,0,1,0,1
"WENNY",0,4,0,1,4,0,1,0,1
"WENQI",3,1,.75,.25,4,0,0,0,0
"WHY",1,1,.5,.5,2,0,0,0,0
"WILFRID",3,0,1,0,3,1,0,1,0
"WILFRIED",4,0,1,0,4,1,0,1,0
"WILI",3,0,1,0,3,1,0,1,0
"WILLEMIJN",0,3,0,1,3,0,1,0,1
"WILLIAMSON",2,1,.6666667,.3333333,3,0,0,0,0
"WILMAN",3,0,1,0,3,1,0,1,0
"WINFRED",2,0,1,0,2,1,0,1,0
"WINNI",0,3,0,1,3,0,1,0,1
"WINTON",2,0,1,0,2,1,0,1,0
"WISDOM",3,0,1,0,3,1,0,1,0
"WONDA",0,2,0,1,2,0,1,0,1
"WONDER",1,2,.3333333,.6666667,3,0,0,0,0
"WOOF",2,0,1,0,2,1,0,1,0
"WRECK",1,1,.5,.5,2,0,0,0,0
"WYETH",2,0,1,0,2,1,0,1,0
"XANDRA",0,2,0,1,2,0,1,0,1
"XAVIEL",3,0,1,0,3,1,0,1,0
"XENO",4,0,1,0,4,1,0,1,0
"XIAODONG",3,1,.75,.25,4,0,0,0,0
"XIAOFEI",1,1,.5,.5,2,0,0,0,0
"XIAOLIN",2,2,.5,.5,4,0,0,0,0
"XIAOLING",0,2,0,1,2,0,1,0,1
"XIAOLONG",3,0,1,0,3,1,0,1,0
"XIAONA",0,3,0,1,3,0,1,0,1
"XIAOXIAO",0,2,0,1,2,0,1,0,1
"XIAOYING",0,4,0,1,4,0,1,0,1
"XIONG",2,0,1,0,2,1,0,1,0
"YAJAYRA",0,2,0,1,2,0,1,0,1
"YAKIMA",0,2,0,1,2,0,1,0,1
"YAM",1,2,.3333333,.6666667,3,0,0,0,0
"YAMINAH",0,2,0,1,2,0,1,0,1
"YANCEY",2,1,.6666667,.3333333,3,0,0,0,0
"YANDRY",2,1,.6666667,.3333333,3,0,0,0,0
"YANERY",1,2,.3333333,.6666667,3,0,0,0,0
"YANIN",0,3,0,1,3,0,1,0,1
"YANLING",0,3,0,1,3,0,1,0,1
"YANY",0,2,0,1,2,0,1,0,1
"YARISSA",0,2,0,1,2,0,1,0,1
"YASIRA",0,3,0,1,3,0,1,0,1
"YASIRIS",0,2,0,1,2,0,1,0,1
"YASNA",0,2,0,1,2,0,1,0,1
"YASUHIRO",2,0,1,0,2,1,0,1,0
"YASUSHI",3,0,1,0,3,1,0,1,0
"YATIN",2,0,1,0,2,1,0,1,0
"YEAH",2,0,1,0,2,1,0,1,0
"YEGOR",4,0,1,0,4,1,0,1,0
"YEHOSHUA",3,0,1,0,3,1,0,1,0
"YENNI",0,3,0,1,3,0,1,0,1
"YER",1,1,.5,.5,2,0,0,0,0
"YERALDIN",0,4,0,1,4,0,1,0,1
"YERY",2,0,1,0,2,1,0,1,0
"YESIKA",0,2,0,1,2,0,1,0,1
"YESSIE",0,2,0,1,2,0,1,0,1
"YEV",3,0,1,0,3,1,0,1,0
"YEVGENIA",0,2,0,1,2,0,1,0,1
"YEWANDE",0,3,0,1,3,0,1,0,1
"YIDDY",3,0,1,0,3,1,0,1,0
"YIJIA",0,2,0,1,2,0,1,0,1
"YILDA",0,2,0,1,2,0,1,0,1
"YILI",0,3,0,1,3,0,1,0,1
"YINGYI",0,2,0,1,2,0,1,0,1
"YINI",0,3,0,1,3,0,1,0,1
"YIU",1,1,.5,.5,2,0,0,0,0
"YOANA",0,3,0,1,3,0,1,0,1
"YOANNA",0,2,0,1,2,0,1,0,1
"YOCHI",1,2,.3333333,.6666667,3,0,0,0,0
"YOJI",3,0,1,0,3,1,0,1,0
"YOLAINE",0,4,0,1,4,0,1,0,1
"YOLIE",0,3,0,1,3,0,1,0,1
"YOONAH",0,3,0,1,3,0,1,0,1
"YOONJUNG",0,2,0,1,2,0,1,0,1
"YOREL",3,0,1,0,3,1,0,1,0
"YOSHIKA",0,3,0,1,3,0,1,0,1
"YOVANNA",0,3,0,1,3,0,1,0,1
"YUANYUAN",0,2,0,1,2,0,1,0,1
"YUCA",0,3,0,1,3,0,1,0,1
"YUDITH",0,3,0,1,3,0,1,0,1
"YUH",1,1,.5,.5,2,0,0,0,0
"YUKAKO",0,3,0,1,3,0,1,0,1
"YULISA",0,2,0,1,2,0,1,0,1
"YULONDA",0,4,0,1,4,0,1,0,1
"YUMING",2,0,1,0,2,1,0,1,0
"YUVRAJ",2,0,1,0,2,1,0,1,0
"YUWEN",0,2,0,1,2,0,1,0,1
"YVIE",0,2,0,1,2,0,1,0,1
"YVON",3,0,1,0,3,1,0,1,0
"YÃ€NBÄªN",1,2,.3333333,.6666667,3,0,0,0,0
"ZACKERY",3,0,1,0,3,1,0,1,0
"ZAFIR",2,0,1,0,2,1,0,1,0
"ZAHEEDA",0,2,0,1,2,0,1,0,1
"ZAHIDUL",3,0,1,0,3,1,0,1,0
"ZAKHAR",3,0,1,0,3,1,0,1,0
"ZAKIYYA",0,3,0,1,3,0,1,0,1
"ZALINA",0,3,0,1,3,0,1,0,1
"ZARIF",2,0,1,0,2,1,0,1,0
"ZAUR",2,0,1,0,2,1,0,1,0
"ZAWADI",1,1,.5,.5,2,0,0,0,0
"ZAYNAB",0,2,0,1,2,0,1,0,1
"ZBIGNIEW",2,0,1,0,2,1,0,1,0
"ZEBA",0,2,0,1,2,0,1,0,1
"ZEF",2,0,1,0,2,1,0,1,0
"ZELLA",0,2,0,1,2,0,1,0,1
"ZERLINA",0,2,0,1,2,0,1,0,1
"ZEYNEL",4,0,1,0,4,1,0,1,0
"ZHICHAO",2,0,1,0,2,1,0,1,0
"ZINNIA",0,3,0,1,3,0,1,0,1
"ZIVILE",0,4,0,1,4,0,1,0,1
"ZIZI",0,2,0,1,2,0,1,0,1
"ZOHAIR",2,0,1,0,2,1,0,1,0
"ZOHEB",3,0,1,0,3,1,0,1,0
"ZONA",1,1,.5,.5,2,0,0,0,0
"ZOSIA",0,3,0,1,3,0,1,0,1
"ZOZO",0,2,0,1,2,0,1,0,1
"ZUHAIR",3,0,1,0,3,1,0,1,0
"ZUHAL",0,2,0,1,2,0,1,0,1
"ZULEY",0,3,0,1,3,0,1,0,1
"Ä°LAYDA",0,2,0,1,2,0,1,0,1
"AADIL",2,0,1,0,2,1,0,1,0
"AAMER",2,0,1,0,2,1,0,1,0
"AAYUSH",2,0,1,0,2,1,0,1,0
"ABBIGAIL",0,2,0,1,2,0,1,0,1
"ABBOTT",1,1,.5,.5,2,0,0,0,0
"ABDURRAHMAN",2,0,1,0,2,1,0,1,0
"ABEDIN",3,0,1,0,3,1,0,1,0
"ABHIMANYU",2,0,1,0,2,1,0,1,0
"ABHINAY",2,0,1,0,2,1,0,1,0
"ABIEZER",2,0,1,0,2,1,0,1,0
"ABIN",2,0,1,0,2,1,0,1,0
"ABM",2,0,1,0,2,1,0,1,0
"ABRIL",0,3,0,1,3,0,1,0,1
"ACHILLE",2,0,1,0,2,1,0,1,0
"ACHIM",2,0,1,0,2,1,0,1,0
"ACHMED",3,0,1,0,3,1,0,1,0
"ACHYUT",3,0,1,0,3,1,0,1,0
"ACKEEM",2,0,1,0,2,1,0,1,0
"ADALISA",0,2,0,1,2,0,1,0,1
"ADALIZ",0,3,0,1,3,0,1,0,1
"ADEEB",2,0,1,0,2,1,0,1,0
"ADEGBOYEGA",3,0,1,0,3,1,0,1,0
"ADELEKE",2,0,1,0,2,1,0,1,0
"ADELIA",0,2,0,1,2,0,1,0,1
"ADESH",2,0,1,0,2,1,0,1,0
"ADESOJI",2,0,1,0,2,1,0,1,0
"ADESOLA",1,2,.3333333,.6666667,3,0,0,0,0
"ADETOLA",1,1,.5,.5,2,0,0,0,0
"ADETOUN",0,3,0,1,3,0,1,0,1
"ADETUNJI",2,0,1,0,2,1,0,1,0
"ADEY",2,0,1,0,2,1,0,1,0
"ADIANA",0,2,0,1,2,0,1,0,1
"ADIRA",0,3,0,1,3,0,1,0,1
"ADOLF",3,0,1,0,3,1,0,1,0
"ADONI",2,0,1,0,2,1,0,1,0
"ADONIJAH",3,0,1,0,3,1,0,1,0
"ADONNA",0,2,0,1,2,0,1,0,1
"ADREAN",1,1,.5,.5,2,0,0,0,0
"AESHA",0,3,0,1,3,0,1,0,1
"AFIFA",0,2,0,1,2,0,1,0,1
"AFONSO",3,0,1,0,3,1,0,1,0
"AFRIKAN",1,1,.5,.5,2,0,0,0,0
"AFRODITI",0,2,0,1,2,0,1,0,1
"AGAM",2,0,1,0,2,1,0,1,0
"AGAPI",0,2,0,1,2,0,1,0,1
"AGNE",0,3,0,1,3,0,1,0,1
"AGUSTINUS",2,0,1,0,2,1,0,1,0
"AHKEEM",3,0,1,0,3,1,0,1,0
"AHLAM",0,2,0,1,2,0,1,0,1
"AHMADOU",3,0,1,0,3,1,0,1,0
"AHN",0,2,0,1,2,0,1,0,1
"AHRAM",0,3,0,1,3,0,1,0,1
"AHREUM",0,2,0,1,2,0,1,0,1
"AIDEE",0,2,0,1,2,0,1,0,1
"AILIE",0,2,0,1,2,0,1,0,1
"AIMA",0,2,0,1,2,0,1,0,1
"AIME",0,2,0,1,2,0,1,0,1
"AIREEN",0,2,0,1,2,0,1,0,1
"AISHIA",0,2,0,1,2,0,1,0,1
"AISSATA",0,2,0,1,2,0,1,0,1
"AITANA",0,2,0,1,2,0,1,0,1
"AJAI",2,0,1,0,2,1,0,1,0
"AKAI",1,1,.5,.5,2,0,0,0,0
"AKEEN",3,0,1,0,3,1,0,1,0
"AKEYA",0,2,0,1,2,0,1,0,1
"AKHI",1,1,.5,.5,2,0,0,0,0
"AKHTAR",2,0,1,0,2,1,0,1,0
"AKIDA",1,1,.5,.5,2,0,0,0,0
"AKINOBU",3,0,1,0,3,1,0,1,0
"AKINOLA",3,0,1,0,3,1,0,1,0
"AKTAR",1,1,.5,.5,2,0,0,0,0
"ALADDIN",2,0,1,0,2,1,0,1,0
"ALAND",2,0,1,0,2,1,0,1,0
"ALASDAIR",2,0,1,0,2,1,0,1,0
"ALASIA",0,2,0,1,2,0,1,0,1
"ALATHEA",0,3,0,1,3,0,1,0,1
"ALBANO",2,0,1,0,2,1,0,1,0
"ALBEN",2,0,1,0,2,1,0,1,0
"ALBENA",0,2,0,1,2,0,1,0,1
"ALBO",1,1,.5,.5,2,0,0,0,0
"ALCI",2,0,1,0,2,1,0,1,0
"ALDER",1,1,.5,.5,2,0,0,0,0
"ALDOUS",2,0,1,0,2,1,0,1,0
"ALEGRIA",0,2,0,1,2,0,1,0,1
"ALEICIA",0,3,0,1,3,0,1,0,1
"ALEXYS",0,2,0,1,2,0,1,0,1
"ALEXZA",0,2,0,1,2,0,1,0,1
"ALFIA",0,2,0,1,2,0,1,0,1
"ALGENIS",2,0,1,0,2,1,0,1,0
"ALHAJI",3,0,1,0,3,1,0,1,0
"ALII",0,2,0,1,2,0,1,0,1
"ALIJAH",2,0,1,0,2,1,0,1,0
"ALIK",2,0,1,0,2,1,0,1,0
"ALIKO",3,0,1,0,3,1,0,1,0
"ALLAH",2,0,1,0,2,1,0,1,0
"ALLAIN",2,0,1,0,2,1,0,1,0
"ALLANAH",0,2,0,1,2,0,1,0,1
"ALLEL",2,0,1,0,2,1,0,1,0
"ALLISTAIR",3,0,1,0,3,1,0,1,0
"ALLYSHA",0,2,0,1,2,0,1,0,1
"ALMAZ",1,1,.5,.5,2,0,0,0,0
"ALMEDINA",0,3,0,1,3,0,1,0,1
"ALPHAA",2,0,1,0,2,1,0,1,0
"ALTAGRACE",0,2,0,1,2,0,1,0,1
"ALTOVISE",0,2,0,1,2,0,1,0,1
"ALVARADO",2,1,.6666667,.3333333,3,0,0,0,0
"ALVI",2,0,1,0,2,1,0,1,0
"ALVIDA",0,3,0,1,3,0,1,0,1
"ALVINO",3,0,1,0,3,1,0,1,0
"ALVISE",2,0,1,0,2,1,0,1,0
"ALYSSE",0,2,0,1,2,0,1,0,1
"AMAD",3,0,1,0,3,1,0,1,0
"AMADEO",2,0,1,0,2,1,0,1,0
"AMARIE",0,2,0,1,2,0,1,0,1
"AMAZIN",2,0,1,0,2,1,0,1,0
"AMBI",2,0,1,0,2,1,0,1,0
"AMECHI",3,0,1,0,3,1,0,1,0
"AMEETA",0,2,0,1,2,0,1,0,1
"AMICHAI",2,0,1,0,2,1,0,1,0
"AMIYA",2,0,1,0,2,1,0,1,0
"AMMO",2,1,.6666667,.3333333,3,0,0,0,0
"AMP",1,1,.5,.5,2,0,0,0,0
"AMZAD",2,0,1,0,2,1,0,1,0
"ANAGHA",0,2,0,1,2,0,1,0,1
"ANAIKA",0,2,0,1,2,0,1,0,1
"ANAISA",0,2,0,1,2,0,1,0,1
"ANALEE",0,2,0,1,2,0,1,0,1
"ANALIE",0,2,0,1,2,0,1,0,1
"ANALYDIA",0,3,0,1,3,0,1,0,1
"ANASTASHIA",0,3,0,1,3,0,1,0,1
"ANASTASIO",3,0,1,0,3,1,0,1,0
"ANATOLII",3,0,1,0,3,1,0,1,0
"ANAYKA",0,2,0,1,2,0,1,0,1
"ANCEL",1,1,.5,.5,2,0,0,0,0
"ANCIL",3,0,1,0,3,1,0,1,0
"ANDORA",0,2,0,1,2,0,1,0,1
"ANDRAY",3,0,1,0,3,1,0,1,0
"ANDRIES",1,1,.5,.5,2,0,0,0,0
"ANDRIJ",3,0,1,0,3,1,0,1,0
"ANDRINE",0,2,0,1,2,0,1,0,1
"ANEISA",0,3,0,1,3,0,1,0,1
"ANEKA",0,2,0,1,2,0,1,0,1
"ANELISE",0,3,0,1,3,0,1,0,1
"ANEURIS",2,0,1,0,2,1,0,1,0
"ANEURY",3,0,1,0,3,1,0,1,0
"ANFISA",0,2,0,1,2,0,1,0,1
"ANGELENA",0,3,0,1,3,0,1,0,1
"ANGELINO",2,0,1,0,2,1,0,1,0
"ANGELLY",0,2,0,1,2,0,1,0,1
"ANGELS",1,1,.5,.5,2,0,0,0,0
"ANIMESH",2,0,1,0,2,1,0,1,0
"ANIQUE",0,2,0,1,2,0,1,0,1
"ANIRBAN",3,0,1,0,3,1,0,1,0
"ANIRUDHA",2,0,1,0,2,1,0,1,0
"ANISE",0,2,0,1,2,0,1,0,1
"ANIYAH",1,2,.3333333,.6666667,3,0,0,0,0
"ANJELA",0,2,0,1,2,0,1,0,1
"ANJIE",0,2,0,1,2,0,1,0,1
"ANJOLI",0,2,0,1,2,0,1,0,1
"ANJULIE",0,3,0,1,3,0,1,0,1
"ANKI",0,2,0,1,2,0,1,0,1
"ANNAMAE",0,2,0,1,2,0,1,0,1
"ANNEMIEKE",0,2,0,1,2,0,1,0,1
"ANNISHA",0,3,0,1,3,0,1,0,1
"ANOUCHKA",0,2,0,1,2,0,1,0,1
"ANOWAR",3,0,1,0,3,1,0,1,0
"ANSA",0,2,0,1,2,0,1,0,1
"ANSARA",0,2,0,1,2,0,1,0,1
"ANTAR",3,0,1,0,3,1,0,1,0
"ANTASHA",0,2,0,1,2,0,1,0,1
"ANTHE",0,2,0,1,2,0,1,0,1
"ANTHONI",2,0,1,0,2,1,0,1,0
"ANTO",2,0,1,0,2,1,0,1,0
"ANTONELLO",2,0,1,0,2,1,0,1,0
"ANTUAN",2,0,1,0,2,1,0,1,0
"ANTUANETTE",0,2,0,1,2,0,1,0,1
"ANTWAUN",3,0,1,0,3,1,0,1,0
"ANTWOINE",2,0,1,0,2,1,0,1,0
"ANZHELIKA",0,2,0,1,2,0,1,0,1
"AOI",0,2,0,1,2,0,1,0,1
"APOLLO",3,0,1,0,3,1,0,1,0
"APRILL",0,3,0,1,3,0,1,0,1
"AQEELA",0,2,0,1,2,0,1,0,1
"AQIL",2,0,1,0,2,1,0,1,0
"AQUILLA",1,1,.5,.5,2,0,0,0,0
"ARABELIS",0,3,0,1,3,0,1,0,1
"ARANCHA",0,2,0,1,2,0,1,0,1
"ARBEY",2,0,1,0,2,1,0,1,0
"ARCANGEL",3,0,1,0,3,1,0,1,0
"ARCANGELO",3,0,1,0,3,1,0,1,0
"ARCHNA",0,2,0,1,2,0,1,0,1
"ARDALAN",3,0,1,0,3,1,0,1,0
"ARDI",2,0,1,0,2,1,0,1,0
"AREEFA",0,2,0,1,2,0,1,0,1
"ARES",2,0,1,0,2,1,0,1,0
"AREZOU",0,2,0,1,2,0,1,0,1
"ARFA",0,3,0,1,3,0,1,0,1
"ARGY",0,3,0,1,3,0,1,0,1
"ARGYRIOS",3,0,1,0,3,1,0,1,0
"ARIEN",1,1,.5,.5,2,0,0,0,0
"ARIFUL",2,0,1,0,2,1,0,1,0
"ARIFUR",2,0,1,0,2,1,0,1,0
"ARINDAM",2,0,1,0,2,1,0,1,0
"ARINOLA",0,3,0,1,3,0,1,0,1
"ARISMENDI",2,0,1,0,2,1,0,1,0
"ARISTEA",0,3,0,1,3,0,1,0,1
"ARISTEDES",2,0,1,0,2,1,0,1,0
"ARIZONA",1,1,.5,.5,2,0,0,0,0
"ARKA",2,0,1,0,2,1,0,1,0
"ARLEENE",0,2,0,1,2,0,1,0,1
"ARLINA",0,3,0,1,3,0,1,0,1
"ARMELLE",0,2,0,1,2,0,1,0,1
"ARMONDO",2,0,1,0,2,1,0,1,0
"ARN",2,0,1,0,2,1,0,1,0
"ARNELL",3,0,1,0,3,1,0,1,0
"ARNELLE",0,3,0,1,3,0,1,0,1
"ARNETTE",0,3,0,1,3,0,1,0,1
"ARNISE",0,3,0,1,3,0,1,0,1
"ARQUELIO",2,0,1,0,2,1,0,1,0
"ARSA",2,0,1,0,2,1,0,1,0
"ARTEMUS",3,0,1,0,3,1,0,1,0
"ARTINA",0,2,0,1,2,0,1,0,1
"ARTUN",2,0,1,0,2,1,0,1,0
"ARUNI",0,2,0,1,2,0,1,0,1
"ARVID",2,0,1,0,2,1,0,1,0
"ASANI",3,0,1,0,3,1,0,1,0
"ASE",2,0,1,0,2,1,0,1,0
"ASHAWN",3,0,1,0,3,1,0,1,0
"ASHIM",2,0,1,0,2,1,0,1,0
"ASHLEY-MARIE",0,2,0,1,2,0,1,0,1
"ASIFA",0,2,0,1,2,0,1,0,1
"ASJA",0,2,0,1,2,0,1,0,1
"ASKA",0,2,0,1,2,0,1,0,1
"ASSIA",0,2,0,1,2,0,1,0,1
"ASTHON",3,0,1,0,3,1,0,1,0
"ASTORIA",3,0,1,0,3,1,0,1,0
"ASTRI",1,2,.3333333,.6666667,3,0,0,0,0
"ASWAD",2,0,1,0,2,1,0,1,0
"ATANU",2,0,1,0,2,1,0,1,0
"ATARAH",1,1,.5,.5,2,0,0,0,0
"ATAUR",2,0,1,0,2,1,0,1,0
"ATHEA",0,3,0,1,3,0,1,0,1
"ATILA",2,1,.6666667,.3333333,3,0,0,0,0
"ATISH",2,0,1,0,2,1,0,1,0
"ATIYAH",0,2,0,1,2,0,1,0,1
"ATTIYA",0,2,0,1,2,0,1,0,1
"AUBRI",0,2,0,1,2,0,1,0,1
"AUBRIE",0,2,0,1,2,0,1,0,1
"AUDWIN",2,0,1,0,2,1,0,1,0
"AUNTIE",0,3,0,1,3,0,1,0,1
"AURELLE",1,2,.3333333,.6666667,3,0,0,0,0
"AUSTINE",2,0,1,0,2,1,0,1,0
"AUSTYN",2,0,1,0,2,1,0,1,0
"AUTUM",0,2,0,1,2,0,1,0,1
"AVIANN",0,2,0,1,2,0,1,0,1
"AVILA",0,3,0,1,3,0,1,0,1
"AVRUM",2,0,1,0,2,1,0,1,0
"AVRUMIE",2,0,1,0,2,1,0,1,0
"AVSHALOM",2,0,1,0,2,1,0,1,0
"AX",3,0,1,0,3,1,0,1,0
"AXELLE",0,2,0,1,2,0,1,0,1
"AYCAN",0,2,0,1,2,0,1,0,1
"AYDA",0,2,0,1,2,0,1,0,1
"AYEESHA",0,3,0,1,3,0,1,0,1
"AYFER",0,2,0,1,2,0,1,0,1
"AYLON",2,0,1,0,2,1,0,1,0
"AYRES",3,0,1,0,3,1,0,1,0
"AZAMAT",3,0,1,0,3,1,0,1,0
"BA",1,1,.5,.5,2,0,0,0,0
"BACHI",2,0,1,0,2,1,0,1,0
"BACKSTAGE",1,1,.5,.5,2,0,0,0,0
"BACON",2,0,1,0,2,1,0,1,0
"BADRUL",2,0,1,0,2,1,0,1,0
"BAEK",1,1,.5,.5,2,0,0,0,0
"BAHAA",2,0,1,0,2,1,0,1,0
"BAHMAN",2,0,1,0,2,1,0,1,0
"BAI",1,2,.3333333,.6666667,3,0,0,0,0
"BAIJU",3,0,1,0,3,1,0,1,0
"BALRAJ",3,0,1,0,3,1,0,1,0
"BAMIDELE",0,2,0,1,2,0,1,0,1
"BANDAR",2,0,1,0,2,1,0,1,0
"BARAA",1,1,.5,.5,2,0,0,0,0
"BARY",1,1,.5,.5,2,0,0,0,0
"BASDEO",2,0,1,0,2,1,0,1,0
"BASHEER",2,0,1,0,2,1,0,1,0
"BASHKIM",2,0,1,0,2,1,0,1,0
"BASIM",3,0,1,0,3,1,0,1,0
"BASIRAT",0,2,0,1,2,0,1,0,1
"BASSIE",0,2,0,1,2,0,1,0,1
"BATISTA",0,2,0,1,2,0,1,0,1
"BATO",2,0,1,0,2,1,0,1,0
"BAYYINAH",0,2,0,1,2,0,1,0,1
"BEAUX",2,0,1,0,2,1,0,1,0
"BEBI",0,2,0,1,2,0,1,0,1
"BEHROOZ",2,0,1,0,2,1,0,1,0
"BEHROUZ",3,0,1,0,3,1,0,1,0
"BELIA",0,2,0,1,2,0,1,0,1
"BELISA",0,2,0,1,2,0,1,0,1
"BELLADONNA",1,1,.5,.5,2,0,0,0,0
"BELOVED",0,3,0,1,3,0,1,0,1
"BENARD",2,0,1,0,2,1,0,1,0
"BENBEN",2,0,1,0,2,1,0,1,0
"BENEE",1,1,.5,.5,2,0,0,0,0
"BENJA",2,1,.6666667,.3333333,3,0,0,0,0
"BENONI",2,0,1,0,2,1,0,1,0
"BENTZY",2,0,1,0,2,1,0,1,0
"BENZI",2,0,1,0,2,1,0,1,0
"BERE",0,3,0,1,3,0,1,0,1
"BERHANE",2,0,1,0,2,1,0,1,0
"BERKER",2,0,1,0,2,1,0,1,0
"BERKOWITZ",1,1,.5,.5,2,0,0,0,0
"BERLIN",0,2,0,1,2,0,1,0,1
"BERLYN",1,1,.5,.5,2,0,0,0,0
"BERNADETTA",0,3,0,1,3,0,1,0,1
"BERNS",1,2,.3333333,.6666667,3,0,0,0,0
"BERTHONY",2,0,1,0,2,1,0,1,0
"BERTI",0,2,0,1,2,0,1,0,1
"BESHOY",2,0,1,0,2,1,0,1,0
"BETHSY",0,2,0,1,2,0,1,0,1
"BETTER",2,0,1,0,2,1,0,1,0
"BETTYANNE",0,3,0,1,3,0,1,0,1
"BETÃœL",0,2,0,1,2,0,1,0,1
"BEVERLYN",0,3,0,1,3,0,1,0,1
"BHAKTA",2,0,1,0,2,1,0,1,0
"BHARTI",0,3,0,1,3,0,1,0,1
"BHUMI",0,2,0,1,2,0,1,0,1
"BI",2,0,1,0,2,1,0,1,0
"BIBIANE",0,2,0,1,2,0,1,0,1
"BIENVENIDA",0,3,0,1,3,0,1,0,1
"BIGAPPLE",1,1,.5,.5,2,0,0,0,0
"BIGMIKE",3,0,1,0,3,1,0,1,0
"BIJOY",2,0,1,0,2,1,0,1,0
"BILBO",2,0,1,0,2,1,0,1,0
"BILKIS",0,2,0,1,2,0,1,0,1
"BINDIA",0,2,0,1,2,0,1,0,1
"BIONCA",0,2,0,1,2,0,1,0,1
"BIRSEN",0,2,0,1,2,0,1,0,1
"BIZARRO",3,0,1,0,3,1,0,1,0
"BLADE",3,0,1,0,3,1,0,1,0
"BLASE",2,1,.6666667,.3333333,3,0,0,0,0
"BLINKY",2,0,1,0,2,1,0,1,0
"BOBA",2,1,.6666667,.3333333,3,0,0,0,0
"BOBAE",0,3,0,1,3,0,1,0,1
"BOBB",1,1,.5,.5,2,0,0,0,0
"BOBI",1,1,.5,.5,2,0,0,0,0
"BONAFIDE",2,1,.6666667,.3333333,3,0,0,0,0
"BONGO",2,0,1,0,2,1,0,1,0
"BONI",2,1,.6666667,.3333333,3,0,0,0,0
"BONNA",0,2,0,1,2,0,1,0,1
"BONNEY",0,2,0,1,2,0,1,0,1
"BONZO",2,0,1,0,2,1,0,1,0
"BOONE",2,0,1,0,2,1,0,1,0
"BORRIS",3,0,1,0,3,1,0,1,0
"BOSKO",3,0,1,0,3,1,0,1,0
"BOSSMAN",3,0,1,0,3,1,0,1,0
"BOUNA",1,1,.5,.5,2,0,0,0,0
"BOURNE",2,0,1,0,2,1,0,1,0
"BOWERY",0,2,0,1,2,0,1,0,1
"BOYET",2,0,1,0,2,1,0,1,0
"BRACCI",3,0,1,0,3,1,0,1,0
"BRAIN",1,1,.5,.5,2,0,0,0,0
"BRANTLEY",2,0,1,0,2,1,0,1,0
"BRAÅ‡O",3,0,1,0,3,1,0,1,0
"BREAD",2,0,1,0,2,1,0,1,0
"BRENDALIS",0,2,0,1,2,0,1,0,1
"BREON",0,2,0,1,2,0,1,0,1
"BRETON",2,1,.6666667,.3333333,3,0,0,0,0
"BRIAR",0,2,0,1,2,0,1,0,1
"BRIGGITTE",0,2,0,1,2,0,1,0,1
"BRIGGS",1,1,.5,.5,2,0,0,0,0
"BRIGITA",0,3,0,1,3,0,1,0,1
"BRITTIANY",0,2,0,1,2,0,1,0,1
"BRODERICK",3,0,1,0,3,1,0,1,0
"BROOKIE",0,2,0,1,2,0,1,0,1
"BROOKLYNS",1,1,.5,.5,2,0,0,0,0
"BROTHA",2,0,1,0,2,1,0,1,0
"BRURIA",0,3,0,1,3,0,1,0,1
"BRYEN",2,0,1,0,2,1,0,1,0
"BUBA",3,0,1,0,3,1,0,1,0
"BUBBE",1,2,.3333333,.6666667,3,0,0,0,0
"BUDDAH",2,1,.6666667,.3333333,3,0,0,0,0
"BUFORD",2,0,1,0,2,1,0,1,0
"BUI",2,0,1,0,2,1,0,1,0
"BUMBLE",1,1,.5,.5,2,0,0,0,0
"BUNNI",0,2,0,1,2,0,1,0,1
"BURNELL",3,0,1,0,3,1,0,1,0
"BURRELL",3,0,1,0,3,1,0,1,0
"BUSH",2,0,1,0,2,1,0,1,0
"BUSOLA",0,2,0,1,2,0,1,0,1
"BUTTAFLY",0,2,0,1,2,0,1,0,1
"BUY",2,0,1,0,2,1,0,1,0
"BYOUNG",2,0,1,0,2,1,0,1,0
"BYUNGWOOK",3,0,1,0,3,1,0,1,0
"CAECILIA",0,2,0,1,2,0,1,0,1
"CAKES",0,2,0,1,2,0,1,0,1
"CALIE",0,3,0,1,3,0,1,0,1
"CALIXTO",2,0,1,0,2,1,0,1,0
"CALLEY",1,1,.5,.5,2,0,0,0,0
"CALUM",2,0,1,0,2,1,0,1,0
"CAMELLE",0,3,0,1,3,0,1,0,1
"CAMISHA",0,2,0,1,2,0,1,0,1
"CANDANCE",0,3,0,1,3,0,1,0,1
"CAPPI",0,2,0,1,2,0,1,0,1
"CAPRICIA",0,2,0,1,2,0,1,0,1
"CAREEM",3,0,1,0,3,1,0,1,0
"CARESSE",0,2,0,1,2,0,1,0,1
"CARLENS",2,0,1,0,2,1,0,1,0
"CARLENY",0,2,0,1,2,0,1,0,1
"CARLIS",1,1,.5,.5,2,0,0,0,0
"CARMA",0,2,0,1,2,0,1,0,1
"CARMELLO",2,0,1,0,2,1,0,1,0
"CARMENZA",0,3,0,1,3,0,1,0,1
"CARMICHAEL",2,0,1,0,2,1,0,1,0
"CAROL-LYNN",0,2,0,1,2,0,1,0,1
"CARRY",0,2,0,1,2,0,1,0,1
"CARYANN",0,3,0,1,3,0,1,0,1
"CASHE",1,1,.5,.5,2,0,0,0,0
"CASSIANA",0,2,0,1,2,0,1,0,1
"CATHE",0,2,0,1,2,0,1,0,1
"CATHELINE",0,3,0,1,3,0,1,0,1
"CATHYANN",0,2,0,1,2,0,1,0,1
"CATIANA",0,2,0,1,2,0,1,0,1
"CAYLIN",1,1,.5,.5,2,0,0,0,0
"CECY",0,2,0,1,2,0,1,0,1
"CELENIA",0,2,0,1,2,0,1,0,1
"CELI",0,2,0,1,2,0,1,0,1
"CELIE",0,3,0,1,3,0,1,0,1
"CELINES",0,2,0,1,2,0,1,0,1
"CELLA",0,3,0,1,3,0,1,0,1
"CELLY",1,2,.3333333,.6666667,3,0,0,0,0
"CERRON",3,0,1,0,3,1,0,1,0
"CESIA",0,3,0,1,3,0,1,0,1
"CEYHAN",2,0,1,0,2,1,0,1,0
"CEZ",0,2,0,1,2,0,1,0,1
"CHACHA",2,0,1,0,2,1,0,1,0
"CHALO",2,0,1,0,2,1,0,1,0
"CHANCHAL",1,1,.5,.5,2,0,0,0,0
"CHANDANI",0,2,0,1,2,0,1,0,1
"CHANDI",0,2,0,1,2,0,1,0,1
"CHANDRASHEKAR",2,0,1,0,2,1,0,1,0
"CHANDRIA",0,2,0,1,2,0,1,0,1
"CHANGA",2,0,1,0,2,1,0,1,0
"CHANSE",2,1,.6666667,.3333333,3,0,0,0,0
"CHAPLAIN",0,2,0,1,2,0,1,0,1
"CHARAN",2,0,1,0,2,1,0,1,0
"CHARDE",0,2,0,1,2,0,1,0,1
"CHARISA",0,3,0,1,3,0,1,0,1
"CHARIT",1,1,.5,.5,2,0,0,0,0
"CHARLAYNE",0,3,0,1,3,0,1,0,1
"CHARLEMAGNE",2,0,1,0,2,1,0,1,0
"CHARLESTON",3,0,1,0,3,1,0,1,0
"CHARLYNNE",0,2,0,1,2,0,1,0,1
"CHARMANE",0,2,0,1,2,0,1,0,1
"CHARMINE",0,3,0,1,3,0,1,0,1
"CHARONE",1,1,.5,.5,2,0,0,0,0
"CHASIDISHE",1,1,.5,.5,2,0,0,0,0
"CHASSITY",0,3,0,1,3,0,1,0,1
"CHASTIDY",0,2,0,1,2,0,1,0,1
"CHASTINE",0,2,0,1,2,0,1,0,1
"CHAUNTELLE",0,2,0,1,2,0,1,0,1
"CHAYE",0,2,0,1,2,0,1,0,1
"CHEALSEA",0,2,0,1,2,0,1,0,1
"CHECK",2,0,1,0,2,1,0,1,0
"CHELLIE",0,2,0,1,2,0,1,0,1
"CHENA",0,2,0,1,2,0,1,0,1
"CHENEA",0,2,0,1,2,0,1,0,1
"CHEOL",2,0,1,0,2,1,0,1,0
"CHEPE",2,0,1,0,2,1,0,1,0
"CHERE",0,2,0,1,2,0,1,0,1
"CHERESSE",0,3,0,1,3,0,1,0,1
"CHERLINE",0,3,0,1,3,0,1,0,1
"CHERYL-ANN",0,2,0,1,2,0,1,0,1
"CHERYLYN",0,3,0,1,3,0,1,0,1
"CHESTERFIELD",2,0,1,0,2,1,0,1,0
"CHIBUZO",2,1,.6666667,.3333333,3,0,0,0,0
"CHIC",2,0,1,0,2,1,0,1,0
"CHIEH",2,0,1,0,2,1,0,1,0
"CHIFFON",0,2,0,1,2,0,1,0,1
"CHIHARU",0,2,0,1,2,0,1,0,1
"CHILLI",3,0,1,0,3,1,0,1,0
"CHINMAY",2,0,1,0,2,1,0,1,0
"CHINMOY",3,0,1,0,3,1,0,1,0
"CHIPS",2,1,.6666667,.3333333,3,0,0,0,0
"CHIPZ",2,0,1,0,2,1,0,1,0
"CHIRANTAN",2,0,1,0,2,1,0,1,0
"CHIRAYU",2,0,1,0,2,1,0,1,0
"CHIRO",2,0,1,0,2,1,0,1,0
"CHIRS",2,0,1,0,2,1,0,1,0
"CHIS",2,0,1,0,2,1,0,1,0
"CHIVONNE",0,3,0,1,3,0,1,0,1
"CHOICE",2,1,.6666667,.3333333,3,0,0,0,0
"CHOPPER",3,0,1,0,3,1,0,1,0
"CHRISITINE",0,3,0,1,3,0,1,0,1
"CHRISTEE",0,3,0,1,3,0,1,0,1
"CHRISTOFER",2,0,1,0,2,1,0,1,0
"CHRISTYL",0,2,0,1,2,0,1,0,1
"CHRYSTYNA",0,2,0,1,2,0,1,0,1
"CHUCHO",2,0,1,0,2,1,0,1,0
"CHUI",1,1,.5,.5,2,0,0,0,0
"CHUNKIE",2,0,1,0,2,1,0,1,0
"CIANA",0,2,0,1,2,0,1,0,1
"CIANO",2,0,1,0,2,1,0,1,0
"CICCIO",2,0,1,0,2,1,0,1,0
"CINDEE",0,2,0,1,2,0,1,0,1
"CINE",0,2,0,1,2,0,1,0,1
"CINTRON",1,1,.5,.5,2,0,0,0,0
"CIO",0,3,0,1,3,0,1,0,1
"CISSE",1,1,.5,.5,2,0,0,0,0
"CITRA",0,2,0,1,2,0,1,0,1
"CKY",3,0,1,0,3,1,0,1,0
"CLARCK",3,0,1,0,3,1,0,1,0
"CLAUDEEN",0,2,0,1,2,0,1,0,1
"CLEIDY",0,2,0,1,2,0,1,0,1
"CLEMENS",2,0,1,0,2,1,0,1,0
"CLEMENTINA",0,2,0,1,2,0,1,0,1
"CLENTON",2,0,1,0,2,1,0,1,0
"CLETE",3,0,1,0,3,1,0,1,0
"CLYNTON",3,0,1,0,3,1,0,1,0
"CODIE",1,1,.5,.5,2,0,0,0,0
"COEN",2,0,1,0,2,1,0,1,0
"COLENE",0,2,0,1,2,0,1,0,1
"COLLENE",0,2,0,1,2,0,1,0,1
"COLOR",2,0,1,0,2,1,0,1,0
"COLT",2,0,1,0,2,1,0,1,0
"COME",2,0,1,0,2,1,0,1,0
"COMEDIAN",2,0,1,0,2,1,0,1,0
"COMRADE",1,1,.5,.5,2,0,0,0,0
"CONSCIOUS",1,1,.5,.5,2,0,0,0,0
"CONSTANZE",0,3,0,1,3,0,1,0,1
"CONTINA",0,2,0,1,2,0,1,0,1
"CORBAN",2,0,1,0,2,1,0,1,0
"CORD",2,0,1,0,2,1,0,1,0
"CORDULA",0,3,0,1,3,0,1,0,1
"CORLISS",0,2,0,1,2,0,1,0,1
"CORONA",1,1,.5,.5,2,0,0,0,0
"CORTES",1,1,.5,.5,2,0,0,0,0
"COSMAS",3,0,1,0,3,1,0,1,0
"CREWS",1,2,.3333333,.6666667,3,0,0,0,0
"CRISTELA",0,3,0,1,3,0,1,0,1
"CRUEL",1,1,.5,.5,2,0,0,0,0
"CRYSSY",0,3,0,1,3,0,1,0,1
"CUBAN",2,0,1,0,2,1,0,1,0
"CUBBY",1,1,.5,.5,2,0,0,0,0
"CUBERT",2,0,1,0,2,1,0,1,0
"CUMHUR",2,0,1,0,2,1,0,1,0
"CURLY",1,1,.5,.5,2,0,0,0,0
"CURRY",1,2,.3333333,.6666667,3,0,0,0,0
"CUTY",0,3,0,1,3,0,1,0,1
"CYNDA",0,2,0,1,2,0,1,0,1
"CYNTIA",0,3,0,1,3,0,1,0,1
"CYRILL",2,0,1,0,2,1,0,1,0
"DAAN",2,0,1,0,2,1,0,1,0
"DAC",2,0,1,0,2,1,0,1,0
"DAFFY",2,0,1,0,2,1,0,1,0
"DAIGO",2,0,1,0,2,1,0,1,0
"DAJON",2,0,1,0,2,1,0,1,0
"DALA",0,2,0,1,2,0,1,0,1
"DALAYS",0,3,0,1,3,0,1,0,1
"DALIANA",0,3,0,1,3,0,1,0,1
"DALJIT",2,0,1,0,2,1,0,1,0
"DALLANA",0,2,0,1,2,0,1,0,1
"DAMIL",3,0,1,0,3,1,0,1,0
"DAMIN",2,0,1,0,2,1,0,1,0
"DANAI",2,0,1,0,2,1,0,1,0
"DANELIA",0,2,0,1,2,0,1,0,1
"DANESHA",0,2,0,1,2,0,1,0,1
"DANIELLEE",0,2,0,1,2,0,1,0,1
"DANIQUA",0,2,0,1,2,0,1,0,1
"DANIRA",0,2,0,1,2,0,1,0,1
"DANIYAL",1,1,.5,.5,2,0,0,0,0
"DANNIEL",2,0,1,0,2,1,0,1,0
"DANYELLA",0,3,0,1,3,0,1,0,1
"DANZEL",3,0,1,0,3,1,0,1,0
"DAOUD",2,0,1,0,2,1,0,1,0
"DAPA",3,0,1,0,3,1,0,1,0
"DAQUANA",0,2,0,1,2,0,1,0,1
"DAQUEEN",0,2,0,1,2,0,1,0,1
"DARALYN",0,2,0,1,2,0,1,0,1
"DARAN",2,0,1,0,2,1,0,1,0
"DARCELL",0,2,0,1,2,0,1,0,1
"DARCIA",0,3,0,1,3,0,1,0,1
"DARDEN",2,0,1,0,2,1,0,1,0
"DARELLE",2,1,.6666667,.3333333,3,0,0,0,0
"DARLENIS",0,3,0,1,3,0,1,0,1
"DARLINGTON",2,0,1,0,2,1,0,1,0
"DAROLD",1,1,.5,.5,2,0,0,0,0
"DARRAN",3,0,1,0,3,1,0,1,0
"DARRIELLE",0,3,0,1,3,0,1,0,1
"DARROL",3,0,1,0,3,1,0,1,0
"DARRY",2,0,1,0,2,1,0,1,0
"DASIA",0,3,0,1,3,0,1,0,1
"DAUREN",3,0,1,0,3,1,0,1,0
"DAVENDRA",2,0,1,0,2,1,0,1,0
"DAWANA",0,3,0,1,3,0,1,0,1
"DAWNA",0,3,0,1,3,0,1,0,1
"DAWOON",0,2,0,1,2,0,1,0,1
"DAYDAY",1,1,.5,.5,2,0,0,0,0
"DAYE",2,0,1,0,2,1,0,1,0
"DAYMOND",2,0,1,0,2,1,0,1,0
"DAYONG",2,0,1,0,2,1,0,1,0
"DAYRA",0,2,0,1,2,0,1,0,1
"DAYSHAUN",3,0,1,0,3,1,0,1,0
"DAYSHAWN",2,1,.6666667,.3333333,3,0,0,0,0
"DEATRICE",0,2,0,1,2,0,1,0,1
"DEAVON",2,1,.6666667,.3333333,3,0,0,0,0
"DEBASHIS",2,0,1,0,2,1,0,1,0
"DEBE",0,2,0,1,2,0,1,0,1
"DEBOLA",0,2,0,1,2,0,1,0,1
"DEBRALYN",0,3,0,1,3,0,1,0,1
"DEBRAN",0,3,0,1,3,0,1,0,1
"DEDDY",2,0,1,0,2,1,0,1,0
"DEEZ",2,0,1,0,2,1,0,1,0
"DEICY",0,2,0,1,2,0,1,0,1
"DELANDO",3,0,1,0,3,1,0,1,0
"DELEON",2,1,.6666667,.3333333,3,0,0,0,0
"DELIS",0,2,0,1,2,0,1,0,1
"DELITA",0,2,0,1,2,0,1,0,1
"DELIZA",0,3,0,1,3,0,1,0,1
"DELMO",2,0,1,0,2,1,0,1,0
"DELONTE",2,0,1,0,2,1,0,1,0
"DELORA",0,2,0,1,2,0,1,0,1
"DEMARCUS",2,0,1,0,2,1,0,1,0
"DEMARIO",2,0,1,0,2,1,0,1,0
"DEMMY",1,1,.5,.5,2,0,0,0,0
"DENEIL",0,2,0,1,2,0,1,0,1
"DENEISE",0,3,0,1,3,0,1,0,1
"DENESHA",0,2,0,1,2,0,1,0,1
"DENISIA",0,3,0,1,3,0,1,0,1
"DENISS",1,1,.5,.5,2,0,0,0,0
"DENN",2,0,1,0,2,1,0,1,0
"DENNISA",0,2,0,1,2,0,1,0,1
"DENROY",2,0,1,0,2,1,0,1,0
"DENSIL",3,0,1,0,3,1,0,1,0
"DENSON",3,0,1,0,3,1,0,1,0
"DENY",1,1,.5,.5,2,0,0,0,0
"DEODAT",2,0,1,0,2,1,0,1,0
"DEONDRA",0,2,0,1,2,0,1,0,1
"DEONNA",0,2,0,1,2,0,1,0,1
"DERAY",2,0,1,0,2,1,0,1,0
"DERELLE",2,0,1,0,2,1,0,1,0
"DERIAN",1,1,.5,.5,2,0,0,0,0
"DERMOTT",2,0,1,0,2,1,0,1,0
"DERRIC",2,0,1,0,2,1,0,1,0
"DERRIK",3,0,1,0,3,1,0,1,0
"DERVLA",0,2,0,1,2,0,1,0,1
"DESARAY",0,3,0,1,3,0,1,0,1
"DESERI",0,3,0,1,3,0,1,0,1
"DESREEN",0,2,0,1,2,0,1,0,1
"DESSIREE",0,2,0,1,2,0,1,0,1
"DEVINDER",2,0,1,0,2,1,0,1,0
"DEVO",2,1,.6666667,.3333333,3,0,0,0,0
"DEVONNIE",0,2,0,1,2,0,1,0,1
"DEWY",1,1,.5,.5,2,0,0,0,0
"DEXIS",0,2,0,1,2,0,1,0,1
"DEYAN",2,0,1,0,2,1,0,1,0
"DEYANA",0,3,0,1,3,0,1,0,1
"DHARMA",2,0,1,0,2,1,0,1,0
"DHARMENDRA",3,0,1,0,3,1,0,1,0
"DHIMITER",3,0,1,0,3,1,0,1,0
"DHONDUP",2,0,1,0,2,1,0,1,0
"DIAH",0,3,0,1,3,0,1,0,1
"DIAHANNA",0,2,0,1,2,0,1,0,1
"DIALA",0,2,0,1,2,0,1,0,1
"DIANGELO",2,0,1,0,2,1,0,1,0
"DIANI",0,2,0,1,2,0,1,0,1
"DIANNY",0,2,0,1,2,0,1,0,1
"DIANY",0,3,0,1,3,0,1,0,1
"DICKENS",3,0,1,0,3,1,0,1,0
"DID",3,0,1,0,3,1,0,1,0
"DIDO",1,2,.3333333,.6666667,3,0,0,0,0
"DIGGS",2,0,1,0,2,1,0,1,0
"DIK",2,1,.6666667,.3333333,3,0,0,0,0
"DILL",2,0,1,0,2,1,0,1,0
"DILLAN",2,0,1,0,2,1,0,1,0
"DIMARIS",0,2,0,1,2,0,1,0,1
"DIMITRIY",2,0,1,0,2,1,0,1,0
"DINE",1,1,.5,.5,2,0,0,0,0
"DINELLE",0,2,0,1,2,0,1,0,1
"DINGO",3,0,1,0,3,1,0,1,0
"DINKY",0,3,0,1,3,0,1,0,1
"DINOS",3,0,1,0,3,1,0,1,0
"DINOSKA",0,3,0,1,3,0,1,0,1
"DINU",2,0,1,0,2,1,0,1,0
"DIOMARA",0,2,0,1,2,0,1,0,1
"DIOMARIS",0,2,0,1,2,0,1,0,1
"DIONICIA",0,2,0,1,2,0,1,0,1
"DIONISIOS",2,0,1,0,2,1,0,1,0
"DIONYSIS",2,0,1,0,2,1,0,1,0
"DIOP",2,0,1,0,2,1,0,1,0
"DIOSA",0,3,0,1,3,0,1,0,1
"DIPTA",3,0,1,0,3,1,0,1,0
"DITI",1,1,.5,.5,2,0,0,0,0
"DIWAKAR",2,0,1,0,2,1,0,1,0
"DJENNY",0,2,0,1,2,0,1,0,1
"DNICE",2,0,1,0,2,1,0,1,0
"D-NICE",1,1,.5,.5,2,0,0,0,0
"DOCTOR",2,1,.6666667,.3333333,3,0,0,0,0
"DOD",3,0,1,0,3,1,0,1,0
"DOLA",1,1,.5,.5,2,0,0,0,0
"DOLINDA",0,3,0,1,3,0,1,0,1
"DOMINGUEZ",1,1,.5,.5,2,0,0,0,0
"DONAT",3,0,1,0,3,1,0,1,0
"DONEL",3,0,1,0,3,1,0,1,0
"DONESHA",0,2,0,1,2,0,1,0,1
"DONICA",0,2,0,1,2,0,1,0,1
"DONIQUE",1,1,.5,.5,2,0,0,0,0
"DONIS",3,0,1,0,3,1,0,1,0
"DONITA",0,2,0,1,2,0,1,0,1
"DONNELLE",1,1,.5,.5,2,0,0,0,0
"DONNETT",0,3,0,1,3,0,1,0,1
"DONY",2,1,.6666667,.3333333,3,0,0,0,0
"DONYELLA",0,2,0,1,2,0,1,0,1
"DONZELL",3,0,1,0,3,1,0,1,0
"DORE",1,2,.3333333,.6666667,3,0,0,0,0
"DOREN",2,0,1,0,2,1,0,1,0
"DORN",2,0,1,0,2,1,0,1,0
"DORNELL",2,1,.6666667,.3333333,3,0,0,0,0
"DOTTI",0,2,0,1,2,0,1,0,1
"DOVILE",0,2,0,1,2,0,1,0,1
"DOYIN",2,0,1,0,2,1,0,1,0
"DOZIE",2,0,1,0,2,1,0,1,0
"DREAD",2,0,1,0,2,1,0,1,0
"DRED",3,0,1,0,3,1,0,1,0
"DRITERO",3,0,1,0,3,1,0,1,0
"DUDA",1,1,.5,.5,2,0,0,0,0
"DULANI",3,0,1,0,3,1,0,1,0
"DULARIE",0,3,0,1,3,0,1,0,1
"DUMONT",1,1,.5,.5,2,0,0,0,0
"DUNIA",0,3,0,1,3,0,1,0,1
"DURAY",2,0,1,0,2,1,0,1,0
"DURON",3,0,1,0,3,1,0,1,0
"DURWIN",3,0,1,0,3,1,0,1,0
"DUVET",3,0,1,0,3,1,0,1,0
"DW",2,0,1,0,2,1,0,1,0
"DWAN",0,3,0,1,3,0,1,0,1
"DYANI",0,2,0,1,2,0,1,0,1
"DYMPNA",0,2,0,1,2,0,1,0,1
"DZEMAL",2,0,1,0,2,1,0,1,0
"EAGLE",2,0,1,0,2,1,0,1,0
"EARLYN",1,1,.5,.5,2,0,0,0,0
"EBBE",2,1,.6666667,.3333333,3,0,0,0,0
"EBONIQUE",0,2,0,1,2,0,1,0,1
"EBRAHIM",3,0,1,0,3,1,0,1,0
"EDEM",2,0,1,0,2,1,0,1,0
"EDILIA",0,2,0,1,2,0,1,0,1
"EDINSON",2,0,1,0,2,1,0,1,0
"EDRA",0,2,0,1,2,0,1,0,1
"EDWAR",2,1,.6666667,.3333333,3,0,0,0,0
"EDWYN",2,0,1,0,2,1,0,1,0
"EEVA",0,2,0,1,2,0,1,0,1
"EFFE",1,2,.3333333,.6666667,3,0,0,0,0
"EFUSJON",2,1,.6666667,.3333333,3,0,0,0,0
"EGG",1,2,.3333333,.6666667,3,0,0,0,0
"EGHOSA",1,1,.5,.5,2,0,0,0,0
"EGLI",1,1,.5,.5,2,0,0,0,0
"EGZON",2,0,1,0,2,1,0,1,0
"EHSANUL",2,0,1,0,2,1,0,1,0
"EIKI",2,0,1,0,2,1,0,1,0
"EILLEEN",0,2,0,1,2,0,1,0,1
"EIMY",0,3,0,1,3,0,1,0,1
"EINSTEIN",2,0,1,0,2,1,0,1,0
"EKENE",1,2,.3333333,.6666667,3,0,0,0,0
"EKI",1,2,.3333333,.6666667,3,0,0,0,0
"EKLAVYA",2,0,1,0,2,1,0,1,0
"EKUA",1,1,.5,.5,2,0,0,0,0
"ELADIA",0,2,0,1,2,0,1,0,1
"ELANNA",0,2,0,1,2,0,1,0,1
"ELCHIN",2,0,1,0,2,1,0,1,0
"ELDAN",3,0,1,0,3,1,0,1,0
"ELEEN",0,3,0,1,3,0,1,0,1
"ELENORA",0,2,0,1,2,0,1,0,1
"ELIANNE",0,2,0,1,2,0,1,0,1
"ELIMELECH",2,0,1,0,2,1,0,1,0
"ELION",2,0,1,0,2,1,0,1,0
"ELISHIA",1,1,.5,.5,2,0,0,0,0
"ELIZABETA",0,2,0,1,2,0,1,0,1
"ELL",2,1,.6666667,.3333333,3,0,0,0,0
"ELLENE",0,2,0,1,2,0,1,0,1
"ELNA",0,3,0,1,3,0,1,0,1
"ELPIDA",0,2,0,1,2,0,1,0,1
"ELVERA",0,2,0,1,2,0,1,0,1
"ELVY",2,1,.6666667,.3333333,3,0,0,0,0
"ELYANA",0,3,0,1,3,0,1,0,1
"ELYZABETH",0,2,0,1,2,0,1,0,1
"E-MAN",2,0,1,0,2,1,0,1,0
"EMANUELLE",0,2,0,1,2,0,1,0,1
"EME",1,1,.5,.5,2,0,0,0,0
"EMILI",1,1,.5,.5,2,0,0,0,0
"EMILLIE",0,2,0,1,2,0,1,0,1
"EMM",2,0,1,0,2,1,0,1,0
"EMMILY",0,2,0,1,2,0,1,0,1
"EMONI",1,1,.5,.5,2,0,0,0,0
"ENESA",0,3,0,1,3,0,1,0,1
"ENITH",0,3,0,1,3,0,1,0,1
"ENKELEDA",0,2,0,1,2,0,1,0,1
"ENNIO",2,0,1,0,2,1,0,1,0
"ENYA",0,2,0,1,2,0,1,0,1
"EPI",0,2,0,1,2,0,1,0,1
"EPIFANIO",3,0,1,0,3,1,0,1,0
"EQUALITY",1,2,.3333333,.6666667,3,0,0,0,0
"EQUAN",2,0,1,0,2,1,0,1,0
"ERAM",2,1,.6666667,.3333333,3,0,0,0,0
"ERASMIA",0,2,0,1,2,0,1,0,1
"ERASMUS",2,1,.6666667,.3333333,3,0,0,0,0
"ERCILIA",0,3,0,1,3,0,1,0,1
"ERCUMENT",2,0,1,0,2,1,0,1,0
"ERDEN",2,0,1,0,2,1,0,1,0
"ERFAN",2,0,1,0,2,1,0,1,0
"ERIE",0,2,0,1,2,0,1,0,1
"ERIOLA",0,2,0,1,2,0,1,0,1
"ERK",3,0,1,0,3,1,0,1,0
"ERLINE",0,2,0,1,2,0,1,0,1
"ERMENEGILDO",2,0,1,0,2,1,0,1,0
"ERRON",2,0,1,0,2,1,0,1,0
"ERSEN",2,0,1,0,2,1,0,1,0
"ERSHAD",3,0,1,0,3,1,0,1,0
"ERTUGRUL",3,0,1,0,3,1,0,1,0
"ERV",2,0,1,0,2,1,0,1,0
"ERYC",3,0,1,0,3,1,0,1,0
"ERYCK",2,0,1,0,2,1,0,1,0
"ESCHER",1,2,.3333333,.6666667,3,0,0,0,0
"ESCO",2,1,.6666667,.3333333,3,0,0,0,0
"ESCRAVA",0,3,0,1,3,0,1,0,1
"ESDRAS",2,1,.6666667,.3333333,3,0,0,0,0
"ESMEE",0,2,0,1,2,0,1,0,1
"ESPINAL",2,0,1,0,2,1,0,1,0
"ESSIEN",0,2,0,1,2,0,1,0,1
"ESTEFFANY",0,2,0,1,2,0,1,0,1
"ESTELITA",0,3,0,1,3,0,1,0,1
"ESTERLIN",1,2,.3333333,.6666667,3,0,0,0,0
"ESTEVEN",2,0,1,0,2,1,0,1,0
"ESY",1,1,.5,.5,2,0,0,0,0
"ET",2,0,1,0,2,1,0,1,0
"ETERNITY",0,3,0,1,3,0,1,0,1
"ETNA",1,1,.5,.5,2,0,0,0,0
"EUCLID",2,0,1,0,2,1,0,1,0
"EUDYS",3,0,1,0,3,1,0,1,0
"EULANDA",0,2,0,1,2,0,1,0,1
"EUNIE",0,3,0,1,3,0,1,0,1
"EUNSEOK",3,0,1,0,3,1,0,1,0
"EUNSOOK",0,2,0,1,2,0,1,0,1
"EURALIS",0,2,0,1,2,0,1,0,1
"EVANIA",0,2,0,1,2,0,1,0,1
"EVDOKIA",0,2,0,1,2,0,1,0,1
"EVERTH",3,0,1,0,3,1,0,1,0
"EVERYDAY",1,1,.5,.5,2,0,0,0,0
"EVET",0,2,0,1,2,0,1,0,1
"EVGUENI",2,0,1,0,2,1,0,1,0
"EVYATAR",2,0,1,0,2,1,0,1,0
"EWARD",2,0,1,0,2,1,0,1,0
"EYLEEN",0,3,0,1,3,0,1,0,1
"EYUP",2,0,1,0,2,1,0,1,0
"EZIO",2,0,1,0,2,1,0,1,0
"EZRI",2,0,1,0,2,1,0,1,0
"EZZAT",2,0,1,0,2,1,0,1,0
"FAATIMAH",0,2,0,1,2,0,1,0,1
"FADIL",2,0,1,0,2,1,0,1,0
"FAE",0,3,0,1,3,0,1,0,1
"FAHED",2,0,1,0,2,1,0,1,0
"FAHRI",2,0,1,0,2,1,0,1,0
"FALECIA",0,2,0,1,2,0,1,0,1
"FAQUAN",3,0,1,0,3,1,0,1,0
"FARAJ",2,0,1,0,2,1,0,1,0
"FARD",3,0,1,0,3,1,0,1,0
"FARNAZ",0,2,0,1,2,0,1,0,1
"FARO",2,0,1,0,2,1,0,1,0
"FARRAN",0,2,0,1,2,0,1,0,1
"FARZAN",2,0,1,0,2,1,0,1,0
"FATEMAH",0,2,0,1,2,0,1,0,1
"FATEN",0,2,0,1,2,0,1,0,1
"FATHIA",0,2,0,1,2,0,1,0,1
"FATIMATA",0,2,0,1,2,0,1,0,1
"FATIME",0,2,0,1,2,0,1,0,1
"FATOUMA",0,2,0,1,2,0,1,0,1
"FATTY",1,1,.5,.5,2,0,0,0,0
"FAYYAZ",2,0,1,0,2,1,0,1,0
"FAZIA",0,2,0,1,2,0,1,0,1
"FAZILA",0,2,0,1,2,0,1,0,1
"FAZLUL",2,0,1,0,2,1,0,1,0
"FEEL",2,0,1,0,2,1,0,1,0
"FEHMI",3,0,1,0,3,1,0,1,0
"FELESHA",0,2,0,1,2,0,1,0,1
"FELICHA",0,2,0,1,2,0,1,0,1
"FELIPA",0,2,0,1,2,0,1,0,1
"FELIZ",0,2,0,1,2,0,1,0,1
"FENDI",1,2,.3333333,.6666667,3,0,0,0,0
"FENNIE",0,2,0,1,2,0,1,0,1
"FEONA",0,2,0,1,2,0,1,0,1
"FERCHO",2,0,1,0,2,1,0,1,0
"FERID",2,0,1,0,2,1,0,1,0
"FETTI",2,1,.6666667,.3333333,3,0,0,0,0
"FETTY",1,2,.3333333,.6666667,3,0,0,0,0
"FIDAN",2,1,.6666667,.3333333,3,0,0,0,0
"FIGARO",3,0,1,0,3,1,0,1,0
"FILI",1,2,.3333333,.6666667,3,0,0,0,0
"FIORI",0,2,0,1,2,0,1,0,1
"FLIGHT",2,0,1,0,2,1,0,1,0
"FLORENTINO",2,0,1,0,2,1,0,1,0
"FLORI",1,2,.3333333,.6666667,3,0,0,0,0
"FLORIA",0,2,0,1,2,0,1,0,1
"FLOY",1,1,.5,.5,2,0,0,0,0
"FLUTURA",0,2,0,1,2,0,1,0,1
"FODAY",2,0,1,0,2,1,0,1,0
"FOLASADE",0,3,0,1,3,0,1,0,1
"FOLORUNSO",2,0,1,0,2,1,0,1,0
"FOOLISH",2,0,1,0,2,1,0,1,0
"FRANCESSE",0,2,0,1,2,0,1,0,1
"FRANKELLY",3,0,1,0,3,1,0,1,0
"FRANKIN",2,0,1,0,2,1,0,1,0
"FRAYDA",0,2,0,1,2,0,1,0,1
"FRAZER",3,0,1,0,3,1,0,1,0
"FRE",2,0,1,0,2,1,0,1,0
"FREDERIKE",0,2,0,1,2,0,1,0,1
"FREDO",2,0,1,0,2,1,0,1,0
"FREDRICKA",0,2,0,1,2,0,1,0,1
"FRESA",0,2,0,1,2,0,1,0,1
"FRISCO",2,0,1,0,2,1,0,1,0
"FRITZA",0,2,0,1,2,0,1,0,1
"FROZEN",1,1,.5,.5,2,0,0,0,0
"FRUM",2,0,1,0,2,1,0,1,0
"FUENTES",0,2,0,1,2,0,1,0,1
"FUK",1,1,.5,.5,2,0,0,0,0
"FUMIHIRO",3,0,1,0,3,1,0,1,0
"FUMIO",2,0,1,0,2,1,0,1,0
"FUSAKO",0,3,0,1,3,0,1,0,1
"GAILE",0,2,0,1,2,0,1,0,1
"GALLY",2,0,1,0,2,1,0,1,0
"GALT",1,1,.5,.5,2,0,0,0,0
"GANA",1,1,.5,.5,2,0,0,0,0
"GARAM",3,0,1,0,3,1,0,1,0
"GARBO",0,2,0,1,2,0,1,0,1
"GARDEN",1,1,.5,.5,2,0,0,0,0
"GARDITH",0,2,0,1,2,0,1,0,1
"GAREY",2,0,1,0,2,1,0,1,0
"GARRISON",3,0,1,0,3,1,0,1,0
"GARVENS",3,0,1,0,3,1,0,1,0
"GATA",0,3,0,1,3,0,1,0,1
"GAUTHAM",2,0,1,0,2,1,0,1,0
"GAYNELLE",0,3,0,1,3,0,1,0,1
"GAYOUNG",0,2,0,1,2,0,1,0,1
"GAZMIR",2,0,1,0,2,1,0,1,0
"GED",0,2,0,1,2,0,1,0,1
"GEEGEE",0,2,0,1,2,0,1,0,1
"GEFFREY",3,0,1,0,3,1,0,1,0
"GENGIS",2,0,1,0,2,1,0,1,0
"GENKI",2,1,.6666667,.3333333,3,0,0,0,0
"GENNIE",0,2,0,1,2,0,1,0,1
"GENY",0,2,0,1,2,0,1,0,1
"GEOVANI",2,0,1,0,2,1,0,1,0
"GERD",3,0,1,0,3,1,0,1,0
"GERHARDT",2,0,1,0,2,1,0,1,0
"GEROGE",2,0,1,0,2,1,0,1,0
"GERON",3,0,1,0,3,1,0,1,0
"GERRARD",2,0,1,0,2,1,0,1,0
"GERRIANN",0,3,0,1,3,0,1,0,1
"GERRIANNE",0,3,0,1,3,0,1,0,1
"GERSH",2,0,1,0,2,1,0,1,0
"GESSELLE",0,3,0,1,3,0,1,0,1
"GETTY",1,2,.3333333,.6666667,3,0,0,0,0
"GETZY",2,0,1,0,2,1,0,1,0
"GHALIB",3,0,1,0,3,1,0,1,0
"GIAMPAOLO",3,0,1,0,3,1,0,1,0
"GIANLUIGI",3,0,1,0,3,1,0,1,0
"GIANVITO",2,0,1,0,2,1,0,1,0
"GIBBS",3,0,1,0,3,1,0,1,0
"GIBSON",3,0,1,0,3,1,0,1,0
"GIEDRE",0,3,0,1,3,0,1,0,1
"GIFTED",3,0,1,0,3,1,0,1,0
"GILSON",3,0,1,0,3,1,0,1,0
"GIMA",0,3,0,1,3,0,1,0,1
"GINES",2,0,1,0,2,1,0,1,0
"GINEVRA",0,2,0,1,2,0,1,0,1
"GINIA",0,2,0,1,2,0,1,0,1
"GIORA",3,0,1,0,3,1,0,1,0
"GIORDANI",3,0,1,0,3,1,0,1,0
"GIORDANO",2,0,1,0,2,1,0,1,0
"GIORGINA",0,2,0,1,2,0,1,0,1
"GIRAY",3,0,1,0,3,1,0,1,0
"GISETTE",0,2,0,1,2,0,1,0,1
"GITANJALI",0,2,0,1,2,0,1,0,1
"GLADWIN",2,0,1,0,2,1,0,1,0
"GLENDON",2,0,1,0,2,1,0,1,0
"GLENISE",0,2,0,1,2,0,1,0,1
"GLENMORE",2,0,1,0,2,1,0,1,0
"GLENNIE",1,2,.3333333,.6666667,3,0,0,0,0
"GLOVER",2,0,1,0,2,1,0,1,0
"GOLI",0,2,0,1,2,0,1,0,1
"GOMA",1,2,.3333333,.6666667,3,0,0,0,0
"GOPAUL",2,0,1,0,2,1,0,1,0
"GORGE",3,0,1,0,3,1,0,1,0
"GOSS",0,2,0,1,2,0,1,0,1
"GOUTAM",3,0,1,0,3,1,0,1,0
"GOVINDA",2,0,1,0,2,1,0,1,0
"GOWTHAM",3,0,1,0,3,1,0,1,0
"GRACY",0,2,0,1,2,0,1,0,1
"GRAZYNA",0,3,0,1,3,0,1,0,1
"GREENWICH",1,1,.5,.5,2,0,0,0,0
"GREGGORY",3,0,1,0,3,1,0,1,0
"GREICY",0,2,0,1,2,0,1,0,1
"GRETHE",0,2,0,1,2,0,1,0,1
"GRIGOR",2,0,1,0,2,1,0,1,0
"GROUCHO",1,1,.5,.5,2,0,0,0,0
"GUALBERTO",2,0,1,0,2,1,0,1,0
"GUENEVERE",0,3,0,1,3,0,1,0,1
"GUENTHER",3,0,1,0,3,1,0,1,0
"GUERDY",0,2,0,1,2,0,1,0,1
"GUERINO",3,0,1,0,3,1,0,1,0
"GUERLAIN",1,1,.5,.5,2,0,0,0,0
"GUILAINE",0,2,0,1,2,0,1,0,1
"GUILFORD",2,0,1,0,2,1,0,1,0
"GUILLO",2,0,1,0,2,1,0,1,0
"GULNAZ",0,2,0,1,2,0,1,0,1
"GUNEL",0,2,0,1,2,0,1,0,1
"GUNTER",3,0,1,0,3,1,0,1,0
"GUR",2,0,1,0,2,1,0,1,0
"GURHAN",2,0,1,0,2,1,0,1,0
"GURJEET",1,1,.5,.5,2,0,0,0,0
"GURWINDER",2,0,1,0,2,1,0,1,0
"GUZEL",1,1,.5,.5,2,0,0,0,0
"GYULA",2,0,1,0,2,1,0,1,0
"HAARIS",3,0,1,0,3,1,0,1,0
"HADDON",2,0,1,0,2,1,0,1,0
"HADJA",0,2,0,1,2,0,1,0,1
"HADRIAN",3,0,1,0,3,1,0,1,0
"HADY",2,0,1,0,2,1,0,1,0
"HAEIN",0,2,0,1,2,0,1,0,1
"HAJA",0,2,0,1,2,0,1,0,1
"HALEEMA",0,2,0,1,2,0,1,0,1
"HALENA",0,2,0,1,2,0,1,0,1
"HAMADY",2,0,1,0,2,1,0,1,0
"HAMANI",2,0,1,0,2,1,0,1,0
"HAMMY",1,2,.3333333,.6666667,3,0,0,0,0
"HANAE",0,2,0,1,2,0,1,0,1
"HANDOKO",3,0,1,0,3,1,0,1,0
"HANDS",1,1,.5,.5,2,0,0,0,0
"HANIA",0,2,0,1,2,0,1,0,1
"HANKA",0,2,0,1,2,0,1,0,1
"HANSA",1,1,.5,.5,2,0,0,0,0
"HANSOME",3,0,1,0,3,1,0,1,0
"HAP",3,0,1,0,3,1,0,1,0
"HAR",2,0,1,0,2,1,0,1,0
"HARALD",3,0,1,0,3,1,0,1,0
"HARBOR",1,2,.3333333,.6666667,3,0,0,0,0
"HARD",3,0,1,0,3,1,0,1,0
"HARDCORE",2,0,1,0,2,1,0,1,0
"HARMONIE",1,2,.3333333,.6666667,3,0,0,0,0
"HARRIETT",0,3,0,1,3,0,1,0,1
"HARRON",2,0,1,0,2,1,0,1,0
"HARUKO",0,2,0,1,2,0,1,0,1
"HARUT",3,0,1,0,3,1,0,1,0
"HASAAN",2,0,1,0,2,1,0,1,0
"HASSON",3,0,1,0,3,1,0,1,0
"HAWK",2,0,1,0,2,1,0,1,0
"HAYK",3,0,1,0,3,1,0,1,0
"HAZUKI",0,2,0,1,2,0,1,0,1
"HEATHERLYN",0,2,0,1,2,0,1,0,1
"HEBER",3,0,1,0,3,1,0,1,0
"HEBERT",3,0,1,0,3,1,0,1,0
"HEDGE",1,1,.5,.5,2,0,0,0,0
"HEEJU",0,2,0,1,2,0,1,0,1
"HEERA",2,0,1,0,2,1,0,1,0
"HEINER",2,0,1,0,2,1,0,1,0
"HELAINA",0,2,0,1,2,0,1,0,1
"HELANA",0,2,0,1,2,0,1,0,1
"HEND",0,2,0,1,2,0,1,0,1
"HENDRI",3,0,1,0,3,1,0,1,0
"HENRRY",3,0,1,0,3,1,0,1,0
"HERALD",3,0,1,0,3,1,0,1,0
"HERALDO",2,0,1,0,2,1,0,1,0
"HERI",2,0,1,0,2,1,0,1,0
"HERNALDO",3,0,1,0,3,1,0,1,0
"HERSHY",2,0,1,0,2,1,0,1,0
"HERVEY",3,0,1,0,3,1,0,1,0
"HIGH",3,0,1,0,3,1,0,1,0
"HINDI",0,3,0,1,3,0,1,0,1
"HINNA",0,2,0,1,2,0,1,0,1
"HISA",1,2,.3333333,.6666667,3,0,0,0,0
"HIU",1,1,.5,.5,2,0,0,0,0
"HOBBES",3,0,1,0,3,1,0,1,0
"HOLT",1,1,.5,.5,2,0,0,0,0
"HOMAYOUN",3,0,1,0,3,1,0,1,0
"HOME",2,0,1,0,2,1,0,1,0
"HOONG",0,2,0,1,2,0,1,0,1
"HOOPZ",3,0,1,0,3,1,0,1,0
"HORANE",2,0,1,0,2,1,0,1,0
"HORTENSE",0,3,0,1,3,0,1,0,1
"HOSNA",0,2,0,1,2,0,1,0,1
"HOSUN",0,2,0,1,2,0,1,0,1
"HOUDINI",3,0,1,0,3,1,0,1,0
"HOUSSAM",2,0,1,0,2,1,0,1,0
"HOWELL",2,0,1,0,2,1,0,1,0
"HOYIN",2,0,1,0,2,1,0,1,0
"HOZEFA",2,0,1,0,2,1,0,1,0
"HRIDOY",3,0,1,0,3,1,0,1,0
"HUG",1,1,.5,.5,2,0,0,0,0
"HUIMIN",0,2,0,1,2,0,1,0,1
"HUMBER",3,0,1,0,3,1,0,1,0
"HUSAYN",2,0,1,0,2,1,0,1,0
"HUZAIFA",3,0,1,0,3,1,0,1,0
"HYATT",2,0,1,0,2,1,0,1,0
"HYDER",3,0,1,0,3,1,0,1,0
"HYPE",2,0,1,0,2,1,0,1,0
"HYUNJIN",0,2,0,1,2,0,1,0,1
"HYUNSUK",3,0,1,0,3,1,0,1,0
"IBA",2,1,.6666667,.3333333,3,0,0,0,0
"ICELEAN",0,2,0,1,2,0,1,0,1
"ICHIGO",1,1,.5,.5,2,0,0,0,0
"IDELL",1,2,.3333333,.6666667,3,0,0,0,0
"IDELLA",0,3,0,1,3,0,1,0,1
"IDREES",2,0,1,0,2,1,0,1,0
"IGLESIAS",2,0,1,0,2,1,0,1,0
"IKBAL",1,1,.5,.5,2,0,0,0,0
"ILDI",0,2,0,1,2,0,1,0,1
"ILIJA",2,0,1,0,2,1,0,1,0
"ILISE",0,3,0,1,3,0,1,0,1
"ILLONA",0,3,0,1,3,0,1,0,1
"IM",2,0,1,0,2,1,0,1,0
"IMOGENE",0,2,0,1,2,0,1,0,1
"INDRAJIT",2,0,1,0,2,1,0,1,0
"INESE",0,2,0,1,2,0,1,0,1
"INGO",2,0,1,0,2,1,0,1,0
"INNESSA",0,2,0,1,2,0,1,0,1
"IOSIF",2,0,1,0,2,1,0,1,0
"IRKA",0,2,0,1,2,0,1,0,1
"ISAACS",2,0,1,0,2,1,0,1,0
"ISAM",2,0,1,0,2,1,0,1,0
"ISHARA",1,1,.5,.5,2,0,0,0,0
"ISHMEL",3,0,1,0,3,1,0,1,0
"ISKANDER",2,0,1,0,2,1,0,1,0
"ISRAR",2,0,1,0,2,1,0,1,0
"ISSEI",2,0,1,0,2,1,0,1,0
"ISSIAKA",2,0,1,0,2,1,0,1,0
"ISTIAQUE",2,0,1,0,2,1,0,1,0
"ITI",1,1,.5,.5,2,0,0,0,0
"ITIEL",2,0,1,0,2,1,0,1,0
"ITO",2,0,1,0,2,1,0,1,0
"IULIAN",2,0,1,0,2,1,0,1,0
"IVAILO",2,0,1,0,2,1,0,1,0
"IVELINA",0,2,0,1,2,0,1,0,1
"IVER",3,0,1,0,3,1,0,1,0
"IYORE",0,2,0,1,2,0,1,0,1
"IZABEL",0,2,0,1,2,0,1,0,1
"IZAIAH",2,0,1,0,2,1,0,1,0
"IZHAR",2,0,1,0,2,1,0,1,0
"JAAEL",1,1,.5,.5,2,0,0,0,0
"JABER",2,0,1,0,2,1,0,1,0
"JACKILYN",0,3,0,1,3,0,1,0,1
"JACOBI",1,1,.5,.5,2,0,0,0,0
"JACOLE",0,2,0,1,2,0,1,0,1
"JACQUALINE",0,3,0,1,3,0,1,0,1
"JACQUILINE",0,3,0,1,3,0,1,0,1
"JADRANKA",0,2,0,1,2,0,1,0,1
"JAEHONG",3,0,1,0,3,1,0,1,0
"JAEMIN",2,0,1,0,2,1,0,1,0
"JAEQUAN",3,0,1,0,3,1,0,1,0
"JAESUNG",3,0,1,0,3,1,0,1,0
"JAFARI",2,0,1,0,2,1,0,1,0
"JAGRUTI",0,2,0,1,2,0,1,0,1
"JAHDIEL",2,0,1,0,2,1,0,1,0
"JAHMEEK",2,0,1,0,2,1,0,1,0
"JAHNAVI",0,2,0,1,2,0,1,0,1
"JAHNNA",0,3,0,1,3,0,1,0,1
"JAHREL",2,0,1,0,2,1,0,1,0
"JAIPAUL",3,0,1,0,3,1,0,1,0
"JAIQUAN",3,0,1,0,3,1,0,1,0
"JAIRAM",2,0,1,0,2,1,0,1,0
"JAIRON",3,0,1,0,3,1,0,1,0
"JAKELINE",0,2,0,1,2,0,1,0,1
"JALON",1,1,.5,.5,2,0,0,0,0
"JAMARA",0,2,0,1,2,0,1,0,1
"JAMAUL",2,0,1,0,2,1,0,1,0
"JAMICE",0,3,0,1,3,0,1,0,1
"JAMIEK",2,0,1,0,2,1,0,1,0
"JAMIELYNN",0,2,0,1,2,0,1,0,1
"JAMISHA",0,2,0,1,2,0,1,0,1
"JAMMI",0,2,0,1,2,0,1,0,1
"JAMPA",0,2,0,1,2,0,1,0,1
"JAMSHED",3,0,1,0,3,1,0,1,0
"JANAH",0,2,0,1,2,0,1,0,1
"JANEMARIE",0,2,0,1,2,0,1,0,1
"JANERIS",0,2,0,1,2,0,1,0,1
"JANERY",0,2,0,1,2,0,1,0,1
"JANISHA",0,2,0,1,2,0,1,0,1
"JANNINA",0,2,0,1,2,0,1,0,1
"JAPHIA",1,2,.3333333,.6666667,3,0,0,0,0
"JAQUAY",2,1,.6666667,.3333333,3,0,0,0,0
"JARINA",0,3,0,1,3,0,1,0,1
"JARMAINE",2,0,1,0,2,1,0,1,0
"JARMAL",3,0,1,0,3,1,0,1,0
"JAROMIR",2,0,1,0,2,1,0,1,0
"JARRY",2,0,1,0,2,1,0,1,0
"JARY",2,1,.6666667,.3333333,3,0,0,0,0
"JASH",1,1,.5,.5,2,0,0,0,0
"JASHIM",2,0,1,0,2,1,0,1,0
"JASIM",2,0,1,0,2,1,0,1,0
"JASJEET",2,0,1,0,2,1,0,1,0
"JASKIRAT",2,0,1,0,2,1,0,1,0
"JATAWN",1,2,.3333333,.6666667,3,0,0,0,0
"JATNNA",0,2,0,1,2,0,1,0,1
"JAVIS",2,1,.6666667,.3333333,3,0,0,0,0
"JAVONA",0,2,0,1,2,0,1,0,1
"JAVONE",2,0,1,0,2,1,0,1,0
"JAVONNA",0,2,0,1,2,0,1,0,1
"JAVONTE",2,0,1,0,2,1,0,1,0
"JAYANTI",1,1,.5,.5,2,0,0,0,0
"JAYLON",2,0,1,0,2,1,0,1,0
"JAYLYN",1,1,.5,.5,2,0,0,0,0
"JAYNIE",0,3,0,1,3,0,1,0,1
"JAYRON",2,1,.6666667,.3333333,3,0,0,0,0
"JAYSEAN",3,0,1,0,3,1,0,1,0
"JAYTEE",1,1,.5,.5,2,0,0,0,0
"JEANCLAUDE",2,0,1,0,2,1,0,1,0
"JEANE",0,2,0,1,2,0,1,0,1
"JEANEL",0,2,0,1,2,0,1,0,1
"JEANET",1,2,.3333333,.6666667,3,0,0,0,0
"JEANHEE",0,2,0,1,2,0,1,0,1
"JEANNETH",0,3,0,1,3,0,1,0,1
"JEBA",0,2,0,1,2,0,1,0,1
"JEEHEE",0,2,0,1,2,0,1,0,1
"JEEVES",2,0,1,0,2,1,0,1,0
"JEEYOUNG",0,2,0,1,2,0,1,0,1
"JEFFRE",2,0,1,0,2,1,0,1,0
"JEHANNE",1,2,.3333333,.6666667,3,0,0,0,0
"JEMAINE",3,0,1,0,3,1,0,1,0
"JENEANE",0,2,0,1,2,0,1,0,1
"JENEBA",0,2,0,1,2,0,1,0,1
"JENILYN",0,2,0,1,2,0,1,0,1
"JENINA",0,2,0,1,2,0,1,0,1
"JENINNE",0,2,0,1,2,0,1,0,1
"JENNET",0,2,0,1,2,0,1,0,1
"JENNIFA",0,3,0,1,3,0,1,0,1
"JENSEY",2,0,1,0,2,1,0,1,0
"JERA",0,2,0,1,2,0,1,0,1
"JERICK",3,0,1,0,3,1,0,1,0
"JERIE",0,2,0,1,2,0,1,0,1
"JERMANE",2,0,1,0,2,1,0,1,0
"JERMY",1,1,.5,.5,2,0,0,0,0
"JERODE",3,0,1,0,3,1,0,1,0
"JEROMY",2,0,1,0,2,1,0,1,0
"JERONE",3,0,1,0,3,1,0,1,0
"JESON",2,1,.6666667,.3333333,3,0,0,0,0
"JESSECA",0,3,0,1,3,0,1,0,1
"JESSEL",2,1,.6666667,.3333333,3,0,0,0,0
"JESSIBEL",0,2,0,1,2,0,1,0,1
"JESSICALYNN",0,2,0,1,2,0,1,0,1
"JEV",2,0,1,0,2,1,0,1,0
"JEVAUN",2,0,1,0,2,1,0,1,0
"JEYSSON",3,0,1,0,3,1,0,1,0
"JEZABEL",0,2,0,1,2,0,1,0,1
"JHANELLE",1,1,.5,.5,2,0,0,0,0
"JHOANNY",0,2,0,1,2,0,1,0,1
"JHONSON",2,0,1,0,2,1,0,1,0
"JIAMIN",1,1,.5,.5,2,0,0,0,0
"JIANA",0,2,0,1,2,0,1,0,1
"JIANNA",0,2,0,1,2,0,1,0,1
"JIANPING",0,2,0,1,2,0,1,0,1
"JIAYING",0,3,0,1,3,0,1,0,1
"JIB",1,1,.5,.5,2,0,0,0,0
"JIBRI",2,0,1,0,2,1,0,1,0
"JIGGS",2,0,1,0,2,1,0,1,0
"JIGNA",0,2,0,1,2,0,1,0,1
"JILLAN",1,2,.3333333,.6666667,3,0,0,0,0
"JIMEKA",0,2,0,1,2,0,1,0,1
"JIMMI",2,0,1,0,2,1,0,1,0
"JINGER",0,2,0,1,2,0,1,0,1
"JINGLE",1,1,.5,.5,2,0,0,0,0
"JINSOO",2,0,1,0,2,1,0,1,0
"JINYU",1,1,.5,.5,2,0,0,0,0
"JOAL",2,0,1,0,2,1,0,1,0
"JO-AN",0,2,0,1,2,0,1,0,1
"JOBE",2,0,1,0,2,1,0,1,0
"JOCEL",1,1,.5,.5,2,0,0,0,0
"JOCELYNN",0,2,0,1,2,0,1,0,1
"JOEVON",2,0,1,0,2,1,0,1,0
"JOHA",2,0,1,0,2,1,0,1,0
"JOHANNIE",0,2,0,1,2,0,1,0,1
"JOHNETTA",0,2,0,1,2,0,1,0,1
"JOHNN",3,0,1,0,3,1,0,1,0
"JO-JO",2,0,1,0,2,1,0,1,0
"JOKE",1,1,.5,.5,2,0,0,0,0
"JOMARA",0,2,0,1,2,0,1,0,1
"JONAN",2,0,1,0,2,1,0,1,0
"JONGWON",2,0,1,0,2,1,0,1,0
"JONIEL",3,0,1,0,3,1,0,1,0
"JONPAUL",2,0,1,0,2,1,0,1,0
"JONTE",0,2,0,1,2,0,1,0,1
"JOOHYUN",2,0,1,0,2,1,0,1,0
"JORDANO",2,0,1,0,2,1,0,1,0
"JORIS",2,0,1,0,2,1,0,1,0
"JOSCELYN",0,2,0,1,2,0,1,0,1
"JOSEE",0,3,0,1,3,0,1,0,1
"JOSEPHA",0,2,0,1,2,0,1,0,1
"JOSETH",1,2,.3333333,.6666667,3,0,0,0,0
"JOSETTA",0,3,0,1,3,0,1,0,1
"JOSIANNE",0,3,0,1,3,0,1,0,1
"JOSLIN",0,3,0,1,3,0,1,0,1
"JOSMAR",3,0,1,0,3,1,0,1,0
"JOSMARIE",0,2,0,1,2,0,1,0,1
"JOU",1,1,.5,.5,2,0,0,0,0
"JOUBERT",2,0,1,0,2,1,0,1,0
"JOVAUGHN",2,0,1,0,2,1,0,1,0
"JOVE",1,1,.5,.5,2,0,0,0,0
"JOVICA",2,1,.6666667,.3333333,3,0,0,0,0
"JOWAYNE",2,0,1,0,2,1,0,1,0
"JOYDEEP",2,0,1,0,2,1,0,1,0
"JOYLEEN",0,2,0,1,2,0,1,0,1
"JUANI",0,2,0,1,2,0,1,0,1
"JUBE",3,0,1,0,3,1,0,1,0
"JUDYTH",0,2,0,1,2,0,1,0,1
"JUHI",0,3,0,1,3,0,1,0,1
"JUHO",3,0,1,0,3,1,0,1,0
"JUHYUN",0,2,0,1,2,0,1,0,1
"JULAINE",0,2,0,1,2,0,1,0,1
"JULLIE",0,2,0,1,2,0,1,0,1
"JULLY",0,2,0,1,2,0,1,0,1
"JULS",0,2,0,1,2,0,1,0,1
"JUMAH",2,0,1,0,2,1,0,1,0
"JUNA",0,2,0,1,2,0,1,0,1
"JUNCHEN",2,0,1,0,2,1,0,1,0
"JUNED",2,0,1,0,2,1,0,1,0
"JUNGSUN",1,2,.3333333,.6666667,3,0,0,0,0
"JUNGWOO",1,1,.5,.5,2,0,0,0,0
"JUPITER",2,1,.6666667,.3333333,3,0,0,0,0
"JUWEL",3,0,1,0,3,1,0,1,0
"JUWON",1,1,.5,.5,2,0,0,0,0
"JÃ–RN",2,0,1,0,2,1,0,1,0
"KAAJAL",0,2,0,1,2,0,1,0,1
"KABRINA",0,2,0,1,2,0,1,0,1
"KADIATU",0,3,0,1,3,0,1,0,1
"KADIDJA",0,2,0,1,2,0,1,0,1
"KADINA",0,2,0,1,2,0,1,0,1
"KAEDI",0,2,0,1,2,0,1,0,1
"KAESHA",0,2,0,1,2,0,1,0,1
"KAHIEM",2,0,1,0,2,1,0,1,0
"KAILASH",2,0,1,0,2,1,0,1,0
"KAILE",2,0,1,0,2,1,0,1,0
"KAJOL",0,2,0,1,2,0,1,0,1
"KAJUAN",2,0,1,0,2,1,0,1,0
"KAKA",3,0,1,0,3,1,0,1,0
"KAKO",2,1,.6666667,.3333333,3,0,0,0,0
"KALEL",2,0,1,0,2,1,0,1,0
"KALIEF",3,0,1,0,3,1,0,1,0
"KALIK",2,0,1,0,2,1,0,1,0
"KALILA",0,2,0,1,2,0,1,0,1
"KALIQ",2,0,1,0,2,1,0,1,0
"KAMANI",1,1,.5,.5,2,0,0,0,0
"KAMECA",0,2,0,1,2,0,1,0,1
"KAMEISHA",0,3,0,1,3,0,1,0,1
"KAMEKA",0,2,0,1,2,0,1,0,1
"KAMIA",0,3,0,1,3,0,1,0,1
"KAMILO",2,0,1,0,2,1,0,1,0
"KAMMI",0,3,0,1,3,0,1,0,1
"KAMOL",2,0,1,0,2,1,0,1,0
"KAMRUZ",2,0,1,0,2,1,0,1,0
"KAMY",2,0,1,0,2,1,0,1,0
"KANDIE",0,3,0,1,3,0,1,0,1
"KANO",3,0,1,0,3,1,0,1,0
"KANTA",0,2,0,1,2,0,1,0,1
"KANU",2,1,.6666667,.3333333,3,0,0,0,0
"KAOUTAR",0,2,0,1,2,0,1,0,1
"KAPILA",2,1,.6666667,.3333333,3,0,0,0,0
"KARACA",1,1,.5,.5,2,0,0,0,0
"KARIANNE",0,2,0,1,2,0,1,0,1
"KARIME",0,3,0,1,3,0,1,0,1
"KARLE",1,1,.5,.5,2,0,0,0,0
"KARLITO",2,0,1,0,2,1,0,1,0
"KARMALOOP",2,1,.6666667,.3333333,3,0,0,0,0
"KARMEL",1,2,.3333333,.6666667,3,0,0,0,0
"KAROLA",0,2,0,1,2,0,1,0,1
"KARRIN",1,2,.3333333,.6666667,3,0,0,0,0
"KASIEM",2,0,1,0,2,1,0,1,0
"KATAYOUN",0,3,0,1,3,0,1,0,1
"KATHERYNE",0,2,0,1,2,0,1,0,1
"KATSIARYNA",0,2,0,1,2,0,1,0,1
"KATUCHA",0,2,0,1,2,0,1,0,1
"KAUSTUBH",2,0,1,0,2,1,0,1,0
"KAYCI",0,2,0,1,2,0,1,0,1
"KAYDI",0,2,0,1,2,0,1,0,1
"KAYLEY",0,3,0,1,3,0,1,0,1
"KAYRON",1,1,.5,.5,2,0,0,0,0
"KAYSER",2,0,1,0,2,1,0,1,0
"KAYSON",2,0,1,0,2,1,0,1,0
"KAYTI",0,3,0,1,3,0,1,0,1
"KAZEEM",3,0,1,0,3,1,0,1,0
"KAZUNORI",3,0,1,0,3,1,0,1,0
"KEANU",2,0,1,0,2,1,0,1,0
"KEDISHA",0,3,0,1,3,0,1,0,1
"KEDWIN",2,0,1,0,2,1,0,1,0
"KEELE",1,1,.5,.5,2,0,0,0,0
"KEENE",2,0,1,0,2,1,0,1,0
"KEETH",2,0,1,0,2,1,0,1,0
"KEIN",2,1,.6666667,.3333333,3,0,0,0,0
"KEISHAWN",2,1,.6666667,.3333333,3,0,0,0,0
"KEISY",1,2,.3333333,.6666667,3,0,0,0,0
"KELCI",0,3,0,1,3,0,1,0,1
"KELEIGH",0,2,0,1,2,0,1,0,1
"KELTON",3,0,1,0,3,1,0,1,0
"KELYN",0,2,0,1,2,0,1,0,1
"KEMESHA",0,3,0,1,3,0,1,0,1
"KENDALE",2,0,1,0,2,1,0,1,0
"KENDO",3,0,1,0,3,1,0,1,0
"KENDON",2,0,1,0,2,1,0,1,0
"KENDU",2,0,1,0,2,1,0,1,0
"KENNESHA",0,2,0,1,2,0,1,0,1
"KENNITH",3,0,1,0,3,1,0,1,0
"KENTO",2,0,1,0,2,1,0,1,0
"KENWYN",2,0,1,0,2,1,0,1,0
"KEREEN",0,2,0,1,2,0,1,0,1
"KERI-ANNE",0,2,0,1,2,0,1,0,1
"KERLI",0,2,0,1,2,0,1,0,1
"KEROL",0,2,0,1,2,0,1,0,1
"KERONE",1,1,.5,.5,2,0,0,0,0
"KERRILYNN",0,2,0,1,2,0,1,0,1
"KERRINE",0,2,0,1,2,0,1,0,1
"KES",2,0,1,0,2,1,0,1,0
"KESHAV",2,0,1,0,2,1,0,1,0
"KESI",0,3,0,1,3,0,1,0,1
"KESS",3,0,1,0,3,1,0,1,0
"KETISHA",0,2,0,1,2,0,1,0,1
"KETTLY",0,2,0,1,2,0,1,0,1
"KETY",0,2,0,1,2,0,1,0,1
"KEVN",2,0,1,0,2,1,0,1,0
"KEWANDA",0,2,0,1,2,0,1,0,1
"KEYAH",1,2,.3333333,.6666667,3,0,0,0,0
"KEYLLA",0,2,0,1,2,0,1,0,1
"KHADEEJA",0,2,0,1,2,0,1,0,1
"KHADISHA",0,3,0,1,3,0,1,0,1
"KHAIRI",2,0,1,0,2,1,0,1,0
"KHALDOUN",2,0,1,0,2,1,0,1,0
"KHALEELAH",0,3,0,1,3,0,1,0,1
"KHALY",2,1,.6666667,.3333333,3,0,0,0,0
"KHAMIS",2,0,1,0,2,1,0,1,0
"KHATUNA",0,2,0,1,2,0,1,0,1
"KHAY",1,1,.5,.5,2,0,0,0,0
"KHEM",3,0,1,0,3,1,0,1,0
"KHEPERA",1,1,.5,.5,2,0,0,0,0
"KHIA",1,1,.5,.5,2,0,0,0,0
"KHRISTIE",0,2,0,1,2,0,1,0,1
"KHURRUM",2,0,1,0,2,1,0,1,0
"KHWAJA",3,0,1,0,3,1,0,1,0
"KIAHNI",0,3,0,1,3,0,1,0,1
"KIBA",1,1,.5,.5,2,0,0,0,0
"KIBWE",2,0,1,0,2,1,0,1,0
"KIDANE",3,0,1,0,3,1,0,1,0
"KIENAN",3,0,1,0,3,1,0,1,0
"KIER",2,0,1,0,2,1,0,1,0
"KIKELOMO",0,2,0,1,2,0,1,0,1
"KIKU",0,2,0,1,2,0,1,0,1
"KILA",1,1,.5,.5,2,0,0,0,0
"KILBY",1,1,.5,.5,2,0,0,0,0
"KIMAR",3,0,1,0,3,1,0,1,0
"KIMBERLIN",0,3,0,1,3,0,1,0,1
"KINLEY",2,1,.6666667,.3333333,3,0,0,0,0
"KINYA",1,1,.5,.5,2,0,0,0,0
"KIONA",0,2,0,1,2,0,1,0,1
"KIRO",3,0,1,0,3,1,0,1,0
"KIRSTINE",0,3,0,1,3,0,1,0,1
"KISEOK",2,0,1,0,2,1,0,1,0
"KISER",2,0,1,0,2,1,0,1,0
"KISHON",1,1,.5,.5,2,0,0,0,0
"KISS",1,1,.5,.5,2,0,0,0,0
"KISSIE",0,2,0,1,2,0,1,0,1
"KITZ",0,3,0,1,3,0,1,0,1
"KIVEN",2,0,1,0,2,1,0,1,0
"KLEO",0,3,0,1,3,0,1,0,1
"KOKILA",0,2,0,1,2,0,1,0,1
"KOLE",2,1,.6666667,.3333333,3,0,0,0,0
"KONA",1,1,.5,.5,2,0,0,0,0
"KOO",1,1,.5,.5,2,0,0,0,0
"KOOK",0,2,0,1,2,0,1,0,1
"KORHAN",2,0,1,0,2,1,0,1,0
"KORKMAZ",1,1,.5,.5,2,0,0,0,0
"KORNELIJA",0,2,0,1,2,0,1,0,1
"KORO",1,1,.5,.5,2,0,0,0,0
"KOTA",2,0,1,0,2,1,0,1,0
"KOWAN",2,0,1,0,2,1,0,1,0
"KRASIMIR",2,0,1,0,2,1,0,1,0
"KRISJA",0,2,0,1,2,0,1,0,1
"KRIST",3,0,1,0,3,1,0,1,0
"KRISTELL",0,2,0,1,2,0,1,0,1
"KRISTENA",0,2,0,1,2,0,1,0,1
"KRISTIAAN",3,0,1,0,3,1,0,1,0
"KRISTIJAN",3,0,1,0,3,1,0,1,0
"KRISTINN",1,1,.5,.5,2,0,0,0,0
"KRLOS",2,0,1,0,2,1,0,1,0
"KRYSIA",0,2,0,1,2,0,1,0,1
"KRYSTYNE",0,2,0,1,2,0,1,0,1
"KUBRA",0,2,0,1,2,0,1,0,1
"KUDDUSI",2,0,1,0,2,1,0,1,0
"KULJIT",1,1,.5,.5,2,0,0,0,0
"KUMARAN",2,0,1,0,2,1,0,1,0
"KUNG",3,0,1,0,3,1,0,1,0
"KUNJAL",2,1,.6666667,.3333333,3,0,0,0,0
"KUNWAR",2,0,1,0,2,1,0,1,0
"KUTI",2,1,.6666667,.3333333,3,0,0,0,0
"KUZEY",1,1,.5,.5,2,0,0,0,0
"KWANA",0,2,0,1,2,0,1,0,1
"KWEKU",2,0,1,0,2,1,0,1,0
"KYMM",0,3,0,1,3,0,1,0,1
"KYREE",3,0,1,0,3,1,0,1,0
"KYUNGJIN",0,2,0,1,2,0,1,0,1
"KYUWON",1,1,.5,.5,2,0,0,0,0
"LACHELLE",0,3,0,1,3,0,1,0,1
"LADJI",2,0,1,0,2,1,0,1,0
"LAELA",0,2,0,1,2,0,1,0,1
"LAKEYSHA",0,2,0,1,2,0,1,0,1
"LAKI",2,0,1,0,2,1,0,1,0
"LAMELL",3,0,1,0,3,1,0,1,0
"LANELLE",1,1,.5,.5,2,0,0,0,0
"LANORE",0,2,0,1,2,0,1,0,1
"LAO",1,1,.5,.5,2,0,0,0,0
"LAQUANNA",0,2,0,1,2,0,1,0,1
"LAQUASHA",0,2,0,1,2,0,1,0,1
"LARAE",0,2,0,1,2,0,1,0,1
"LARAMIE",1,2,.3333333,.6666667,3,0,0,0,0
"LARBI",2,0,1,0,2,1,0,1,0
"LARGE",1,1,.5,.5,2,0,0,0,0
"LARSEN",2,1,.6666667,.3333333,3,0,0,0,0
"LARSON",2,0,1,0,2,1,0,1,0
"LASHEA",0,3,0,1,3,0,1,0,1
"LASHELLE",0,2,0,1,2,0,1,0,1
"LASSANA",3,0,1,0,3,1,0,1,0
"LATEASHA",0,3,0,1,3,0,1,0,1
"LATECE",0,3,0,1,3,0,1,0,1
"LATHAN",2,0,1,0,2,1,0,1,0
"LATICE",0,2,0,1,2,0,1,0,1
"LATIFFANY",0,3,0,1,3,0,1,0,1
"LATINOS",1,1,.5,.5,2,0,0,0,0
"LATOIA",0,2,0,1,2,0,1,0,1
"LA-TONIA",0,2,0,1,2,0,1,0,1
"LATORA",0,2,0,1,2,0,1,0,1
"LATRECE",0,3,0,1,3,0,1,0,1
"LATRINA",0,2,0,1,2,0,1,0,1
"LATRISHA",0,3,0,1,3,0,1,0,1
"LAUDY",0,2,0,1,2,0,1,0,1
"LAUGH",3,0,1,0,3,1,0,1,0
"LAUREANO",3,0,1,0,3,1,0,1,0
"LAURENA",0,2,0,1,2,0,1,0,1
"LAURENS",1,1,.5,.5,2,0,0,0,0
"LAURENTIU",3,0,1,0,3,1,0,1,0
"LAURINA",0,2,0,1,2,0,1,0,1
"LAURINE",0,3,0,1,3,0,1,0,1
"LAV",1,1,.5,.5,2,0,0,0,0
"LAVASIA",0,2,0,1,2,0,1,0,1
"LAY",0,3,0,1,3,0,1,0,1
"LAYTH",3,0,1,0,3,1,0,1,0
"LAZAROS",2,0,1,0,2,1,0,1,0
"LAZETTE",0,2,0,1,2,0,1,0,1
"LEAANN",0,2,0,1,2,0,1,0,1
"LEAHCIM",2,0,1,0,2,1,0,1,0
"LEARY",1,2,.3333333,.6666667,3,0,0,0,0
"LEEBA",0,2,0,1,2,0,1,0,1
"LEESHA",0,3,0,1,3,0,1,0,1
"LEK",2,0,1,0,2,1,0,1,0
"LEKESHA",0,2,0,1,2,0,1,0,1
"LEKISHA",0,2,0,1,2,0,1,0,1
"LENFORD",2,0,1,0,2,1,0,1,0
"LENITA",0,2,0,1,2,0,1,0,1
"LENROY",2,0,1,0,2,1,0,1,0
"LENS",1,1,.5,.5,2,0,0,0,0
"LEOMAR",2,0,1,0,2,1,0,1,0
"LEONARDA",0,2,0,1,2,0,1,0,1
"LEONCIO",3,0,1,0,3,1,0,1,0
"LEONY",2,0,1,0,2,1,0,1,0
"LERATO",1,1,.5,.5,2,0,0,0,0
"LESTAT",3,0,1,0,3,1,0,1,0
"LESTHER",2,0,1,0,2,1,0,1,0
"LET",0,2,0,1,2,0,1,0,1
"LETHA",0,2,0,1,2,0,1,0,1
"LETIA",0,2,0,1,2,0,1,0,1
"LETTA",0,2,0,1,2,0,1,0,1
"LETTIE",0,2,0,1,2,0,1,0,1
"LEURY",3,0,1,0,3,1,0,1,0
"LEVERN",1,1,.5,.5,2,0,0,0,0
"LEWAA",2,0,1,0,2,1,0,1,0
"LEWIE",2,0,1,0,2,1,0,1,0
"LEYVI",1,1,.5,.5,2,0,0,0,0
"LIAV",1,1,.5,.5,2,0,0,0,0
"LIBARDO",3,0,1,0,3,1,0,1,0
"LIBERT",2,0,1,0,2,1,0,1,0
"LIBNI",1,2,.3333333,.6666667,3,0,0,0,0
"LICELOT",0,3,0,1,3,0,1,0,1
"LIDYA",0,2,0,1,2,0,1,0,1
"LIELLE",0,2,0,1,2,0,1,0,1
"LIESBETH",0,2,0,1,2,0,1,0,1
"LIFENG",3,0,1,0,3,1,0,1,0
"LIGEIA",0,2,0,1,2,0,1,0,1
"LIGHT",3,0,1,0,3,1,0,1,0
"LIGHTNING",2,0,1,0,2,1,0,1,0
"LIIA",0,2,0,1,2,0,1,0,1
"LILIE",0,2,0,1,2,0,1,0,1
"LILING",0,2,0,1,2,0,1,0,1
"LILLIANNA",0,2,0,1,2,0,1,0,1
"LILYA",0,3,0,1,3,0,1,0,1
"LIME",2,0,1,0,2,1,0,1,0
"LIMING",2,0,1,0,2,1,0,1,0
"LINABEL",0,3,0,1,3,0,1,0,1
"LINELL",0,2,0,1,2,0,1,0,1
"LINFORD",3,0,1,0,3,1,0,1,0
"LINORE",0,2,0,1,2,0,1,0,1
"LIONELL",2,0,1,0,2,1,0,1,0
"LIONG",2,0,1,0,2,1,0,1,0
"LISA-ANN",0,2,0,1,2,0,1,0,1
"LISELI",0,3,0,1,3,0,1,0,1
"LISET",0,2,0,1,2,0,1,0,1
"LIST",1,1,.5,.5,2,0,0,0,0
"LITTLEJOHN",1,1,.5,.5,2,0,0,0,0
"LIVEA",0,2,0,1,2,0,1,0,1
"LIZE",0,3,0,1,3,0,1,0,1
"LIZMARY",0,3,0,1,3,0,1,0,1
"LIZZETT",0,2,0,1,2,0,1,0,1
"LJUPKA",0,2,0,1,2,0,1,0,1
"LOGO",0,2,0,1,2,0,1,0,1
"LOI",1,2,.3333333,.6666667,3,0,0,0,0
"LONNELL",2,0,1,0,2,1,0,1,0
"LOONEY",2,1,.6666667,.3333333,3,0,0,0,0
"LOPES",2,1,.6666667,.3333333,3,0,0,0,0
"LORAYNE",0,3,0,1,3,0,1,0,1
"LORELLE",0,2,0,1,2,0,1,0,1
"LORILYNN",0,2,0,1,2,0,1,0,1
"LORREN",1,1,.5,.5,2,0,0,0,0
"LOTOYA",0,2,0,1,2,0,1,0,1
"LOUBNA",0,2,0,1,2,0,1,0,1
"LOUKAS",2,0,1,0,2,1,0,1,0
"LOVABLE",1,2,.3333333,.6666667,3,0,0,0,0
"LOVETTA",0,3,0,1,3,0,1,0,1
"LUELLA",0,2,0,1,2,0,1,0,1
"LUIGJ",3,0,1,0,3,1,0,1,0
"LUNETTE",0,3,0,1,3,0,1,0,1
"LUTFI",2,0,1,0,2,1,0,1,0
"LUTZ",2,0,1,0,2,1,0,1,0
"LUU",1,1,.5,.5,2,0,0,0,0
"LUZMARINA",0,2,0,1,2,0,1,0,1
"LYANA",0,3,0,1,3,0,1,0,1
"LYES",2,0,1,0,2,1,0,1,0
"LYFE",2,0,1,0,2,1,0,1,0
"LYGIA",0,2,0,1,2,0,1,0,1
"LYMARIE",0,2,0,1,2,0,1,0,1
"LYNDEL",1,1,.5,.5,2,0,0,0,0
"LYNDEN",3,0,1,0,3,1,0,1,0
"LYNFORD",3,0,1,0,3,1,0,1,0
"LYNITA",0,3,0,1,3,0,1,0,1
"LYNNANN",0,3,0,1,3,0,1,0,1
"LYNNMARIE",0,2,0,1,2,0,1,0,1
"LYNX",2,0,1,0,2,1,0,1,0
"LYRON",2,0,1,0,2,1,0,1,0
"LYSBETH",0,3,0,1,3,0,1,0,1
"LYUBOMYR",2,0,1,0,2,1,0,1,0
"MACEY",0,2,0,1,2,0,1,0,1
"MACKENDY",2,0,1,0,2,1,0,1,0
"MADALENA",0,2,0,1,2,0,1,0,1
"MADDEN",0,2,0,1,2,0,1,0,1
"MADEEHA",0,2,0,1,2,0,1,0,1
"MADELYNN",0,2,0,1,2,0,1,0,1
"MADIE",1,2,.3333333,.6666667,3,0,0,0,0
"MADS",2,1,.6666667,.3333333,3,0,0,0,0
"MAFALDA",0,2,0,1,2,0,1,0,1
"MAGDALINE",0,3,0,1,3,0,1,0,1
"MAGDELINE",0,2,0,1,2,0,1,0,1
"MAGDIEL",1,1,.5,.5,2,0,0,0,0
"MAHALA",1,1,.5,.5,2,0,0,0,0
"MAHAMMED",3,0,1,0,3,1,0,1,0
"MAHANI",0,2,0,1,2,0,1,0,1
"MAHASE",2,0,1,0,2,1,0,1,0
"MAHBOD",2,0,1,0,2,1,0,1,0
"MAHBUBUL",2,0,1,0,2,1,0,1,0
"MAHIN",1,1,.5,.5,2,0,0,0,0
"MAHMUDUR",2,0,1,0,2,1,0,1,0
"MAHYAR",1,1,.5,.5,2,0,0,0,0
"MAIKEN",0,2,0,1,2,0,1,0,1
"MAILEEN",0,3,0,1,3,0,1,0,1
"MAIMA",0,2,0,1,2,0,1,0,1
"MAIR",2,1,.6666667,.3333333,3,0,0,0,0
"MAITA",0,2,0,1,2,0,1,0,1
"MAITAL",0,3,0,1,3,0,1,0,1
"MAITLAND",2,0,1,0,2,1,0,1,0
"MAJIDA",0,2,0,1,2,0,1,0,1
"MAJKEN",0,2,0,1,2,0,1,0,1
"MAKELA",0,2,0,1,2,0,1,0,1
"MAKS",3,0,1,0,3,1,0,1,0
"MAKSUDA",0,3,0,1,3,0,1,0,1
"MAKSYM",3,0,1,0,3,1,0,1,0
"MALAY",2,0,1,0,2,1,0,1,0
"MALGOSIA",0,3,0,1,3,0,1,0,1
"MALISHA",0,2,0,1,2,0,1,0,1
"MALTA",0,2,0,1,2,0,1,0,1
"MALTE",2,0,1,0,2,1,0,1,0
"MALVIKA",0,3,0,1,3,0,1,0,1
"MALYSSA",0,2,0,1,2,0,1,0,1
"MAMAN",2,1,.6666667,.3333333,3,0,0,0,0
"MANABU",2,0,1,0,2,1,0,1,0
"MANAS",2,0,1,0,2,1,0,1,0
"MANDE",0,2,0,1,2,0,1,0,1
"MANDIP",2,0,1,0,2,1,0,1,0
"MANGESH",2,0,1,0,2,1,0,1,0
"MANISHI",1,2,.3333333,.6666667,3,0,0,0,0
"MANITA",0,2,0,1,2,0,1,0,1
"MANJOT",0,2,0,1,2,0,1,0,1
"MANJUNATH",2,0,1,0,2,1,0,1,0
"MANLY",2,0,1,0,2,1,0,1,0
"MANOLITO",3,0,1,0,3,1,0,1,0
"MAQUEDA",0,2,0,1,2,0,1,0,1
"MARANGELI",0,2,0,1,2,0,1,0,1
"MARCELIS",3,0,1,0,3,1,0,1,0
"MARCIANA",0,3,0,1,3,0,1,0,1
"MARGOTH",0,2,0,1,2,0,1,0,1
"MARIAISABEL",0,2,0,1,2,0,1,0,1
"MARIANITA",0,2,0,1,2,0,1,0,1
"MARIARITA",0,2,0,1,2,0,1,0,1
"MARICHU",0,3,0,1,3,0,1,0,1
"MARIDALIA",0,3,0,1,3,0,1,0,1
"MARIEA",0,3,0,1,3,0,1,0,1
"MARIEANN",0,2,0,1,2,0,1,0,1
"MARIE-CHRISTINE",0,2,0,1,2,0,1,0,1
"MARIECLAIRE",0,2,0,1,2,0,1,0,1
"MARIIA",0,2,0,1,2,0,1,0,1
"MARILIN",0,2,0,1,2,0,1,0,1
"MARILYNE",0,3,0,1,3,0,1,0,1
"MARINDA",0,2,0,1,2,0,1,0,1
"MARISELLA",0,2,0,1,2,0,1,0,1
"MARITESS",0,2,0,1,2,0,1,0,1
"MARKENS",2,0,1,0,2,1,0,1,0
"MARKESE",2,0,1,0,2,1,0,1,0
"MARLAINA",0,2,0,1,2,0,1,0,1
"MARLAINE",0,2,0,1,2,0,1,0,1
"MARLAN",3,0,1,0,3,1,0,1,0
"MARLENNY",0,2,0,1,2,0,1,0,1
"MARLISSA",0,2,0,1,2,0,1,0,1
"MARLOU",1,2,.3333333,.6666667,3,0,0,0,0
"MARNINA",0,2,0,1,2,0,1,0,1
"MARRA",0,2,0,1,2,0,1,0,1
"MARSALIS",3,0,1,0,3,1,0,1,0
"MARSDEN",1,1,.5,.5,2,0,0,0,0
"MARSHELL",0,2,0,1,2,0,1,0,1
"MARSI",0,2,0,1,2,0,1,0,1
"MARTEL",3,0,1,0,3,1,0,1,0
"MARTIJN",2,0,1,0,2,1,0,1,0
"MARTINS",2,0,1,0,2,1,0,1,0
"MARVI",0,2,0,1,2,0,1,0,1
"MARYAH",0,2,0,1,2,0,1,0,1
"MARYCLAIRE",0,2,0,1,2,0,1,0,1
"MARYCLARE",0,2,0,1,2,0,1,0,1
"MARYPAT",0,2,0,1,2,0,1,0,1
"MARYSABEL",0,2,0,1,2,0,1,0,1
"MARYSSA",0,2,0,1,2,0,1,0,1
"MARYURI",0,3,0,1,3,0,1,0,1
"MASI",1,1,.5,.5,2,0,0,0,0
"MASSIE",0,3,0,1,3,0,1,0,1
"MATA",1,1,.5,.5,2,0,0,0,0
"MATHEO",3,0,1,0,3,1,0,1,0
"MATIA",0,2,0,1,2,0,1,0,1
"MATTHEWS",2,0,1,0,2,1,0,1,0
"MATUS",1,1,.5,.5,2,0,0,0,0
"MAUDI",0,3,0,1,3,0,1,0,1
"MAULI",1,1,.5,.5,2,0,0,0,0
"MAURISHA",0,2,0,1,2,0,1,0,1
"MAYANG",0,2,0,1,2,0,1,0,1
"MAYBEL",0,2,0,1,2,0,1,0,1
"MAYETTE",0,2,0,1,2,0,1,0,1
"MAYLEE",0,2,0,1,2,0,1,0,1
"MAYLIS",0,2,0,1,2,0,1,0,1
"MAYMAY",0,2,0,1,2,0,1,0,1
"MAYNARD",2,0,1,0,2,1,0,1,0
"MCNEIL",1,2,.3333333,.6666667,3,0,0,0,0
"MEAD",2,0,1,0,2,1,0,1,0
"MEAGHANN",0,2,0,1,2,0,1,0,1
"MECHO",2,0,1,0,2,1,0,1,0
"MEDJINE",0,2,0,1,2,0,1,0,1
"MEDWIN",2,0,1,0,2,1,0,1,0
"MEDY",0,2,0,1,2,0,1,0,1
"MEGS",0,2,0,1,2,0,1,0,1
"MEHAR",0,2,0,1,2,0,1,0,1
"MEHBOOB",2,0,1,0,2,1,0,1,0
"MEIKO",0,3,0,1,3,0,1,0,1
"MEILY",0,2,0,1,2,0,1,0,1
"MEIRE",0,2,0,1,2,0,1,0,1
"MEKKA",1,2,.3333333,.6666667,3,0,0,0,0
"MEKO",1,2,.3333333,.6666667,3,0,0,0,0
"MELANNIE",0,2,0,1,2,0,1,0,1
"MELCHOR",2,0,1,0,2,1,0,1,0
"MELENIE",0,2,0,1,2,0,1,0,1
"MELESA",0,2,0,1,2,0,1,0,1
"MELIHA",0,3,0,1,3,0,1,0,1
"MELIKE",0,2,0,1,2,0,1,0,1
"MELIQUE",1,1,.5,.5,2,0,0,0,0
"MELLI",1,1,.5,.5,2,0,0,0,0
"MELODEE",0,2,0,1,2,0,1,0,1
"MELONEY",0,3,0,1,3,0,1,0,1
"MELTON",2,0,1,0,2,1,0,1,0
"MENSAH",1,1,.5,.5,2,0,0,0,0
"MERE",1,1,.5,.5,2,0,0,0,0
"MERILEE",0,2,0,1,2,0,1,0,1
"MERLINA",0,2,0,1,2,0,1,0,1
"MERRISSA",0,2,0,1,2,0,1,0,1
"MERWYN",2,0,1,0,2,1,0,1,0
"MESHEL",0,2,0,1,2,0,1,0,1
"MESHELLE",0,2,0,1,2,0,1,0,1
"MEVLÃœT",2,0,1,0,2,1,0,1,0
"MEW",0,2,0,1,2,0,1,0,1
"MEY",0,2,0,1,2,0,1,0,1
"MEYLIN",0,3,0,1,3,0,1,0,1
"MEYLING",0,2,0,1,2,0,1,0,1
"MICHAEL-ANTHONY",3,0,1,0,3,1,0,1,0
"MICHAELINE",0,2,0,1,2,0,1,0,1
"MICHAEL-JOHN",2,0,1,0,2,1,0,1,0
"MICHAIL",2,0,1,0,2,1,0,1,0
"MICHELLI",0,2,0,1,2,0,1,0,1
"MICKEAL",2,0,1,0,2,1,0,1,0
"MIDDLE",2,0,1,0,2,1,0,1,0
"MIDNIGHT",1,1,.5,.5,2,0,0,0,0
"MIDWOOD",0,2,0,1,2,0,1,0,1
"MIEKA",0,2,0,1,2,0,1,0,1
"MIER",3,0,1,0,3,1,0,1,0
"MIGUELANGEL",2,0,1,0,2,1,0,1,0
"MIHALIS",2,0,1,0,2,1,0,1,0
"MIINA",0,2,0,1,2,0,1,0,1
"MIJI",0,3,0,1,3,0,1,0,1
"MIKEAL",2,0,1,0,2,1,0,1,0
"MIKELL",2,0,1,0,2,1,0,1,0
"MIKELLE",0,2,0,1,2,0,1,0,1
"MIKHAELA",0,2,0,1,2,0,1,0,1
"MILANI",0,3,0,1,3,0,1,0,1
"MILCIADES",2,0,1,0,2,1,0,1,0
"MILENKO",2,0,1,0,2,1,0,1,0
"MILFORD",2,0,1,0,2,1,0,1,0
"MILIA",0,2,0,1,2,0,1,0,1
"MILLARD",3,0,1,0,3,1,0,1,0
"MILOT",3,0,1,0,3,1,0,1,0
"MILUSKA",0,2,0,1,2,0,1,0,1
"MILVA",0,2,0,1,2,0,1,0,1
"MIMMO",3,0,1,0,3,1,0,1,0
"MINCHUL",2,0,1,0,2,1,0,1,0
"MIND",3,0,1,0,3,1,0,1,0
"MINHA",0,2,0,1,2,0,1,0,1
"MINHYE",0,2,0,1,2,0,1,0,1
"MINJAE",2,0,1,0,2,1,0,1,0
"MINKY",0,3,0,1,3,0,1,0,1
"MINNETTE",0,2,0,1,2,0,1,0,1
"MINNY",0,2,0,1,2,0,1,0,1
"MINSEOK",2,0,1,0,2,1,0,1,0
"MINSU",2,0,1,0,2,1,0,1,0
"MINSUN",0,3,0,1,3,0,1,0,1
"MINTU",1,1,.5,.5,2,0,0,0,0
"MINX",0,2,0,1,2,0,1,0,1
"MIRAL",0,2,0,1,2,0,1,0,1
"MIRAN",0,2,0,1,2,0,1,0,1
"MIREIA",0,2,0,1,2,0,1,0,1
"MIREL",0,2,0,1,2,0,1,0,1
"MITTAL",1,1,.5,.5,2,0,0,0,0
"MITUN",2,0,1,0,2,1,0,1,0
"MLADEN",2,0,1,0,2,1,0,1,0
"MODI",2,1,.6666667,.3333333,3,0,0,0,0
"MODY",3,0,1,0,3,1,0,1,0
"MOHAB",2,0,1,0,2,1,0,1,0
"MOINUL",3,0,1,0,3,1,0,1,0
"MOJDEH",0,2,0,1,2,0,1,0,1
"MONCEF",2,0,1,0,2,1,0,1,0
"MONDA",0,3,0,1,3,0,1,0,1
"MONISOLA",0,3,0,1,3,0,1,0,1
"MONSERRATE",3,0,1,0,3,1,0,1,0
"MONSY",1,1,.5,.5,2,0,0,0,0
"MOONA",0,3,0,1,3,0,1,0,1
"MORELLI",1,1,.5,.5,2,0,0,0,0
"MORI",2,0,1,0,2,1,0,1,0
"MOSHIKO",2,0,1,0,2,1,0,1,0
"MOSHIUR",2,0,1,0,2,1,0,1,0
"MOSI",1,1,.5,.5,2,0,0,0,0
"MOUHAMADOU",2,0,1,0,2,1,0,1,0
"MOVIE",3,0,1,0,3,1,0,1,0
"MOXIE",1,1,.5,.5,2,0,0,0,0
"MRUNAL",3,0,1,0,3,1,0,1,0
"MSDIVA",0,2,0,1,2,0,1,0,1
"MUAMMER",2,0,1,0,2,1,0,1,0
"MUJTABA",2,0,1,0,2,1,0,1,0
"MUKTA",0,3,0,1,3,0,1,0,1
"MUKUL",2,0,1,0,2,1,0,1,0
"MULLER",2,1,.6666667,.3333333,3,0,0,0,0
"MUNDA",3,0,1,0,3,1,0,1,0
"MUNJAL",2,0,1,0,2,1,0,1,0
"MUNNA",3,0,1,0,3,1,0,1,0
"MURA",1,1,.5,.5,2,0,0,0,0
"MURILO",2,0,1,0,2,1,0,1,0
"MUSETTE",0,2,0,1,2,0,1,0,1
"MUSH",2,0,1,0,2,1,0,1,0
"MUSIQ",1,2,.3333333,.6666667,3,0,0,0,0
"MUZAFFAR",2,0,1,0,2,1,0,1,0
"MUZAMIL",3,0,1,0,3,1,0,1,0
"MYE",1,1,.5,.5,2,0,0,0,0
"MYER",2,0,1,0,2,1,0,1,0
"MYIESHA",0,3,0,1,3,0,1,0,1
"MYKOL",3,0,1,0,3,1,0,1,0
"MYOSHI",0,2,0,1,2,0,1,0,1
"MÃœÅ_TAK",3,0,1,0,3,1,0,1,0
"NABY",1,1,.5,.5,2,0,0,0,0
"NADEAN",0,3,0,1,3,0,1,0,1
"NADESHA",0,3,0,1,3,0,1,0,1
"NADJAH",0,2,0,1,2,0,1,0,1
"NAF",2,0,1,0,2,1,0,1,0
"NAFEEZ",2,0,1,0,2,1,0,1,0
"NAFIZ",2,0,1,0,2,1,0,1,0
"NAGAT",0,3,0,1,3,0,1,0,1
"NAGESH",3,0,1,0,3,1,0,1,0
"NAHUEL",2,0,1,0,2,1,0,1,0
"NAIARA",0,3,0,1,3,0,1,0,1
"NAIF",2,0,1,0,2,1,0,1,0
"NAIL",2,1,.6666667,.3333333,3,0,0,0,0
"NAIOMY",0,2,0,1,2,0,1,0,1
"NAIYMA",0,3,0,1,3,0,1,0,1
"NAKAMURA",1,2,.3333333,.6666667,3,0,0,0,0
"NAKEEMA",0,2,0,1,2,0,1,0,1
"NAKEMA",0,2,0,1,2,0,1,0,1
"NALDO",3,0,1,0,3,1,0,1,0
"NANDRANI",0,2,0,1,2,0,1,0,1
"NARCY",0,2,0,1,2,0,1,0,1
"NARDO",3,0,1,0,3,1,0,1,0
"NAREE",0,2,0,1,2,0,1,0,1
"NAREN",3,0,1,0,3,1,0,1,0
"NARENDER",2,0,1,0,2,1,0,1,0
"NASEEB",2,1,.6666667,.3333333,3,0,0,0,0
"NASEEMA",0,3,0,1,3,0,1,0,1
"NASHAY",0,3,0,1,3,0,1,0,1
"NASHLA",0,3,0,1,3,0,1,0,1
"NASIYA",0,2,0,1,2,0,1,0,1
"NASSIMA",0,2,0,1,2,0,1,0,1
"NATACHIA",0,2,0,1,2,0,1,0,1
"NATALIIA",0,2,0,1,2,0,1,0,1
"NATARSHA",0,2,0,1,2,0,1,0,1
"NATHANIAL",2,0,1,0,2,1,0,1,0
"NATSU",0,2,0,1,2,0,1,0,1
"NATSUMI",0,2,0,1,2,0,1,0,1
"NAVIA",0,2,0,1,2,0,1,0,1
"NAYANA",0,2,0,1,2,0,1,0,1
"NAYARA",0,3,0,1,3,0,1,0,1
"NAYIM",3,0,1,0,3,1,0,1,0
"NAYOMI",0,2,0,1,2,0,1,0,1
"NAYYARA",0,3,0,1,3,0,1,0,1
"NAZARET",0,3,0,1,3,0,1,0,1
"NAZIF",3,0,1,0,3,1,0,1,0
"NAZIRA",0,2,0,1,2,0,1,0,1
"NAZMUN",1,1,.5,.5,2,0,0,0,0
"NBA",1,1,.5,.5,2,0,0,0,0
"NEBIL",3,0,1,0,3,1,0,1,0
"NECHELLE",0,3,0,1,3,0,1,0,1
"NEDELKA",0,3,0,1,3,0,1,0,1
"NEDZAD",2,0,1,0,2,1,0,1,0
"NEELESH",2,0,1,0,2,1,0,1,0
"NEELUM",0,2,0,1,2,0,1,0,1
"NEER",2,0,1,0,2,1,0,1,0
"NEFAIL",2,0,1,0,2,1,0,1,0
"NEFELI",0,2,0,1,2,0,1,0,1
"NEGASH",3,0,1,0,3,1,0,1,0
"NEIDY",0,2,0,1,2,0,1,0,1
"NEKO",0,2,0,1,2,0,1,0,1
"NELFI",2,0,1,0,2,1,0,1,0
"NELITA",0,2,0,1,2,0,1,0,1
"NELS",2,0,1,0,2,1,0,1,0
"NEMA",2,1,.6666667,.3333333,3,0,0,0,0
"NENETTE",0,3,0,1,3,0,1,0,1
"NEOMI",1,1,.5,.5,2,0,0,0,0
"NERTILA",0,2,0,1,2,0,1,0,1
"NESHAT",2,0,1,0,2,1,0,1,0
"NESSIE",0,3,0,1,3,0,1,0,1
"NET",1,1,.5,.5,2,0,0,0,0
"NEUMAN",2,0,1,0,2,1,0,1,0
"NEURY",2,0,1,0,2,1,0,1,0
"NEWT",0,2,0,1,2,0,1,0,1
"NGODUP",2,0,1,0,2,1,0,1,0
"NHI",0,2,0,1,2,0,1,0,1
"NIARA",0,2,0,1,2,0,1,0,1
"NICASIO",3,0,1,0,3,1,0,1,0
"NICCOLO",2,0,1,0,2,1,0,1,0
"NICKESHIA",0,2,0,1,2,0,1,0,1
"NICKSON",2,0,1,0,2,1,0,1,0
"NICLAS",2,0,1,0,2,1,0,1,0
"NICOS",2,0,1,0,2,1,0,1,0
"NICOY",3,0,1,0,3,1,0,1,0
"NIDYA",0,2,0,1,2,0,1,0,1
"NIEMAH",0,3,0,1,3,0,1,0,1
"NIHAR",3,0,1,0,3,1,0,1,0
"NIHAT",3,0,1,0,3,1,0,1,0
"NIJEL",2,0,1,0,2,1,0,1,0
"NIKK",0,2,0,1,2,0,1,0,1
"NIKKETA",0,2,0,1,2,0,1,0,1
"NIKKISHA",0,2,0,1,2,0,1,0,1
"NIKOLIN",3,0,1,0,3,1,0,1,0
"NILL",2,0,1,0,2,1,0,1,0
"NINAMARIE",0,2,0,1,2,0,1,0,1
"NINEL",0,2,0,1,2,0,1,0,1
"NIPUN",2,0,1,0,2,1,0,1,0
"NIRVA",0,2,0,1,2,0,1,0,1
"NISAA",0,3,0,1,3,0,1,0,1
"NISIM",2,0,1,0,2,1,0,1,0
"NISRINE",0,2,0,1,2,0,1,0,1
"NITI",0,3,0,1,3,0,1,0,1
"NIXA",0,3,0,1,3,0,1,0,1
"NIYAZI",3,0,1,0,3,1,0,1,0
"NKEM",0,2,0,1,2,0,1,0,1
"NOCHEM",3,0,1,0,3,1,0,1,0
"NOELL",1,2,.3333333,.6666667,3,0,0,0,0
"NOHEMY",0,2,0,1,2,0,1,0,1
"NOMAR",2,0,1,0,2,1,0,1,0
"NOODLE",1,1,.5,.5,2,0,0,0,0
"NOOK",2,0,1,0,2,1,0,1,0
"NOORI",1,1,.5,.5,2,0,0,0,0
"NOORUL",1,1,.5,.5,2,0,0,0,0
"NOOSHIN",0,2,0,1,2,0,1,0,1
"NOR",1,1,.5,.5,2,0,0,0,0
"NORLAN",0,2,0,1,2,0,1,0,1
"NOUNOU",1,1,.5,.5,2,0,0,0,0
"NOVEL",0,2,0,1,2,0,1,0,1
"NOVELETTE",0,2,0,1,2,0,1,0,1
"NOVI",1,1,.5,.5,2,0,0,0,0
"NUNA",0,2,0,1,2,0,1,0,1
"NURIS",0,3,0,1,3,0,1,0,1
"NURUDEEN",2,0,1,0,2,1,0,1,0
"NUWAN",3,0,1,0,3,1,0,1,0
"NYAISA",0,3,0,1,3,0,1,0,1
"OAKLEY",0,2,0,1,2,0,1,0,1
"OBAA",0,2,0,1,2,0,1,0,1
"OBADIAH",2,0,1,0,2,1,0,1,0
"OBAFEMI",2,0,1,0,2,1,0,1,0
"OCHO",0,2,0,1,2,0,1,0,1
"OCTAVIAN",2,0,1,0,2,1,0,1,0
"ODD",1,1,.5,.5,2,0,0,0,0
"ODY",0,2,0,1,2,0,1,0,1
"ODYSSEUS",3,0,1,0,3,1,0,1,0
"OJI",3,0,1,0,3,1,0,1,0
"OKEMA",0,3,0,1,3,0,1,0,1
"OKERA",3,0,1,0,3,1,0,1,0
"OKPARA",1,1,.5,.5,2,0,0,0,0
"OLANREWAJU",2,0,1,0,2,1,0,1,0
"OLATUNDE",3,0,1,0,3,1,0,1,0
"OLAYEMI",1,1,.5,.5,2,0,0,0,0
"OLEKSIY",2,0,1,0,2,1,0,1,0
"OLIVIE",1,1,.5,.5,2,0,0,0,0
"OLUBUKOLA",0,3,0,1,3,0,1,0,1
"OLUKAYODE",2,0,1,0,2,1,0,1,0
"OLUKEMI",0,3,0,1,3,0,1,0,1
"OLUREMI",1,1,.5,.5,2,0,0,0,0
"OLUSEYI",1,1,.5,.5,2,0,0,0,0
"OLUSHOLA",3,0,1,0,3,1,0,1,0
"OMARIS",0,2,0,1,2,0,1,0,1
"OMROY",3,0,1,0,3,1,0,1,0
"ONASSIS",3,0,1,0,3,1,0,1,0
"ONDRA",1,1,.5,.5,2,0,0,0,0
"ONEEKA",0,2,0,1,2,0,1,0,1
"ONICK",3,0,1,0,3,1,0,1,0
"ONIQUE",1,2,.3333333,.6666667,3,0,0,0,0
"ONOME",1,1,.5,.5,2,0,0,0,0
"OPHÃ‰LIE",0,3,0,1,3,0,1,0,1
"OPOKU",2,0,1,0,2,1,0,1,0
"OPRAH",0,3,0,1,3,0,1,0,1
"ORFA",0,3,0,1,3,0,1,0,1
"ORGES",2,0,1,0,2,1,0,1,0
"ORIOL",2,0,1,0,2,1,0,1,0
"ORLENE",0,2,0,1,2,0,1,0,1
"OROKU",3,0,1,0,3,1,0,1,0
"ORRY",2,0,1,0,2,1,0,1,0
"ORSOLA",0,3,0,1,3,0,1,0,1
"ORSY",2,0,1,0,2,1,0,1,0
"ORVIL",2,0,1,0,2,1,0,1,0
"OSA",2,1,.6666667,.3333333,3,0,0,0,0
"OSHRI",2,0,1,0,2,1,0,1,0
"OSIE",2,0,1,0,2,1,0,1,0
"OSMAR",2,0,1,0,2,1,0,1,0
"OSORIO",0,2,0,1,2,0,1,0,1
"OTO",2,0,1,0,2,1,0,1,0
"OTTAVIO",3,0,1,0,3,1,0,1,0
"OTTIS",3,0,1,0,3,1,0,1,0
"OU",2,0,1,0,2,1,0,1,0
"OUT",1,1,.5,.5,2,0,0,0,0
"OWENS",2,1,.6666667,.3333333,3,0,0,0,0
"OY",1,1,.5,.5,2,0,0,0,0
"OZKAR",3,0,1,0,3,1,0,1,0
"OZY",2,0,1,0,2,1,0,1,0
"PACHA",2,0,1,0,2,1,0,1,0
"PAGAN",2,0,1,0,2,1,0,1,0
"PAKAWADEE",0,2,0,1,2,0,1,0,1
"PALA",2,0,1,0,2,1,0,1,0
"PALASH",2,0,1,0,2,1,0,1,0
"PALDEN",2,0,1,0,2,1,0,1,0
"PAPIA",0,2,0,1,2,0,1,0,1
"PAPIS",2,0,1,0,2,1,0,1,0
"PAQUITA",0,3,0,1,3,0,1,0,1
"PARAIC",2,0,1,0,2,1,0,1,0
"PARAMJEET",2,1,.6666667,.3333333,3,0,0,0,0
"PARDEEP",3,0,1,0,3,1,0,1,0
"PAREDES",2,0,1,0,2,1,0,1,0
"PARIMAL",2,0,1,0,2,1,0,1,0
"PARINDA",0,2,0,1,2,0,1,0,1
"PARISSA",0,2,0,1,2,0,1,0,1
"PARMANAND",3,0,1,0,3,1,0,1,0
"PARMEET",2,0,1,0,2,1,0,1,0
"PARRA",1,1,.5,.5,2,0,0,0,0
"PARVANEH",0,2,0,1,2,0,1,0,1
"PASQUALINA",0,3,0,1,3,0,1,0,1
"PATCH",3,0,1,0,3,1,0,1,0
"PATRENA",0,2,0,1,2,0,1,0,1
"PATRICA",0,3,0,1,3,0,1,0,1
"PATRIOT",3,0,1,0,3,1,0,1,0
"PATTERSON",2,1,.6666667,.3333333,3,0,0,0,0
"PAULIN",1,1,.5,.5,2,0,0,0,0
"PAVLA",0,3,0,1,3,0,1,0,1
"PAWANDEEP",2,0,1,0,2,1,0,1,0
"PEA",1,1,.5,.5,2,0,0,0,0
"PEADAR",2,0,1,0,2,1,0,1,0
"PEDDY",2,0,1,0,2,1,0,1,0
"PEDER",2,0,1,0,2,1,0,1,0
"PEGGIE",0,2,0,1,2,0,1,0,1
"PEGGYANN",0,3,0,1,3,0,1,0,1
"PEGUY",2,0,1,0,2,1,0,1,0
"PEI-WEN",0,2,0,1,2,0,1,0,1
"PEONY",0,2,0,1,2,0,1,0,1
"PEPA",0,2,0,1,2,0,1,0,1
"PEPITA",0,3,0,1,3,0,1,0,1
"PERCIO",2,0,1,0,2,1,0,1,0
"PERE",2,0,1,0,2,1,0,1,0
"PERFECTO",3,0,1,0,3,1,0,1,0
"PERNILLE",0,2,0,1,2,0,1,0,1
"PERSEPHONE",0,3,0,1,3,0,1,0,1
"PERSIDA",0,2,0,1,2,0,1,0,1
"PERVAIZ",3,0,1,0,3,1,0,1,0
"PERVEZ",3,0,1,0,3,1,0,1,0
"PERVIN",0,2,0,1,2,0,1,0,1
"PETA-GAY",0,2,0,1,2,0,1,0,1
"PETRO",2,0,1,0,2,1,0,1,0
"PETTY",0,2,0,1,2,0,1,0,1
"PHANI",3,0,1,0,3,1,0,1,0
"PHARAOH",2,0,1,0,2,1,0,1,0
"PHAROAH",2,0,1,0,2,1,0,1,0
"PHEONA",0,2,0,1,2,0,1,0,1
"PHEONIX",1,1,.5,.5,2,0,0,0,0
"PHILLIPPA",0,2,0,1,2,0,1,0,1
"PHILLIS",1,2,.3333333,.6666667,3,0,0,0,0
"PHIN",2,0,1,0,2,1,0,1,0
"PHO",3,0,1,0,3,1,0,1,0
"PHYLISS",0,2,0,1,2,0,1,0,1
"PIERRE-EMMANUEL",2,0,1,0,2,1,0,1,0
"PIERRE-LOUIS",2,0,1,0,2,1,0,1,0
"PIERRETTE",0,3,0,1,3,0,1,0,1
"PIL",2,0,1,0,2,1,0,1,0
"PINGPING",1,1,.5,.5,2,0,0,0,0
"PINHAS",2,0,1,0,2,1,0,1,0
"PINKS",2,1,.6666667,.3333333,3,0,0,0,0
"PIPE",3,0,1,0,3,1,0,1,0
"PITT",2,1,.6666667,.3333333,3,0,0,0,0
"PLLUMB",2,1,.6666667,.3333333,3,0,0,0,0
"PLOY",0,2,0,1,2,0,1,0,1
"POH",1,1,.5,.5,2,0,0,0,0
"POLLYANNA",0,2,0,1,2,0,1,0,1
"PONCHO",2,0,1,0,2,1,0,1,0
"PONG",2,1,.6666667,.3333333,3,0,0,0,0
"POPE",3,0,1,0,3,1,0,1,0
"POPPI",0,2,0,1,2,0,1,0,1
"POPS",3,0,1,0,3,1,0,1,0
"POSEY",1,1,.5,.5,2,0,0,0,0
"PRABHAKAR",3,0,1,0,3,1,0,1,0
"PRACILLA",0,2,0,1,2,0,1,0,1
"PRADYUMNA",2,0,1,0,2,1,0,1,0
"PRAGATI",0,2,0,1,2,0,1,0,1
"PRAGNESH",3,0,1,0,3,1,0,1,0
"PRAMILA",0,2,0,1,2,0,1,0,1
"PRANEET",2,0,1,0,2,1,0,1,0
"PRANEETH",2,0,1,0,2,1,0,1,0
"PRANOTI",0,2,0,1,2,0,1,0,1
"PRASHAN",2,0,1,0,2,1,0,1,0
"PRASHANTA",2,0,1,0,2,1,0,1,0
"PREE",1,1,.5,.5,2,0,0,0,0
"PRESCILLA",0,3,0,1,3,0,1,0,1
"PRICELESS",1,1,.5,.5,2,0,0,0,0
"PRIEST",2,0,1,0,2,1,0,1,0
"PRISCILIA",0,2,0,1,2,0,1,0,1
"PRIYAL",1,1,.5,.5,2,0,0,0,0
"PRIYESH",2,0,1,0,2,1,0,1,0
"PROM",3,0,1,0,3,1,0,1,0
"PROMILA",0,2,0,1,2,0,1,0,1
"PROSPECT",2,0,1,0,2,1,0,1,0
"PROSPER",2,0,1,0,2,1,0,1,0
"PROSPERO",2,0,1,0,2,1,0,1,0
"PROVIDENCE",0,2,0,1,2,0,1,0,1
"PRYA",0,3,0,1,3,0,1,0,1
"PSYCHE",0,3,0,1,3,0,1,0,1
"PUNCHLINE",3,0,1,0,3,1,0,1,0
"PUTRI",0,2,0,1,2,0,1,0,1
"PYRO",1,1,.5,.5,2,0,0,0,0
"QAMIL",1,1,.5,.5,2,0,0,0,0
"QENDRIM",2,0,1,0,2,1,0,1,0
"QIQI",0,2,0,1,2,0,1,0,1
"QUANNA",0,3,0,1,3,0,1,0,1
"QUANTA",0,2,0,1,2,0,1,0,1
"QUATISHA",0,3,0,1,3,0,1,0,1
"QUEL",2,0,1,0,2,1,0,1,0
"QUEST",2,0,1,0,2,1,0,1,0
"QUI",1,2,.3333333,.6666667,3,0,0,0,0
"QUINCEY",2,0,1,0,2,1,0,1,0
"QUINETTA",0,3,0,1,3,0,1,0,1
"QUINTANA",1,1,.5,.5,2,0,0,0,0
"QUINTEN",3,0,1,0,3,1,0,1,0
"RAASHIDA",0,2,0,1,2,0,1,0,1
"RABEYA",0,2,0,1,2,0,1,0,1
"RACHIDA",0,2,0,1,2,0,1,0,1
"RADFORD",2,0,1,0,2,1,0,1,0
"RADI",2,0,1,0,2,1,0,1,0
"RADOUANE",2,0,1,0,2,1,0,1,0
"RAELYNN",0,2,0,1,2,0,1,0,1
"RAEVEN",0,2,0,1,2,0,1,0,1
"RAFAIL",3,0,1,0,3,1,0,1,0
"RAFELINA",0,2,0,1,2,0,1,0,1
"RAHSHAWN",2,0,1,0,2,1,0,1,0
"RAIYAN",2,0,1,0,2,1,0,1,0
"RAJINDER",2,0,1,0,2,1,0,1,0
"RALITSA",0,2,0,1,2,0,1,0,1
"RAMACHANDRAN",3,0,1,0,3,1,0,1,0
"RAMANDEEP",2,0,1,0,2,1,0,1,0
"RAMATOU",0,3,0,1,3,0,1,0,1
"RAMATU",0,2,0,1,2,0,1,0,1
"RAMES",3,0,1,0,3,1,0,1,0
"RAMKUMAR",2,0,1,0,2,1,0,1,0
"RAMO",3,0,1,0,3,1,0,1,0
"RANAE",0,2,0,1,2,0,1,0,1
"RANCE",2,0,1,0,2,1,0,1,0
"RANDIP",2,0,1,0,2,1,0,1,0
"RANEL",0,2,0,1,2,0,1,0,1
"RANFIS",3,0,1,0,3,1,0,1,0
"RANIE",0,2,0,1,2,0,1,0,1
"RANJITH",3,0,1,0,3,1,0,1,0
"RANNY",1,1,.5,.5,2,0,0,0,0
"RAP",2,1,.6666667,.3333333,3,0,0,0,0
"RAPHEAL",3,0,1,0,3,1,0,1,0
"RASHADA",0,2,0,1,2,0,1,0,1
"RASHANE",2,0,1,0,2,1,0,1,0
"RASHANNA",0,2,0,1,2,0,1,0,1
"RASHELL",0,2,0,1,2,0,1,0,1
"RASHEMA",0,2,0,1,2,0,1,0,1
"RASHMA",0,2,0,1,2,0,1,0,1
"RAVAN",0,2,0,1,2,0,1,0,1
"RAVIRAJ",3,0,1,0,3,1,0,1,0
"RAVNEET",0,2,0,1,2,0,1,0,1
"RAVON",3,0,1,0,3,1,0,1,0
"RAYMEL",3,0,1,0,3,1,0,1,0
"RAYMIE",2,0,1,0,2,1,0,1,0
"RAYNALDO",3,0,1,0,3,1,0,1,0
"RAYNIEL",3,0,1,0,3,1,0,1,0
"RAYSHUN",3,0,1,0,3,1,0,1,0
"REAVIS",1,1,.5,.5,2,0,0,0,0
"REDDY",3,0,1,0,3,1,0,1,0
"REDON",2,0,1,0,2,1,0,1,0
"REDOUANE",2,0,1,0,2,1,0,1,0
"REESES",0,2,0,1,2,0,1,0,1
"REGG",2,0,1,0,2,1,0,1,0
"REHANNA",0,3,0,1,3,0,1,0,1
"REIGN",0,2,0,1,2,0,1,0,1
"REJI",3,0,1,0,3,1,0,1,0
"RELLA",0,3,0,1,3,0,1,0,1
"RELLY",1,2,.3333333,.6666667,3,0,0,0,0
"REMEDY",1,1,.5,.5,2,0,0,0,0
"REMONA",0,2,0,1,2,0,1,0,1
"RENATTA",0,2,0,1,2,0,1,0,1
"RENDY",0,2,0,1,2,0,1,0,1
"RENETTE",0,2,0,1,2,0,1,0,1
"RENIS",2,0,1,0,2,1,0,1,0
"RENNE",0,3,0,1,3,0,1,0,1
"RENOLD",2,0,1,0,2,1,0,1,0
"RENWICK",2,0,1,0,2,1,0,1,0
"RESUL",2,0,1,0,2,1,0,1,0
"REVATHI",0,2,0,1,2,0,1,0,1
"REYAD",2,0,1,0,2,1,0,1,0
"RHAN",2,0,1,0,2,1,0,1,0
"RHANDY",3,0,1,0,3,1,0,1,0
"RHINO",3,0,1,0,3,1,0,1,0
"RHONIE",1,1,.5,.5,2,0,0,0,0
"RIAH",0,2,0,1,2,0,1,0,1
"RIBEIRO",2,0,1,0,2,1,0,1,0
"RICHTER",2,0,1,0,2,1,0,1,0
"RICKARDO",2,0,1,0,2,1,0,1,0
"RIFKI",2,0,1,0,2,1,0,1,0
"RIFKY",0,2,0,1,2,0,1,0,1
"RIGGS",2,0,1,0,2,1,0,1,0
"RIGHT",1,1,.5,.5,2,0,0,0,0
"RIKO",3,0,1,0,3,1,0,1,0
"RIKU",3,0,1,0,3,1,0,1,0
"RION",2,0,1,0,2,1,0,1,0
"RIPPY",1,1,.5,.5,2,0,0,0,0
"RISHAB",2,0,1,0,2,1,0,1,0
"RITWIK",2,0,1,0,2,1,0,1,0
"RIYADH",2,0,1,0,2,1,0,1,0
"RIYO",0,2,0,1,2,0,1,0,1
"RIZZY",2,0,1,0,2,1,0,1,0
"ROANNA",0,2,0,1,2,0,1,0,1
"ROBA",2,1,.6666667,.3333333,3,0,0,0,0
"ROBBI",1,1,.5,.5,2,0,0,0,0
"ROBER",3,0,1,0,3,1,0,1,0
"ROCHELE",0,2,0,1,2,0,1,0,1
"ROCKFORD",2,0,1,0,2,1,0,1,0
"ROCO",3,0,1,0,3,1,0,1,0
"RODERIC",2,0,1,0,2,1,0,1,0
"ROGIER",2,0,1,0,2,1,0,1,0
"ROGUE",1,1,.5,.5,2,0,0,0,0
"ROHAIL",2,0,1,0,2,1,0,1,0
"ROLL",1,1,.5,.5,2,0,0,0,0
"ROMAL",2,0,1,0,2,1,0,1,0
"ROMELIA",0,2,0,1,2,0,1,0,1
"ROMEY",3,0,1,0,3,1,0,1,0
"ROMUALD",2,0,1,0,2,1,0,1,0
"ROMULUS",2,0,1,0,2,1,0,1,0
"RONALDA",0,2,0,1,2,0,1,0,1
"RONDI",0,2,0,1,2,0,1,0,1
"RONDU",3,0,1,0,3,1,0,1,0
"RONITA",0,3,0,1,3,0,1,0,1
"RONNIQUE",1,1,.5,.5,2,0,0,0,0
"ROO",1,1,.5,.5,2,0,0,0,0
"ROOSTER",3,0,1,0,3,1,0,1,0
"RORIE",0,2,0,1,2,0,1,0,1
"RORSCHACH",3,0,1,0,3,1,0,1,0
"ROSADO",1,1,.5,.5,2,0,0,0,0
"ROSANE",0,2,0,1,2,0,1,0,1
"ROSELIA",0,2,0,1,2,0,1,0,1
"ROSEMOND",2,0,1,0,2,1,0,1,0
"ROSENI",0,2,0,1,2,0,1,0,1
"ROSENTHAL",1,1,.5,.5,2,0,0,0,0
"ROSHANE",2,0,1,0,2,1,0,1,0
"ROSHELL",0,3,0,1,3,0,1,0,1
"ROSHNEE",0,2,0,1,2,0,1,0,1
"ROSHONDA",0,3,0,1,3,0,1,0,1
"ROSINE",0,2,0,1,2,0,1,0,1
"ROTH",2,0,1,0,2,1,0,1,0
"ROYALTY",2,0,1,0,2,1,0,1,0
"ROYO",2,0,1,0,2,1,0,1,0
"ROZALIN",0,2,0,1,2,0,1,0,1
"ROZIE",0,2,0,1,2,0,1,0,1
"RUDIK",3,0,1,0,3,1,0,1,0
"RUFINO",2,0,1,0,2,1,0,1,0
"RUGER",2,0,1,0,2,1,0,1,0
"RUJU",0,2,0,1,2,0,1,0,1
"RUKHSANA",0,2,0,1,2,0,1,0,1
"RUKSANA",0,2,0,1,2,0,1,0,1
"RUMEAL",2,0,1,0,2,1,0,1,0
"RUMIKO",0,3,0,1,3,0,1,0,1
"RUPAK",3,0,1,0,3,1,0,1,0
"RUPAM",1,2,.3333333,.6666667,3,0,0,0,0
"RUSHELLE",0,2,0,1,2,0,1,0,1
"RUSHIN",1,1,.5,.5,2,0,0,0,0
"RUSSIA",0,2,0,1,2,0,1,0,1
"RUTGER",3,0,1,0,3,1,0,1,0
"RUTHI",0,2,0,1,2,0,1,0,1
"RUWAN",2,0,1,0,2,1,0,1,0
"RYANNA",0,2,0,1,2,0,1,0,1
"RYNA",0,2,0,1,2,0,1,0,1
"RYOJI",3,0,1,0,3,1,0,1,0
"RYOSUKE",2,0,1,0,2,1,0,1,0
"RYSZARD",2,0,1,0,2,1,0,1,0
"SAADA",1,1,.5,.5,2,0,0,0,0
"SAARAH",0,2,0,1,2,0,1,0,1
"SABAHATTIN",2,0,1,0,2,1,0,1,0
"SABERA",0,2,0,1,2,0,1,0,1
"SABREEN",0,3,0,1,3,0,1,0,1
"SAC",2,0,1,0,2,1,0,1,0
"SACHELLE",1,1,.5,.5,2,0,0,0,0
"SADIJE",0,2,0,1,2,0,1,0,1
"SADOK",2,0,1,0,2,1,0,1,0
"SADRI",1,1,.5,.5,2,0,0,0,0
"SAEEDA",0,2,0,1,2,0,1,0,1
"SAEID",2,0,1,0,2,1,0,1,0
"SAEROM",0,2,0,1,2,0,1,0,1
"SAFIYYAH",0,3,0,1,3,0,1,0,1
"SAFY",0,2,0,1,2,0,1,0,1
"SAHER",0,2,0,1,2,0,1,0,1
"SAHID",2,0,1,0,2,1,0,1,0
"SAIDUL",3,0,1,0,3,1,0,1,0
"SAIDY",0,2,0,1,2,0,1,0,1
"SAIED",2,0,1,0,2,1,0,1,0
"SAIKAT",3,0,1,0,3,1,0,1,0
"SAJI",3,0,1,0,3,1,0,1,0
"SAJMIR",2,0,1,0,2,1,0,1,0
"SAKIKO",0,2,0,1,2,0,1,0,1
"SALAAM",1,1,.5,.5,2,0,0,0,0
"SALAHEDDINE",2,0,1,0,2,1,0,1,0
"SALAHUDDIN",2,0,1,0,2,1,0,1,0
"SALAZAR",2,0,1,0,2,1,0,1,0
"SALIEU",2,0,1,0,2,1,0,1,0
"SALIOU",2,0,1,0,2,1,0,1,0
"SALVIN",2,0,1,0,2,1,0,1,0
"SAMAA",0,2,0,1,2,0,1,0,1
"SAMANDA",0,2,0,1,2,0,1,0,1
"SAMANTH",1,2,.3333333,.6666667,3,0,0,0,0
"SAMBA",2,0,1,0,2,1,0,1,0
"SAMERA",0,3,0,1,3,0,1,0,1
"SAMIYA",0,2,0,1,2,0,1,0,1
"SAMJHANA",0,2,0,1,2,0,1,0,1
"SAMOA",0,2,0,1,2,0,1,0,1
"SAMORA",1,1,.5,.5,2,0,0,0,0
"SAMORI",2,0,1,0,2,1,0,1,0
"SAMUAL",2,1,.6666667,.3333333,3,0,0,0,0
"SAMYA",0,2,0,1,2,0,1,0,1
"SANAH",0,2,0,1,2,0,1,0,1
"SANAN",3,0,1,0,3,1,0,1,0
"SANDIA",0,2,0,1,2,0,1,0,1
"SANDINO",2,0,1,0,2,1,0,1,0
"SANDLER",3,0,1,0,3,1,0,1,0
"SANDREA",0,3,0,1,3,0,1,0,1
"SANDRIA",0,2,0,1,2,0,1,0,1
"SANDYA",0,2,0,1,2,0,1,0,1
"SANGEET",1,1,.5,.5,2,0,0,0,0
"SANGSOO",2,0,1,0,2,1,0,1,0
"SANGWOOK",2,0,1,0,2,1,0,1,0
"SANJEET",2,0,1,0,2,1,0,1,0
"SANJEEWA",2,0,1,0,2,1,0,1,0
"SANJI",1,1,.5,.5,2,0,0,0,0
"SANJITA",0,3,0,1,3,0,1,0,1
"SANYO",0,2,0,1,2,0,1,0,1
"SAPRINA",0,2,0,1,2,0,1,0,1
"SARBJIT",2,0,1,0,2,1,0,1,0
"SARELLE",0,3,0,1,3,0,1,0,1
"SARIAH",0,2,0,1,2,0,1,0,1
"SAROSH",3,0,1,0,3,1,0,1,0
"SARTORI",3,0,1,0,3,1,0,1,0
"SARWAT",0,3,0,1,3,0,1,0,1
"SAS",0,2,0,1,2,0,1,0,1
"SASHANNA",0,3,0,1,3,0,1,0,1
"SASSAN",3,0,1,0,3,1,0,1,0
"SAUNDERS",3,0,1,0,3,1,0,1,0
"SAVETA",0,2,0,1,2,0,1,0,1
"SAVION",2,0,1,0,2,1,0,1,0
"SAYEEM",3,0,1,0,3,1,0,1,0
"SAYID",2,0,1,0,2,1,0,1,0
"SCARFACE",3,0,1,0,3,1,0,1,0
"SCHADRAC",3,0,1,0,3,1,0,1,0
"SCHOLAR",3,0,1,0,3,1,0,1,0
"SEANN",3,0,1,0,3,1,0,1,0
"SEHO",2,0,1,0,2,1,0,1,0
"SEI",1,1,.5,.5,2,0,0,0,0
"SEKAYI",3,0,1,0,3,1,0,1,0
"SEKENA",0,3,0,1,3,0,1,0,1
"SEKU",2,0,1,0,2,1,0,1,0
"SELDON",2,0,1,0,2,1,0,1,0
"SELIA",0,2,0,1,2,0,1,0,1
"SELINE",0,3,0,1,3,0,1,0,1
"SEMAJ",3,0,1,0,3,1,0,1,0
"SEMIR",2,0,1,0,2,1,0,1,0
"SEMYON",3,0,1,0,3,1,0,1,0
"SENIA",0,2,0,1,2,0,1,0,1
"SENIOR",1,1,.5,.5,2,0,0,0,0
"SENORA",0,2,0,1,2,0,1,0,1
"SEQUAN",2,0,1,0,2,1,0,1,0
"SEREENA",0,3,0,1,3,0,1,0,1
"SERGELINE",0,2,0,1,2,0,1,0,1
"SERGI",3,0,1,0,3,1,0,1,0
"SERGUEI",3,0,1,0,3,1,0,1,0
"SERIOUS",2,1,.6666667,.3333333,3,0,0,0,0
"SEUNGAH",0,2,0,1,2,0,1,0,1
"SEUNGHUN",3,0,1,0,3,1,0,1,0
"SEUNGHYUN",2,0,1,0,2,1,0,1,0
"SEUNGMIN",2,1,.6666667,.3333333,3,0,0,0,0
"SEVARA",0,2,0,1,2,0,1,0,1
"SEVIL",0,2,0,1,2,0,1,0,1
"SEVIN",0,2,0,1,2,0,1,0,1
"SEVON",0,3,0,1,3,0,1,0,1
"SEY",2,0,1,0,2,1,0,1,0
"SHAAKIRA",0,2,0,1,2,0,1,0,1
"SHABA",1,1,.5,.5,2,0,0,0,0
"SHABAZ",3,0,1,0,3,1,0,1,0
"SHACARA",0,2,0,1,2,0,1,0,1
"SHADIRA",0,2,0,1,2,0,1,0,1
"SHADOE",1,1,.5,.5,2,0,0,0,0
"SHAGGY",2,0,1,0,2,1,0,1,0
"SHAHEEM",2,0,1,0,2,1,0,1,0
"SHAHEIM",3,0,1,0,3,1,0,1,0
"SHAHERYAR",3,0,1,0,3,1,0,1,0
"SHAHIDUL",3,0,1,0,3,1,0,1,0
"SHAHIL",2,0,1,0,2,1,0,1,0
"SHAIFALI",0,3,0,1,3,0,1,0,1
"SHAIMA",0,2,0,1,2,0,1,0,1
"SHAJU",3,0,1,0,3,1,0,1,0
"SHAKEELA",0,3,0,1,3,0,1,0,1
"SHAKEERA",0,3,0,1,3,0,1,0,1
"SHAKEIRA",0,2,0,1,2,0,1,0,1
"SHAKEISHA",0,3,0,1,3,0,1,0,1
"SHAKIERA",0,2,0,1,2,0,1,0,1
"SHAKISHA",0,3,0,1,3,0,1,0,1
"SHALAY",0,2,0,1,2,0,1,0,1
"SHALITA",0,2,0,1,2,0,1,0,1
"SHALIZA",0,2,0,1,2,0,1,0,1
"SHAMECA",0,2,0,1,2,0,1,0,1
"SHAMIE",0,2,0,1,2,0,1,0,1
"SHAMILLA",0,3,0,1,3,0,1,0,1
"SHAMMARA",0,2,0,1,2,0,1,0,1
"SHAMON",3,0,1,0,3,1,0,1,0
"SHAMONE",1,2,.3333333,.6666667,3,0,0,0,0
"SHANA-KAY",0,2,0,1,2,0,1,0,1
"SHANDORA",0,2,0,1,2,0,1,0,1
"SHANDY",0,3,0,1,3,0,1,0,1
"SHANEZA",0,3,0,1,3,0,1,0,1
"SHANIQUIA",0,2,0,1,2,0,1,0,1
"SHANIT",0,2,0,1,2,0,1,0,1
"SHANTON",1,1,.5,.5,2,0,0,0,0
"SHAPE",2,0,1,0,2,1,0,1,0
"SHAQUEEN",0,2,0,1,2,0,1,0,1
"SHAQUIA",0,2,0,1,2,0,1,0,1
"SHARE",1,1,.5,.5,2,0,0,0,0
"SHAREA",0,2,0,1,2,0,1,0,1
"SHARESSE",0,2,0,1,2,0,1,0,1
"SHARIK",1,1,.5,.5,2,0,0,0,0
"SHARKY",3,0,1,0,3,1,0,1,0
"SHARRA",0,2,0,1,2,0,1,0,1
"SHARRAINE",0,3,0,1,3,0,1,0,1
"SHARREN",0,2,0,1,2,0,1,0,1
"SHARRONE",0,2,0,1,2,0,1,0,1
"SHATAVIA",0,2,0,1,2,0,1,0,1
"SHATEEK",2,1,.6666667,.3333333,3,0,0,0,0
"SHATIK",3,0,1,0,3,1,0,1,0
"SHAUNA-KAY",0,2,0,1,2,0,1,0,1
"SHAUNDRA",0,2,0,1,2,0,1,0,1
"SHAUNEE",0,3,0,1,3,0,1,0,1
"SHAUNELLE",0,3,0,1,3,0,1,0,1
"SHAUNTELL",0,3,0,1,3,0,1,0,1
"SHAVANA",0,2,0,1,2,0,1,0,1
"SHAVAUGHN",0,3,0,1,3,0,1,0,1
"SHAVKAT",2,0,1,0,2,1,0,1,0
"SHAWNA-LEE",0,2,0,1,2,0,1,0,1
"SHAWNAY",0,3,0,1,3,0,1,0,1
"SHAWNELLE",0,2,0,1,2,0,1,0,1
"SHAWNETT",0,2,0,1,2,0,1,0,1
"SHAWON",2,0,1,0,2,1,0,1,0
"SHAYLYN",0,2,0,1,2,0,1,0,1
"SHAZIM",3,0,1,0,3,1,0,1,0
"SHEIKIA",0,2,0,1,2,0,1,0,1
"SHEILAGH",0,2,0,1,2,0,1,0,1
"SHELITA",0,2,0,1,2,0,1,0,1
"SHELLZ",2,0,1,0,2,1,0,1,0
"SHEMAR",2,0,1,0,2,1,0,1,0
"SHENGYU",1,1,.5,.5,2,0,0,0,0
"SHEPHALI",0,2,0,1,2,0,1,0,1
"SHEPHERD",2,0,1,0,2,1,0,1,0
"SHERALEE",0,2,0,1,2,0,1,0,1
"SHERAN",1,1,.5,.5,2,0,0,0,0
"SHEREENE",0,2,0,1,2,0,1,0,1
"SHEREESE",0,3,0,1,3,0,1,0,1
"SHERICKA",0,2,0,1,2,0,1,0,1
"SHERIFF",3,0,1,0,3,1,0,1,0
"SHERLEEN",0,3,0,1,3,0,1,0,1
"SHERLENE",0,3,0,1,3,0,1,0,1
"SHERLIE",0,2,0,1,2,0,1,0,1
"SHERMIN",0,2,0,1,2,0,1,0,1
"SHERNETT",0,2,0,1,2,0,1,0,1
"SHERREL",0,3,0,1,3,0,1,0,1
"SHERRIA",0,3,0,1,3,0,1,0,1
"SHERROL",0,2,0,1,2,0,1,0,1
"SHERRYANNE",0,3,0,1,3,0,1,0,1
"SHERWAYNE",3,0,1,0,3,1,0,1,0
"SHEVAN",1,1,.5,.5,2,0,0,0,0
"SHEYENNE",0,2,0,1,2,0,1,0,1
"SHIBA",0,3,0,1,3,0,1,0,1
"SHIEN",1,1,.5,.5,2,0,0,0,0
"SHIHAN",1,1,.5,.5,2,0,0,0,0
"SHIJU",2,0,1,0,2,1,0,1,0
"SHILO",2,0,1,0,2,1,0,1,0
"SHIMONA",0,2,0,1,2,0,1,0,1
"SHIMY",2,0,1,0,2,1,0,1,0
"SHINEQUA",0,3,0,1,3,0,1,0,1
"SHINESE",0,2,0,1,2,0,1,0,1
"SHINGO",1,1,.5,.5,2,0,0,0,0
"SHIOBAN",0,2,0,1,2,0,1,0,1
"SHION",2,0,1,0,2,1,0,1,0
"SHIRENE",0,2,0,1,2,0,1,0,1
"SHIRLYN",0,3,0,1,3,0,1,0,1
"SHIRRY",0,2,0,1,2,0,1,0,1
"SHIRVONNE",0,2,0,1,2,0,1,0,1
"SHIVAUGHN",0,2,0,1,2,0,1,0,1
"SHIYA",0,3,0,1,3,0,1,0,1
"SHIYUN",0,2,0,1,2,0,1,0,1
"SHKELZEN",2,0,1,0,2,1,0,1,0
"SHKENDIJE",0,2,0,1,2,0,1,0,1
"SHOICHI",2,0,1,0,2,1,0,1,0
"SHOJI",2,0,1,0,2,1,0,1,0
"SHOMIK",2,0,1,0,2,1,0,1,0
"SHONDELLE",0,2,0,1,2,0,1,0,1
"SHONE",1,2,.3333333,.6666667,3,0,0,0,0
"SHONTELLE",1,1,.5,.5,2,0,0,0,0
"SHOSHANNAH",0,2,0,1,2,0,1,0,1
"SHOURYA",2,0,1,0,2,1,0,1,0
"SHRAGI",2,0,1,0,2,1,0,1,0
"SHRAVAN",2,0,1,0,2,1,0,1,0
"SHRIYA",0,3,0,1,3,0,1,0,1
"SHTERNA",0,2,0,1,2,0,1,0,1
"SHULAMIS",0,3,0,1,3,0,1,0,1
"SHUSHAN",1,1,.5,.5,2,0,0,0,0
"SHUSHANA",0,2,0,1,2,0,1,0,1
"SHUWEN",0,2,0,1,2,0,1,0,1
"SHYLENE",0,2,0,1,2,0,1,0,1
"SIBUSISO",3,0,1,0,3,1,0,1,0
"SIC",2,0,1,0,2,1,0,1,0
"SIDDHI",1,2,.3333333,.6666667,3,0,0,0,0
"SIDIK",3,0,1,0,3,1,0,1,0
"SIDIKA",0,2,0,1,2,0,1,0,1
"SIL",1,1,.5,.5,2,0,0,0,0
"SILVESTRO",2,0,1,0,2,1,0,1,0
"SILVIYA",0,2,0,1,2,0,1,0,1
"SIMPLE",1,1,.5,.5,2,0,0,0,0
"SINDIA",0,2,0,1,2,0,1,0,1
"SINE",0,2,0,1,2,0,1,0,1
"SINGING",1,1,.5,.5,2,0,0,0,0
"SINGLETON",1,1,.5,.5,2,0,0,0,0
"SINIA",0,2,0,1,2,0,1,0,1
"SINISA",2,0,1,0,2,1,0,1,0
"SINO",1,1,.5,.5,2,0,0,0,0
"SIRIKUL",0,3,0,1,3,0,1,0,1
"SISTA",0,2,0,1,2,0,1,0,1
"SISTINA",0,2,0,1,2,0,1,0,1
"SKATEBOARD",2,0,1,0,2,1,0,1,0
"SKILLZ",2,0,1,0,2,1,0,1,0
"SKIPPER",1,1,.5,.5,2,0,0,0,0
"SKITTLES",2,1,.6666667,.3333333,3,0,0,0,0
"SKYY",0,3,0,1,3,0,1,0,1
"SLAVKO",2,0,1,0,2,1,0,1,0
"SLIPPY",3,0,1,0,3,1,0,1,0
"SMILING",1,1,.5,.5,2,0,0,0,0
"SMOKIN",2,1,.6666667,.3333333,3,0,0,0,0
"SOBEYDA",0,2,0,1,2,0,1,0,1
"SODA",2,0,1,0,2,1,0,1,0
"SOHAM",2,0,1,0,2,1,0,1,0
"SOHEIL",2,0,1,0,2,1,0,1,0
"SOLANYI",0,2,0,1,2,0,1,0,1
"SOLAR",1,1,.5,.5,2,0,0,0,0
"SOLINE",0,2,0,1,2,0,1,0,1
"SOMALIA",0,2,0,1,2,0,1,0,1
"SOMAR",2,0,1,0,2,1,0,1,0
"SONITA",0,2,0,1,2,0,1,0,1
"SOOBIN",0,2,0,1,2,0,1,0,1
"SOOKYUNG",0,3,0,1,3,0,1,0,1
"SOOMEE",0,2,0,1,2,0,1,0,1
"SOORAN",0,2,0,1,2,0,1,0,1
"SOPHEA",1,1,.5,.5,2,0,0,0,0
"SOPHYA",0,3,0,1,3,0,1,0,1
"SORABH",3,0,1,0,3,1,0,1,0
"SOUMIA",0,2,0,1,2,0,1,0,1
"SOUR",2,0,1,0,2,1,0,1,0
"SOYUN",0,3,0,1,3,0,1,0,1
"SPARKS",1,1,.5,.5,2,0,0,0,0
"SPEEDY",2,1,.6666667,.3333333,3,0,0,0,0
"SPICE",3,0,1,0,3,1,0,1,0
"SPIKEY",3,0,1,0,3,1,0,1,0
"SPOON",2,0,1,0,2,1,0,1,0
"SRIDEVI",0,2,0,1,2,0,1,0,1
"SRIKANT",3,0,1,0,3,1,0,1,0
"STALYN",2,0,1,0,2,1,0,1,0
"STAMATIA",0,2,0,1,2,0,1,0,1
"STAMATIOS",2,0,1,0,2,1,0,1,0
"STARLETTE",0,2,0,1,2,0,1,0,1
"STEEVEN",2,0,1,0,2,1,0,1,0
"STEN",2,0,1,0,2,1,0,1,0
"STEPAN",2,0,1,0,2,1,0,1,0
"STEPANIE",0,2,0,1,2,0,1,0,1
"STEPHANO",2,0,1,0,2,1,0,1,0
"STEPHANOS",3,0,1,0,3,1,0,1,0
"STEPHONE",3,0,1,0,3,1,0,1,0
"STEVENN",2,0,1,0,2,1,0,1,0
"STEVI",0,3,0,1,3,0,1,0,1
"STEVLAND",2,0,1,0,2,1,0,1,0
"STRING",1,1,.5,.5,2,0,0,0,0
"SUANNE",0,2,0,1,2,0,1,0,1
"SUBODH",3,0,1,0,3,1,0,1,0
"SUCCESS",2,0,1,0,2,1,0,1,0
"SUDANA",0,2,0,1,2,0,1,0,1
"SUDARSHAN",3,0,1,0,3,1,0,1,0
"SUDHAKAR",2,0,1,0,2,1,0,1,0
"SUDIP",2,0,1,0,2,1,0,1,0
"SUELY",0,3,0,1,3,0,1,0,1
"SUGEY",0,2,0,1,2,0,1,0,1
"SUHAILY",0,2,0,1,2,0,1,0,1
"SUHYUN",0,3,0,1,3,0,1,0,1
"SUJEY",0,3,0,1,3,0,1,0,1
"SUJI",0,3,0,1,3,0,1,0,1
"SUJUNG",0,3,0,1,3,0,1,0,1
"SUKY",1,1,.5,.5,2,0,0,0,0
"SULA",0,2,0,1,2,0,1,0,1
"SUMANDEEP",0,3,0,1,3,0,1,0,1
"SUMANTH",2,0,1,0,2,1,0,1,0
"SUMEI",0,2,0,1,2,0,1,0,1
"SUMNER",2,0,1,0,2,1,0,1,0
"SUNDUS",0,3,0,1,3,0,1,0,1
"SUNGJOON",2,0,1,0,2,1,0,1,0
"SUNG-MIN",2,0,1,0,2,1,0,1,0
"SUNMIN",0,2,0,1,2,0,1,0,1
"SUNY",1,1,.5,.5,2,0,0,0,0
"SURAFEL",2,0,1,0,2,1,0,1,0
"SURAIYA",0,2,0,1,2,0,1,0,1
"SURF",1,1,.5,.5,2,0,0,0,0
"SURIL",2,0,1,0,2,1,0,1,0
"SUSIN",0,2,0,1,2,0,1,0,1
"SW",2,0,1,0,2,1,0,1,0
"SWAINSON",2,0,1,0,2,1,0,1,0
"SWAMI",2,0,1,0,2,1,0,1,0
"SWANAND",2,0,1,0,2,1,0,1,0
"SWAY",1,1,.5,.5,2,0,0,0,0
"SYMARA",0,2,0,1,2,0,1,0,1
"SYUZANNA",0,3,0,1,3,0,1,0,1
"TAAHIRA",0,2,0,1,2,0,1,0,1
"TAALIB",2,0,1,0,2,1,0,1,0
"TADE",1,1,.5,.5,2,0,0,0,0
"TADHG",2,0,1,0,2,1,0,1,0
"TAEHOON",3,0,1,0,3,1,0,1,0
"TAEISHA",0,3,0,1,3,0,1,0,1
"TAFFY",0,2,0,1,2,0,1,0,1
"TAHEEM",2,0,1,0,2,1,0,1,0
"TAHESHA",0,3,0,1,3,0,1,0,1
"TAHIESHA",0,2,0,1,2,0,1,0,1
"TAICHI",3,0,1,0,3,1,0,1,0
"TAIEB",2,1,.6666667,.3333333,3,0,0,0,0
"TAILOR",2,1,.6666667,.3333333,3,0,0,0,0
"TAISIA",0,2,0,1,2,0,1,0,1
"TAJH",2,0,1,0,2,1,0,1,0
"TAJMA",0,3,0,1,3,0,1,0,1
"TAKE",3,0,1,0,3,1,0,1,0
"TAKEMA",0,2,0,1,2,0,1,0,1
"TAKIM",3,0,1,0,3,1,0,1,0
"TAKINA",0,2,0,1,2,0,1,0,1
"TALBOT",2,0,1,0,2,1,0,1,0
"TALIEK",2,0,1,0,2,1,0,1,0
"TAMAKI",0,2,0,1,2,0,1,0,1
"TAMBRA",0,2,0,1,2,0,1,0,1
"TAMECKA",0,2,0,1,2,0,1,0,1
"TAMEEK",2,0,1,0,2,1,0,1,0
"TAMEISHA",0,3,0,1,3,0,1,0,1
"TAMICKA",0,3,0,1,3,0,1,0,1
"TAMIKIA",0,3,0,1,3,0,1,0,1
"TAMMYE",0,2,0,1,2,0,1,0,1
"TAMO",1,2,.3333333,.6666667,3,0,0,0,0
"TAMYRA",0,3,0,1,3,0,1,0,1
"TANDRA",0,2,0,1,2,0,1,0,1
"TANESIA",0,2,0,1,2,0,1,0,1
"TANEYA",0,2,0,1,2,0,1,0,1
"TANGE",2,1,.6666667,.3333333,3,0,0,0,0
"TANIQUE",0,3,0,1,3,0,1,0,1
"TANISE",0,2,0,1,2,0,1,0,1
"TANKA",3,0,1,0,3,1,0,1,0
"TANNIKA",0,2,0,1,2,0,1,0,1
"TAREL",1,1,.5,.5,2,0,0,0,0
"TARIA",0,2,0,1,2,0,1,0,1
"TARINA",0,2,0,1,2,0,1,0,1
"TARJI",0,2,0,1,2,0,1,0,1
"TARQUIN",1,1,.5,.5,2,0,0,0,0
"TARRYN",1,2,.3333333,.6666667,3,0,0,0,0
"TARU",0,2,0,1,2,0,1,0,1
"TASHAE",0,2,0,1,2,0,1,0,1
"TASHERA",0,2,0,1,2,0,1,0,1
"TASHIE",0,2,0,1,2,0,1,0,1
"TASHIEKA",0,2,0,1,2,0,1,0,1
"TASHNA",0,2,0,1,2,0,1,0,1
"TASHONDA",0,2,0,1,2,0,1,0,1
"TAUNA",0,2,0,1,2,0,1,0,1
"TAUSIF",2,0,1,0,2,1,0,1,0
"TAVI",2,0,1,0,2,1,0,1,0
"TAVIS",2,0,1,0,2,1,0,1,0
"TAVY",1,1,.5,.5,2,0,0,0,0
"TAWFIK",2,0,1,0,2,1,0,1,0
"TAWNYA",0,2,0,1,2,0,1,0,1
"TAYESHA",0,2,0,1,2,0,1,0,1
"TAYLOUR",0,2,0,1,2,0,1,0,1
"TEAGAN",1,1,.5,.5,2,0,0,0,0
"TEDDIE",0,2,0,1,2,0,1,0,1
"TEDESHA",0,2,0,1,2,0,1,0,1
"TEDI",2,1,.6666667,.3333333,3,0,0,0,0
"TEDRA",0,3,0,1,3,0,1,0,1
"TEENY",0,2,0,1,2,0,1,0,1
"TEF",2,0,1,0,2,1,0,1,0
"TEJAN",2,0,1,0,2,1,0,1,0
"TEJAY",3,0,1,0,3,1,0,1,0
"TEJINDER",2,0,1,0,2,1,0,1,0
"TEJUS",3,0,1,0,3,1,0,1,0
"TEKA",0,3,0,1,3,0,1,0,1
"TELMA",0,2,0,1,2,0,1,0,1
"TEMIKA",0,2,0,1,2,0,1,0,1
"TENEISHA",0,2,0,1,2,0,1,0,1
"TENNILE",0,2,0,1,2,0,1,0,1
"TEODOR",3,0,1,0,3,1,0,1,0
"TERELLE",2,1,.6666667,.3333333,3,0,0,0,0
"TERISA",0,2,0,1,2,0,1,0,1
"TERJE",2,1,.6666667,.3333333,3,0,0,0,0
"TERRIAN",0,2,0,1,2,0,1,0,1
"TERRIQUE",2,0,1,0,2,1,0,1,0
"TERRYL",1,1,.5,.5,2,0,0,0,0
"TERRYLEE",0,2,0,1,2,0,1,0,1
"TESHIA",0,2,0,1,2,0,1,0,1
"TESIA",0,2,0,1,2,0,1,0,1
"THABANI",2,1,.6666667,.3333333,3,0,0,0,0
"THAMINA",0,2,0,1,2,0,1,0,1
"THAN",0,2,0,1,2,0,1,0,1
"THANASIS",2,0,1,0,2,1,0,1,0
"THANT",2,1,.6666667,.3333333,3,0,0,0,0
"THANUJA",0,3,0,1,3,0,1,0,1
"THEMBI",0,2,0,1,2,0,1,0,1
"THEMI",2,0,1,0,2,1,0,1,0
"THIDA",0,2,0,1,2,0,1,0,1
"THINK",1,1,.5,.5,2,0,0,0,0
"THIRI",0,2,0,1,2,0,1,0,1
"THURGOOD",2,0,1,0,2,1,0,1,0
"TIAISHA",0,2,0,1,2,0,1,0,1
"TIANTIAN",0,2,0,1,2,0,1,0,1
"TIASIA",0,2,0,1,2,0,1,0,1
"TIBERIOUS",1,1,.5,.5,2,0,0,0,0
"TIBI",2,0,1,0,2,1,0,1,0
"TICA",0,2,0,1,2,0,1,0,1
"TIDA",0,2,0,1,2,0,1,0,1
"TIFFANE",0,2,0,1,2,0,1,0,1
"TIFFANNIE",0,2,0,1,2,0,1,0,1
"TIGIST",0,2,0,1,2,0,1,0,1
"TILAK",2,0,1,0,2,1,0,1,0
"TILLA",1,1,.5,.5,2,0,0,0,0
"TILSA",0,2,0,1,2,0,1,0,1
"TIMIKA",0,2,0,1,2,0,1,0,1
"TIMOR",1,1,.5,.5,2,0,0,0,0
"TINK",0,2,0,1,2,0,1,0,1
"TINTIN",1,1,.5,.5,2,0,0,0,0
"TINTU",1,1,.5,.5,2,0,0,0,0
"TINU",1,1,.5,.5,2,0,0,0,0
"TINY",2,0,1,0,2,1,0,1,0
"TIONA",0,2,0,1,2,0,1,0,1
"TIRRELL",2,0,1,0,2,1,0,1,0
"TISHANA",0,2,0,1,2,0,1,0,1
"TISLAM",2,0,1,0,2,1,0,1,0
"TITAN",2,0,1,0,2,1,0,1,0
"TOCHUKWU",3,0,1,0,3,1,0,1,0
"TODOR",3,0,1,0,3,1,0,1,0
"TOKYO",1,1,.5,.5,2,0,0,0,0
"TOMISHA",0,2,0,1,2,0,1,0,1
"TOMOYA",2,0,1,0,2,1,0,1,0
"TOMOYUKI",3,0,1,0,3,1,0,1,0
"TONITO",3,0,1,0,3,1,0,1,0
"TONYIA",0,3,0,1,3,0,1,0,1
"TORREN",3,0,1,0,3,1,0,1,0
"TOSCA",0,3,0,1,3,0,1,0,1
"TOSHIAKI",3,0,1,0,3,1,0,1,0
"TOSHIBA",0,2,0,1,2,0,1,0,1
"TOSHIHIKO",3,0,1,0,3,1,0,1,0
"TOSHIYA",3,0,1,0,3,1,0,1,0
"TOTA",0,2,0,1,2,0,1,0,1
"TOTALLY",2,0,1,0,2,1,0,1,0
"TOUGH",1,1,.5,.5,2,0,0,0,0
"TRAINER",2,1,.6666667,.3333333,3,0,0,0,0
"TRANI",1,1,.5,.5,2,0,0,0,0
"TRAVEL",2,0,1,0,2,1,0,1,0
"TRAVER",2,0,1,0,2,1,0,1,0
"TREENA",0,3,0,1,3,0,1,0,1
"TREMAIN",3,0,1,0,3,1,0,1,0
"TREMEL",2,0,1,0,2,1,0,1,0
"TRESTON",2,0,1,0,2,1,0,1,0
"TREVI",0,2,0,1,2,0,1,0,1
"TREVIS",3,0,1,0,3,1,0,1,0
"TRICE",0,2,0,1,2,0,1,0,1
"TRIGGER",2,0,1,0,2,1,0,1,0
"TRISTIN",2,1,.6666667,.3333333,3,0,0,0,0
"TRUMAINE",2,0,1,0,2,1,0,1,0
"TRYSTAN",2,0,1,0,2,1,0,1,0
"TSEWANG",2,0,1,0,2,1,0,1,0
"TSUBASA",2,0,1,0,2,1,0,1,0
"TUGAY",2,0,1,0,2,1,0,1,0
"TUGRUL",3,0,1,0,3,1,0,1,0
"TURHAN",2,0,1,0,2,1,0,1,0
"TURID",0,2,0,1,2,0,1,0,1
"TUTU",1,1,.5,.5,2,0,0,0,0
"TUWANDA",0,3,0,1,3,0,1,0,1
"TYANNA",0,3,0,1,3,0,1,0,1
"TYLON",2,0,1,0,2,1,0,1,0
"TYLOR",2,0,1,0,2,1,0,1,0
"TYME",2,0,1,0,2,1,0,1,0
"TYMEL",3,0,1,0,3,1,0,1,0
"TYNESE",0,2,0,1,2,0,1,0,1
"TYREIK",2,0,1,0,2,1,0,1,0
"TYREN",2,0,1,0,2,1,0,1,0
"TYRIEK",2,0,1,0,2,1,0,1,0
"TYRONNE",2,0,1,0,2,1,0,1,0
"TYSHON",3,0,1,0,3,1,0,1,0
"TYWANNA",0,2,0,1,2,0,1,0,1
"TZILA",0,3,0,1,3,0,1,0,1
"TZIPI",0,2,0,1,2,0,1,0,1
"TZLIL",0,3,0,1,3,0,1,0,1
"TZU",1,1,.5,.5,2,0,0,0,0
"UDAYA",3,0,1,0,3,1,0,1,0
"UHURA",2,0,1,0,2,1,0,1,0
"UHURU",2,1,.6666667,.3333333,3,0,0,0,0
"ULANA",0,3,0,1,3,0,1,0,1
"ULISSES",3,0,1,0,3,1,0,1,0
"ULUGBEK",2,0,1,0,2,1,0,1,0
"UMBREEN",0,2,0,1,2,0,1,0,1
"UMEKA",0,2,0,1,2,0,1,0,1
"UNCLE",2,0,1,0,2,1,0,1,0
"UNDERSTANDING",3,0,1,0,3,1,0,1,0
"UNO",2,0,1,0,2,1,0,1,0
"UNSAL",2,0,1,0,2,1,0,1,0
"UP",2,0,1,0,2,1,0,1,0
"URAN",2,0,1,0,2,1,0,1,0
"URANIA",0,3,0,1,3,0,1,0,1
"URIA",2,0,1,0,2,1,0,1,0
"UZUN",2,0,1,0,2,1,0,1,0
"VACLAV",2,0,1,0,2,1,0,1,0
"VAGABOND",1,1,.5,.5,2,0,0,0,0
"VALDET",2,0,1,0,2,1,0,1,0
"VALEEN",0,3,0,1,3,0,1,0,1
"VALISHA",0,2,0,1,2,0,1,0,1
"VANDER",3,0,1,0,3,1,0,1,0
"VANDNA",0,3,0,1,3,0,1,0,1
"VANESS",0,3,0,1,3,0,1,0,1
"VARMA",2,0,1,0,2,1,0,1,0
"VARON",2,0,1,0,2,1,0,1,0
"VARVARA",0,2,0,1,2,0,1,0,1
"VASILE",3,0,1,0,3,1,0,1,0
"VASYL",2,0,1,0,2,1,0,1,0
"VEEJAY",2,0,1,0,2,1,0,1,0
"VELA",0,2,0,1,2,0,1,0,1
"VELAZQUEZ",0,2,0,1,2,0,1,0,1
"VELL",2,0,1,0,2,1,0,1,0
"VELLA",0,2,0,1,2,0,1,0,1
"VENETA",0,2,0,1,2,0,1,0,1
"VENUGOPAL",2,0,1,0,2,1,0,1,0
"VERIDIANA",0,2,0,1,2,0,1,0,1
"VERNAL",2,0,1,0,2,1,0,1,0
"VERSATILE",1,1,.5,.5,2,0,0,0,0
"VERUSHKA",0,2,0,1,2,0,1,0,1
"VIBERT",2,0,1,0,2,1,0,1,0
"VICKTORIA",0,2,0,1,2,0,1,0,1
"VICO",2,0,1,0,2,1,0,1,0
"VIEIRA",2,0,1,0,2,1,0,1,0
"VIGGO",3,0,1,0,3,1,0,1,0
"VIKESH",2,0,1,0,2,1,0,1,0
"VILDAN",0,3,0,1,3,0,1,0,1
"VILLE",2,0,1,0,2,1,0,1,0
"VINOTH",2,0,1,0,2,1,0,1,0
"VINZ",2,0,1,0,2,1,0,1,0
"VIONA",0,2,0,1,2,0,1,0,1
"VIPAL",2,0,1,0,2,1,0,1,0
"VIRENDRA",2,0,1,0,2,1,0,1,0
"VIRGIE",0,2,0,1,2,0,1,0,1
"VIRGILE",2,0,1,0,2,1,0,1,0
"VIRGILIA",0,2,0,1,2,0,1,0,1
"VIRGINIO",2,0,1,0,2,1,0,1,0
"VIRGO",0,2,0,1,2,0,1,0,1
"VISHAM",3,0,1,0,3,1,0,1,0
"VISHAN",3,0,1,0,3,1,0,1,0
"VISHESH",2,0,1,0,2,1,0,1,0
"VITALIK",3,0,1,0,3,1,0,1,0
"VIVAN",0,2,0,1,2,0,1,0,1
"VIVID",0,3,0,1,3,0,1,0,1
"VLADLENA",0,3,0,1,3,0,1,0,1
"VLATKO",3,0,1,0,3,1,0,1,0
"VOLNEY",2,0,1,0,2,1,0,1,0
"VONETTE",0,2,0,1,2,0,1,0,1
"VUK",3,0,1,0,3,1,0,1,0
"VULLNET",2,0,1,0,2,1,0,1,0
"VURAL",2,0,1,0,2,1,0,1,0
"WA",1,1,.5,.5,2,0,0,0,0
"WAGDY",3,0,1,0,3,1,0,1,0
"WAKAKO",0,2,0,1,2,0,1,0,1
"WAKI",2,0,1,0,2,1,0,1,0
"WALIA",0,2,0,1,2,0,1,0,1
"WALLESKA",0,2,0,1,2,0,1,0,1
"WALTHER",3,0,1,0,3,1,0,1,0
"WANDALIZ",0,2,0,1,2,0,1,0,1
"WANDALY",0,2,0,1,2,0,1,0,1
"WANDERSON",3,0,1,0,3,1,0,1,0
"WARRICK",3,0,1,0,3,1,0,1,0
"WARUNA",2,0,1,0,2,1,0,1,0
"WASKAR",2,0,1,0,2,1,0,1,0
"WASSILA",0,3,0,1,3,0,1,0,1
"WATT",1,1,.5,.5,2,0,0,0,0
"WATTS",1,2,.3333333,.6666667,3,0,0,0,0
"WAVEY",3,0,1,0,3,1,0,1,0
"WAYMOND",3,0,1,0,3,1,0,1,0
"WAZEEM",2,0,1,0,2,1,0,1,0
"WEINA",0,2,0,1,2,0,1,0,1
"WELLIE",3,0,1,0,3,1,0,1,0
"WENDA",1,2,.3333333,.6666667,3,0,0,0,0
"WENJI",1,2,.3333333,.6666667,3,0,0,0,0
"WENNIE",1,1,.5,.5,2,0,0,0,0
"WESLEE",0,2,0,1,2,0,1,0,1
"WICKET",2,1,.6666667,.3333333,3,0,0,0,0
"WIDGET",1,2,.3333333,.6666667,3,0,0,0,0
"WIEBKE",0,2,0,1,2,0,1,0,1
"WIG",1,1,.5,.5,2,0,0,0,0
"WILNELIA",0,2,0,1,2,0,1,0,1
"WILNER",3,0,1,0,3,1,0,1,0
"WINDSOR",2,0,1,0,2,1,0,1,0
"WINNA",0,3,0,1,3,0,1,0,1
"WISAM",1,1,.5,.5,2,0,0,0,0
"WISON",3,0,1,0,3,1,0,1,0
"WLADIMIRO",3,0,1,0,3,1,0,1,0
"WM",2,1,.6666667,.3333333,3,0,0,0,0
"WONKYUNG",0,3,0,1,3,0,1,0,1
"WOODLYNE",0,2,0,1,2,0,1,0,1
"WOODSIDE",0,2,0,1,2,0,1,0,1
"WOOK",2,0,1,0,2,1,0,1,0
"WOONG",2,0,1,0,2,1,0,1,0
"WORM",2,0,1,0,2,1,0,1,0
"WYMAN",2,0,1,0,2,1,0,1,0
"XCLUSIVE",1,2,.3333333,.6666667,3,0,0,0,0
"XEPH",3,0,1,0,3,1,0,1,0
"XIAOHONG",0,2,0,1,2,0,1,0,1
"XIAOHUA",1,2,.3333333,.6666667,3,0,0,0,0
"XIAOJING",0,3,0,1,3,0,1,0,1
"XIAOMEI",0,3,0,1,3,0,1,0,1
"XIAOTING",0,2,0,1,2,0,1,0,1
"XIAOXI",1,2,.3333333,.6666667,3,0,0,0,0
"XIAOYE",0,2,0,1,2,0,1,0,1
"XINYI",0,2,0,1,2,0,1,0,1
"XOCHILT",0,2,0,1,2,0,1,0,1
"XOCHITL",0,3,0,1,3,0,1,0,1
"XRISTINA",0,3,0,1,3,0,1,0,1
"XTINA",0,2,0,1,2,0,1,0,1
"XUYANG",3,0,1,0,3,1,0,1,0
"YAGO",2,1,.6666667,.3333333,3,0,0,0,0
"YAHAYRA",0,3,0,1,3,0,1,0,1
"YAHIR",3,0,1,0,3,1,0,1,0
"YAITZA",0,2,0,1,2,0,1,0,1
"YAKIRA",0,2,0,1,2,0,1,0,1
"YAMAIRA",0,2,0,1,2,0,1,0,1
"YAMAMOTO",1,2,.3333333,.6666667,3,0,0,0,0
"YAMILEE",0,3,0,1,3,0,1,0,1
"YAMILETTE",0,2,0,1,2,0,1,0,1
"YAMINA",0,2,0,1,2,0,1,0,1
"YAMIRA",0,2,0,1,2,0,1,0,1
"YANAIRA",0,2,0,1,2,0,1,0,1
"YANAN",0,3,0,1,3,0,1,0,1
"YANAY",0,2,0,1,2,0,1,0,1
"YANEL",0,3,0,1,3,0,1,0,1
"YANETT",0,3,0,1,3,0,1,0,1
"YANFEN",0,3,0,1,3,0,1,0,1
"YANHONG",0,3,0,1,3,0,1,0,1
"YANHUA",0,2,0,1,2,0,1,0,1
"YANIRYS",0,2,0,1,2,0,1,0,1
"YANKA",0,2,0,1,2,0,1,0,1
"YANLI",0,3,0,1,3,0,1,0,1
"YANNY",1,1,.5,.5,2,0,0,0,0
"YAOYAO",1,1,.5,.5,2,0,0,0,0
"YAP",2,1,.6666667,.3333333,3,0,0,0,0
"YARELIS",0,2,0,1,2,0,1,0,1
"YARIS",0,2,0,1,2,0,1,0,1
"YASHAR",2,0,1,0,2,1,0,1,0
"YASSI",1,1,.5,.5,2,0,0,0,0
"YASSIR",2,0,1,0,2,1,0,1,0
"YASU",2,0,1,0,2,1,0,1,0
"YASUFUMI",3,0,1,0,3,1,0,1,0
"YASUYO",0,2,0,1,2,0,1,0,1
"YAVE",3,0,1,0,3,1,0,1,0
"YAZZ",0,2,0,1,2,0,1,0,1
"YEDIDA",0,2,0,1,2,0,1,0,1
"YELISA",0,2,0,1,2,0,1,0,1
"YELIZAVETA",0,2,0,1,2,0,1,0,1
"YEMMY",0,2,0,1,2,0,1,0,1
"YEONG",1,1,.5,.5,2,0,0,0,0
"YERALDINE",0,2,0,1,2,0,1,0,1
"YERITZA",0,3,0,1,3,0,1,0,1
"YEURI",3,0,1,0,3,1,0,1,0
"YI-CHUN",1,2,.3333333,.6666667,3,0,0,0,0
"YIFEI",3,0,1,0,3,1,0,1,0
"YIFENG",1,1,.5,.5,2,0,0,0,0
"YIK",1,1,.5,.5,2,0,0,0,0
"YILDIZ",0,2,0,1,2,0,1,0,1
"YILIN",0,2,0,1,2,0,1,0,1
"YILING",1,2,.3333333,.6666667,3,0,0,0,0
"YIORGOS",2,0,1,0,2,1,0,1,0
"YISU",3,0,1,0,3,1,0,1,0
"YIXI",1,2,.3333333,.6666667,3,0,0,0,0
"YOGENDRA",2,0,1,0,2,1,0,1,0
"YOHANCE",2,0,1,0,2,1,0,1,0
"YOHANES",2,0,1,0,2,1,0,1,0
"YOHANI",0,2,0,1,2,0,1,0,1
"YOICHIRO",2,0,1,0,2,1,0,1,0
"YOKE",0,2,0,1,2,0,1,0,1
"YOLENNY",0,3,0,1,3,0,1,0,1
"YOLIMA",0,2,0,1,2,0,1,0,1
"YOLLIE",0,2,0,1,2,0,1,0,1
"YOLLY",0,3,0,1,3,0,1,0,1
"YONGJI",3,0,1,0,3,1,0,1,0
"YOONJI",0,2,0,1,2,0,1,0,1
"YOONJU",0,2,0,1,2,0,1,0,1
"YOONKYUNG",0,2,0,1,2,0,1,0,1
"YOORI",0,2,0,1,2,0,1,0,1
"YORDAN",2,0,1,0,2,1,0,1,0
"YORDANKA",0,2,0,1,2,0,1,0,1
"YORMAN",2,0,1,0,2,1,0,1,0
"YOSHIHIRO",3,0,1,0,3,1,0,1,0
"YOSHITAKA",3,0,1,0,3,1,0,1,0
"YOSMAR",2,1,.6666667,.3333333,3,0,0,0,0
"YOSSEF",2,0,1,0,2,1,0,1,0
"YOUNGSUN",1,1,.5,.5,2,0,0,0,0
"YOUSIF",3,0,1,0,3,1,0,1,0
"YOVANA",0,3,0,1,3,0,1,0,1
"YUBELKIS",0,2,0,1,2,0,1,0,1
"YU-CHIA",0,2,0,1,2,0,1,0,1
"YUDIT",0,2,0,1,2,0,1,0,1
"YUGO",3,0,1,0,3,1,0,1,0
"YUHAO",2,0,1,0,2,1,0,1,0
"YUIKO",0,2,0,1,2,0,1,0,1
"YUJING",0,2,0,1,2,0,1,0,1
"YUKINO",0,2,0,1,2,0,1,0,1
"YUKIYO",0,2,0,1,2,0,1,0,1
"YULIETH",0,2,0,1,2,0,1,0,1
"YUM",0,2,0,1,2,0,1,0,1
"YUME",0,2,0,1,2,0,1,0,1
"YUNXIA",0,3,0,1,3,0,1,0,1
"YVENS",2,0,1,0,2,1,0,1,0
"YVET",0,2,0,1,2,0,1,0,1
"YVROSE",0,2,0,1,2,0,1,0,1
"ZACHARIA",2,0,1,0,2,1,0,1,0
"ZAHED",2,0,1,0,2,1,0,1,0
"ZALE",2,1,.6666667,.3333333,3,0,0,0,0
"ZAQUAN",3,0,1,0,3,1,0,1,0
"ZEA",0,2,0,1,2,0,1,0,1
"ZEBEDEE",2,0,1,0,2,1,0,1,0
"ZEIN",1,1,.5,.5,2,0,0,0,0
"ZEKI",2,0,1,0,2,1,0,1,0
"ZELENE",0,2,0,1,2,0,1,0,1
"ZELI",1,2,.3333333,.6666667,3,0,0,0,0
"ZENAE",0,2,0,1,2,0,1,0,1
"ZENITH",1,2,.3333333,.6666667,3,0,0,0,0
"ZETH",3,0,1,0,3,1,0,1,0
"ZHANA",0,2,0,1,2,0,1,0,1
"ZHANE",1,2,.3333333,.6666667,3,0,0,0,0
"ZHENIA",0,2,0,1,2,0,1,0,1
"ZHIYAN",1,1,.5,.5,2,0,0,0,0
"ZIKO",2,0,1,0,2,1,0,1,0
"ZIRA",0,2,0,1,2,0,1,0,1
"ZIWEI",0,2,0,1,2,0,1,0,1
"ZIYU",3,0,1,0,3,1,0,1,0
"ZOBIA",0,3,0,1,3,0,1,0,1
"ZORIK",2,0,1,0,2,1,0,1,0
"ZOU",1,1,.5,.5,2,0,0,0,0
"ZSOFIA",1,1,.5,.5,2,0,0,0,0
"ZUBAIDAH",0,2,0,1,2,0,1,0,1
"ZUHAIB",2,0,1,0,2,1,0,1,0
"ZUL",3,0,1,0,3,1,0,1,0
"ZULAI",0,2,0,1,2,0,1,0,1
"ZULFIKAR",2,0,1,0,2,1,0,1,0
"ZULIA",0,3,0,1,3,0,1,0,1
"ZURY",0,3,0,1,3,0,1,0,1
"ZVONIMIR",2,0,1,0,2,1,0,1,0
"AADI",2,0,1,0,2,1,0,1,0
"ABAD",2,0,1,0,2,1,0,1,0
"ABASS",2,0,1,0,2,1,0,1,0
"ABBII",0,2,0,1,2,0,1,0,1
"ABBIOLA",0,2,0,1,2,0,1,0,1
"ABDER",2,0,1,0,2,1,0,1,0
"ABDULLAI",2,0,1,0,2,1,0,1,0
"ABDUL-QADIR",2,0,1,0,2,1,0,1,0
"ABDUSSAMET",2,0,1,0,2,1,0,1,0
"ABISHEK",2,0,1,0,2,1,0,1,0
"ABOSEDE",0,2,0,1,2,0,1,0,1
"ACHVA",2,0,1,0,2,1,0,1,0
"ACKIM",2,0,1,0,2,1,0,1,0
"ADASA",0,2,0,1,2,0,1,0,1
"ADDAM",2,0,1,0,2,1,0,1,0
"ADEINA",0,2,0,1,2,0,1,0,1
"ADESINA",1,1,.5,.5,2,0,0,0,0
"ADIANEZ",0,2,0,1,2,0,1,0,1
"ADILSON",2,0,1,0,2,1,0,1,0
"ADINAH",0,2,0,1,2,0,1,0,1
"ADITTO",2,0,1,0,2,1,0,1,0
"ADJANAYE",0,2,0,1,2,0,1,0,1
"ADJUA",0,2,0,1,2,0,1,0,1
"ADORE",0,2,0,1,2,0,1,0,1
"ADREA",0,2,0,1,2,0,1,0,1
"ADRIANN",1,1,.5,.5,2,0,0,0,0
"ADRIATIK",2,0,1,0,2,1,0,1,0
"ADRIEAN",2,0,1,0,2,1,0,1,0
"ADRIENA",0,2,0,1,2,0,1,0,1
"ADRIS",1,1,.5,.5,2,0,0,0,0
"ADUNNI",0,2,0,1,2,0,1,0,1
"AERIEL",0,2,0,1,2,0,1,0,1
"AFA",2,0,1,0,2,1,0,1,0
"AFAQ",2,0,1,0,2,1,0,1,0
"AFESHIA",0,2,0,1,2,0,1,0,1
"AFRON",2,0,1,0,2,1,0,1,0
"AFROZA",0,2,0,1,2,0,1,0,1
"AFSER",1,1,.5,.5,2,0,0,0,0
"AGGREY",2,0,1,0,2,1,0,1,0
"AGOSTINHO",2,0,1,0,2,1,0,1,0
"AGUNG",2,0,1,0,2,1,0,1,0
"AGYEMANG",2,0,1,0,2,1,0,1,0
"AHMAAD",2,0,1,0,2,1,0,1,0
"AHMADU",2,0,1,0,2,1,0,1,0
"AHMER",2,0,1,0,2,1,0,1,0
"AHSEN",1,1,.5,.5,2,0,0,0,0
"AICH",1,1,.5,.5,2,0,0,0,0
"AIFUWA",2,0,1,0,2,1,0,1,0
"AILED",0,2,0,1,2,0,1,0,1
"AINURA",0,2,0,1,2,0,1,0,1
"AISLYN",0,2,0,1,2,0,1,0,1
"AJALA",1,1,.5,.5,2,0,0,0,0
"AJANTHA",1,1,.5,.5,2,0,0,0,0
"AJI",1,1,.5,.5,2,0,0,0,0
"AJIRI",0,2,0,1,2,0,1,0,1
"AJIWOKEWU",1,1,.5,.5,2,0,0,0,0
"AJU",2,0,1,0,2,1,0,1,0
"AKEDA",0,2,0,1,2,0,1,0,1
"AKEELAH",0,2,0,1,2,0,1,0,1
"AKEILA",0,2,0,1,2,0,1,0,1
"AKEIM",2,0,1,0,2,1,0,1,0
"AKELIA",0,2,0,1,2,0,1,0,1
"AKENO",1,1,.5,.5,2,0,0,0,0
"AKIB",2,0,1,0,2,1,0,1,0
"AKINDELE",2,0,1,0,2,1,0,1,0
"AKITO",2,0,1,0,2,1,0,1,0
"AKKO",0,2,0,1,2,0,1,0,1
"AKON",2,0,1,0,2,1,0,1,0
"AKSOY",2,0,1,0,2,1,0,1,0
"AKUMA",2,0,1,0,2,1,0,1,0
"AL-",2,0,1,0,2,1,0,1,0
"ALABA",1,1,.5,.5,2,0,0,0,0
"ALADINO",2,0,1,0,2,1,0,1,0
"ALAFIA",0,2,0,1,2,0,1,0,1
"ALANDA",0,2,0,1,2,0,1,0,1
"ALASHA",0,2,0,1,2,0,1,0,1
"ALASKAN",0,2,0,1,2,0,1,0,1
"ALB",1,1,.5,.5,2,0,0,0,0
"ALBERTE",0,2,0,1,2,0,1,0,1
"ALBITA",0,2,0,1,2,0,1,0,1
"ALCIAN",1,1,.5,.5,2,0,0,0,0
"ALCIBIADES",2,0,1,0,2,1,0,1,0
"ALDITH",0,2,0,1,2,0,1,0,1
"ALDRIC",2,0,1,0,2,1,0,1,0
"ALEANE",0,2,0,1,2,0,1,0,1
"ALEASE",0,2,0,1,2,0,1,0,1
"ALEIKA",0,2,0,1,2,0,1,0,1
"ALEISTER",2,0,1,0,2,1,0,1,0
"ALEJITA",0,2,0,1,2,0,1,0,1
"ALESI",2,0,1,0,2,1,0,1,0
"ALETH",0,2,0,1,2,0,1,0,1
"ALEXYZ",2,0,1,0,2,1,0,1,0
"ALEXZANDRA",0,2,0,1,2,0,1,0,1
"ALFAZ",2,0,1,0,2,1,0,1,0
"ALFINA",0,2,0,1,2,0,1,0,1
"ALGIS",2,0,1,0,2,1,0,1,0
"ALHAN",2,0,1,0,2,1,0,1,0
"ALHASSAN",2,0,1,0,2,1,0,1,0
"ALICEA",0,2,0,1,2,0,1,0,1
"ALIF",2,0,1,0,2,1,0,1,0
"ALISABETH",0,2,0,1,2,0,1,0,1
"ALISEN",0,2,0,1,2,0,1,0,1
"ALLADIN",2,0,1,0,2,1,0,1,0
"ALLEGRIA",0,2,0,1,2,0,1,0,1
"ALLONS",2,0,1,0,2,1,0,1,0
"ALMARIE",0,2,0,1,2,0,1,0,1
"ALMOND",1,1,.5,.5,2,0,0,0,0
"ALMOST",1,1,.5,.5,2,0,0,0,0
"ALMUDENA",0,2,0,1,2,0,1,0,1
"ALO",2,0,1,0,2,1,0,1,0
"ALPEREN",2,0,1,0,2,1,0,1,0
"ALPHONZO",2,0,1,0,2,1,0,1,0
"ALTER",2,0,1,0,2,1,0,1,0
"ALTIA",0,2,0,1,2,0,1,0,1
"ALVONYA",0,2,0,1,2,0,1,0,1
"ALYNNE",0,2,0,1,2,0,1,0,1
"ALYXANDRIA",0,2,0,1,2,0,1,0,1
"AMAAL",0,2,0,1,2,0,1,0,1
"AMAALA",0,2,0,1,2,0,1,0,1
"AMAIR",2,0,1,0,2,1,0,1,0
"AMANO",1,1,.5,.5,2,0,0,0,0
"AMBA",1,1,.5,.5,2,0,0,0,0
"AMBROSIA",0,2,0,1,2,0,1,0,1
"AMDY",2,0,1,0,2,1,0,1,0
"AMEENAH",0,2,0,1,2,0,1,0,1
"AMEERAH",0,2,0,1,2,0,1,0,1
"AMEIKA",0,2,0,1,2,0,1,0,1
"AMERA",0,2,0,1,2,0,1,0,1
"AMICA",0,2,0,1,2,0,1,0,1
"AMIRAN",1,1,.5,.5,2,0,0,0,0
"AMIRH",0,2,0,1,2,0,1,0,1
"AMIRI",2,0,1,0,2,1,0,1,0
"AMITAVA",2,0,1,0,2,1,0,1,0
"AMOGH",2,0,1,0,2,1,0,1,0
"AMPY",1,1,.5,.5,2,0,0,0,0
"AMUN",2,0,1,0,2,1,0,1,0
"ANAHIS",0,2,0,1,2,0,1,0,1
"ANAKAY",0,2,0,1,2,0,1,0,1
"ANALIZ",0,2,0,1,2,0,1,0,1
"ANAMUL",2,0,1,0,2,1,0,1,0
"ANANDI",0,2,0,1,2,0,1,0,1
"ANANSA",0,2,0,1,2,0,1,0,1
"ANASA",0,2,0,1,2,0,1,0,1
"ANASTATIA",0,2,0,1,2,0,1,0,1
"ANASTAZIA",0,2,0,1,2,0,1,0,1
"ANATALIA",0,2,0,1,2,0,1,0,1
"ANATILIA",0,2,0,1,2,0,1,0,1
"ANAYZA",0,2,0,1,2,0,1,0,1
"ANDDY",2,0,1,0,2,1,0,1,0
"ANDERSSON",2,0,1,0,2,1,0,1,0
"ANDHIKA",2,0,1,0,2,1,0,1,0
"ANDIKA",2,0,1,0,2,1,0,1,0
"ANDINO",2,0,1,0,2,1,0,1,0
"ANDRAYA",0,2,0,1,2,0,1,0,1
"ANDREIS",2,0,1,0,2,1,0,1,0
"ANDREZA",0,2,0,1,2,0,1,0,1
"ANDRIAN",2,0,1,0,2,1,0,1,0
"ANDRINA",0,2,0,1,2,0,1,0,1
"ANDROS",2,0,1,0,2,1,0,1,0
"ANDUIN",1,1,.5,.5,2,0,0,0,0
"ANDWELE",2,0,1,0,2,1,0,1,0
"ANEIKA",0,2,0,1,2,0,1,0,1
"ANESTA",0,2,0,1,2,0,1,0,1
"ANGALIC",0,2,0,1,2,0,1,0,1
"ANGELIK",0,2,0,1,2,0,1,0,1
"ANGELISA",0,2,0,1,2,0,1,0,1
"ANGJELINA",0,2,0,1,2,0,1,0,1
"ANGLE",0,2,0,1,2,0,1,0,1
"ANISHKA",0,2,0,1,2,0,1,0,1
"ANJAIL",0,2,0,1,2,0,1,0,1
"ANJANI",1,1,.5,.5,2,0,0,0,0
"ANJELINA",0,2,0,1,2,0,1,0,1
"ANNAH",0,2,0,1,2,0,1,0,1
"ANNA-KAYE",0,2,0,1,2,0,1,0,1
"ANNALY",0,2,0,1,2,0,1,0,1
"ANNAZETTE",0,2,0,1,2,0,1,0,1
"ANNDREW",2,0,1,0,2,1,0,1,0
"ANNECIA",0,2,0,1,2,0,1,0,1
"ANNELYN",0,2,0,1,2,0,1,0,1
"ANNE-MICHELLE",0,2,0,1,2,0,1,0,1
"ANNE-ROSE",0,2,0,1,2,0,1,0,1
"ANNISIA",0,2,0,1,2,0,1,0,1
"ANOOSH",2,0,1,0,2,1,0,1,0
"ANSELMA",0,2,0,1,2,0,1,0,1
"ANSIL",1,1,.5,.5,2,0,0,0,0
"ANTARES",1,1,.5,.5,2,0,0,0,0
"ANTAYA",0,2,0,1,2,0,1,0,1
"ANTEO",2,0,1,0,2,1,0,1,0
"ANTERO",2,0,1,0,2,1,0,1,0
"ANTIMO",2,0,1,0,2,1,0,1,0
"ANTONEIL",2,0,1,0,2,1,0,1,0
"ANTULIO",2,0,1,0,2,1,0,1,0
"ANTWAIN",2,0,1,0,2,1,0,1,0
"ANTZ",2,0,1,0,2,1,0,1,0
"ANUKI",0,2,0,1,2,0,1,0,1
"ANXHELA",0,2,0,1,2,0,1,0,1
"ANYAH",0,2,0,1,2,0,1,0,1
"ANYELI",0,2,0,1,2,0,1,0,1
"APATHY",1,1,.5,.5,2,0,0,0,0
"APOLLON",2,0,1,0,2,1,0,1,0
"APRILIA",1,1,.5,.5,2,0,0,0,0
"AQ",2,0,1,0,2,1,0,1,0
"AQUINO",2,0,1,0,2,1,0,1,0
"ARACELLI",0,2,0,1,2,0,1,0,1
"ARAINA",0,2,0,1,2,0,1,0,1
"ARAL",2,0,1,0,2,1,0,1,0
"ARASELIS",0,2,0,1,2,0,1,0,1
"ARBNOR",2,0,1,0,2,1,0,1,0
"ARCHIL",2,0,1,0,2,1,0,1,0
"ARCHITECT",2,0,1,0,2,1,0,1,0
"ARDIN",2,0,1,0,2,1,0,1,0
"ARDLEY",2,0,1,0,2,1,0,1,0
"ARENA",1,1,.5,.5,2,0,0,0,0
"ARF",2,0,1,0,2,1,0,1,0
"ARGENY",2,0,1,0,2,1,0,1,0
"ARGIRIOS",2,0,1,0,2,1,0,1,0
"ARIAL",0,2,0,1,2,0,1,0,1
"ARIANY",0,2,0,1,2,0,1,0,1
"ARINJIT",2,0,1,0,2,1,0,1,0
"ARITRA",2,0,1,0,2,1,0,1,0
"ARK",2,0,1,0,2,1,0,1,0
"ARLAND",1,1,.5,.5,2,0,0,0,0
"ARLETA",0,2,0,1,2,0,1,0,1
"ARLETTY",0,2,0,1,2,0,1,0,1
"ARLY",0,2,0,1,2,0,1,0,1
"ARMELL",2,0,1,0,2,1,0,1,0
"AROONPORN",0,2,0,1,2,0,1,0,1
"ARQUIMEDES",2,0,1,0,2,1,0,1,0
"ARRY",1,1,.5,.5,2,0,0,0,0
"ARSHIYA",0,2,0,1,2,0,1,0,1
"ARSIM",2,0,1,0,2,1,0,1,0
"ARTAVIA",0,2,0,1,2,0,1,0,1
"ARTJOM",2,0,1,0,2,1,0,1,0
"ARUNE",2,0,1,0,2,1,0,1,0
"ARVA",0,2,0,1,2,0,1,0,1
"ASANKA",2,0,1,0,2,1,0,1,0
"ASANO",0,2,0,1,2,0,1,0,1
"ASARE",2,0,1,0,2,1,0,1,0
"ASFAND",2,0,1,0,2,1,0,1,0
"ASGER",2,0,1,0,2,1,0,1,0
"ASHANTA",1,1,.5,.5,2,0,0,0,0
"ASHEEN",1,1,.5,.5,2,0,0,0,0
"ASHELI",0,2,0,1,2,0,1,0,1
"ASHEY",1,1,.5,.5,2,0,0,0,0
"ASHIR",2,0,1,0,2,1,0,1,0
"ASHMIR",2,0,1,0,2,1,0,1,0
"ASHOKA",2,0,1,0,2,1,0,1,0
"ASHRAM",2,0,1,0,2,1,0,1,0
"ASSEN",2,0,1,0,2,1,0,1,0
"ASSISTANT",1,1,.5,.5,2,0,0,0,0
"ASWORTH",2,0,1,0,2,1,0,1,0
"ATABEX",0,2,0,1,2,0,1,0,1
"ATANISHA",0,2,0,1,2,0,1,0,1
"ATIANA",0,2,0,1,2,0,1,0,1
"ATIR",1,1,.5,.5,2,0,0,0,0
"ATLI",2,0,1,0,2,1,0,1,0
"ATOYA",0,2,0,1,2,0,1,0,1
"ATSUMI",0,2,0,1,2,0,1,0,1
"ATTIKA",1,1,.5,.5,2,0,0,0,0
"ATUM",2,0,1,0,2,1,0,1,0
"AUDEN",2,0,1,0,2,1,0,1,0
"AUDREE",0,2,0,1,2,0,1,0,1
"AUDRI",1,1,.5,.5,2,0,0,0,0
"AUDRIANA",0,2,0,1,2,0,1,0,1
"AULANA",0,2,0,1,2,0,1,0,1
"AUSTRALIA",0,2,0,1,2,0,1,0,1
"AUSTRIA",0,2,0,1,2,0,1,0,1
"AVANEEP",2,0,1,0,2,1,0,1,0
"AVEDIS",2,0,1,0,2,1,0,1,0
"AVERAGE",2,0,1,0,2,1,0,1,0
"AVIANCA",0,2,0,1,2,0,1,0,1
"AVICHAL",2,0,1,0,2,1,0,1,0
"AVID",2,0,1,0,2,1,0,1,0
"AVIE",1,1,.5,.5,2,0,0,0,0
"AVILES",2,0,1,0,2,1,0,1,0
"AVTANDIL",2,0,1,0,2,1,0,1,0
"AXA",0,2,0,1,2,0,1,0,1
"AXIOM",1,1,.5,.5,2,0,0,0,0
"AYIE",0,2,0,1,2,0,1,0,1
"AYM",2,0,1,0,2,1,0,1,0
"AYSIA",0,2,0,1,2,0,1,0,1
"AYTON",2,0,1,0,2,1,0,1,0
"AZELL",2,0,1,0,2,1,0,1,0
"AZEMINA",0,2,0,1,2,0,1,0,1
"AZFAR",2,0,1,0,2,1,0,1,0
"AZIKIWE",2,0,1,0,2,1,0,1,0
"AZZI",2,0,1,0,2,1,0,1,0
"BAADSHAH",2,0,1,0,2,1,0,1,0
"BACARDI",0,2,0,1,2,0,1,0,1
"BACARI",2,0,1,0,2,1,0,1,0
"BADIYA",0,2,0,1,2,0,1,0,1
"BADSHA",2,0,1,0,2,1,0,1,0
"BAKARY",2,0,1,0,2,1,0,1,0
"BAL",1,1,.5,.5,2,0,0,0,0
"BALBINO",2,0,1,0,2,1,0,1,0
"BALFOUR",2,0,1,0,2,1,0,1,0
"BALKRISHNA",2,0,1,0,2,1,0,1,0
"BALLA",2,0,1,0,2,1,0,1,0
"BAMBA",2,0,1,0,2,1,0,1,0
"BAMBU",2,0,1,0,2,1,0,1,0
"BANICA",2,0,1,0,2,1,0,1,0
"BANY",1,1,.5,.5,2,0,0,0,0
"BAPPI",2,0,1,0,2,1,0,1,0
"BARBEE",0,2,0,1,2,0,1,0,1
"BARD",2,0,1,0,2,1,0,1,0
"BARKEEM",2,0,1,0,2,1,0,1,0
"BARLOW",2,0,1,0,2,1,0,1,0
"BARRACK",2,0,1,0,2,1,0,1,0
"BARRETTE",1,1,.5,.5,2,0,0,0,0
"BARTJAN",2,0,1,0,2,1,0,1,0
"BARTLOMIEJ",2,0,1,0,2,1,0,1,0
"BARTOLOME",2,0,1,0,2,1,0,1,0
"BASANTA",2,0,1,0,2,1,0,1,0
"BASHIRA",0,2,0,1,2,0,1,0,1
"BASHMENT",1,1,.5,.5,2,0,0,0,0
"BASSIROU",2,0,1,0,2,1,0,1,0
"BASSO",2,0,1,0,2,1,0,1,0
"BEATON",2,0,1,0,2,1,0,1,0
"BEAUTI",0,2,0,1,2,0,1,0,1
"BECKLEY",1,1,.5,.5,2,0,0,0,0
"BEEBE",0,2,0,1,2,0,1,0,1
"BEHNAZ",0,2,0,1,2,0,1,0,1
"BEHROZ",2,0,1,0,2,1,0,1,0
"BELENDA",0,2,0,1,2,0,1,0,1
"BELYNDA",0,2,0,1,2,0,1,0,1
"BENGIE",2,0,1,0,2,1,0,1,0
"BENGT",2,0,1,0,2,1,0,1,0
"BENIAM",2,0,1,0,2,1,0,1,0
"BENO",2,0,1,0,2,1,0,1,0
"BENTE",0,2,0,1,2,0,1,0,1
"BENTHLY",1,1,.5,.5,2,0,0,0,0
"BEOWULF",2,0,1,0,2,1,0,1,0
"BERIC",2,0,1,0,2,1,0,1,0
"BERKCAN",2,0,1,0,2,1,0,1,0
"BERKIN",2,0,1,0,2,1,0,1,0
"BERLINE",0,2,0,1,2,0,1,0,1
"BERLY",0,2,0,1,2,0,1,0,1
"BERNABE",2,0,1,0,2,1,0,1,0
"BERNARDINE",0,2,0,1,2,0,1,0,1
"BERNELL",2,0,1,0,2,1,0,1,0
"BERNETTE",0,2,0,1,2,0,1,0,1
"BERNITA",0,2,0,1,2,0,1,0,1
"BERRADA",1,1,.5,.5,2,0,0,0,0
"BERTILIO",2,0,1,0,2,1,0,1,0
"BERTINE",0,2,0,1,2,0,1,0,1
"BERTRAN",2,0,1,0,2,1,0,1,0
"BESIK",2,0,1,0,2,1,0,1,0
"BET",0,2,0,1,2,0,1,0,1
"BETHAN",1,1,.5,.5,2,0,0,0,0
"BETHE",0,2,0,1,2,0,1,0,1
"BETHEA",2,0,1,0,2,1,0,1,0
"BETHINA",0,2,0,1,2,0,1,0,1
"BETTINNA",0,2,0,1,2,0,1,0,1
"BETTY-ANN",0,2,0,1,2,0,1,0,1
"BEY",1,1,.5,.5,2,0,0,0,0
"BHADRA",0,2,0,1,2,0,1,0,1
"BHOJ",2,0,1,0,2,1,0,1,0
"BHUSHAN",2,0,1,0,2,1,0,1,0
"BIANCHI",0,2,0,1,2,0,1,0,1
"BIBAI",1,1,.5,.5,2,0,0,0,0
"BIBBIN",2,0,1,0,2,1,0,1,0
"BIBY",0,2,0,1,2,0,1,0,1
"BIDISHA",0,2,0,1,2,0,1,0,1
"BIE",2,0,1,0,2,1,0,1,0
"BIGBAD",1,1,.5,.5,2,0,0,0,0
"BIGD",2,0,1,0,2,1,0,1,0
"BIJESH",2,0,1,0,2,1,0,1,0
"BIJLI",0,2,0,1,2,0,1,0,1
"BILQIS",0,2,0,1,2,0,1,0,1
"BINAYAK",2,0,1,0,2,1,0,1,0
"BINBIN",0,2,0,1,2,0,1,0,1
"BINDER",2,0,1,0,2,1,0,1,0
"BINIAM",2,0,1,0,2,1,0,1,0
"BINISH",1,1,.5,.5,2,0,0,0,0
"BINIT",2,0,1,0,2,1,0,1,0
"BIPASHA",0,2,0,1,2,0,1,0,1
"BIRCAN",0,2,0,1,2,0,1,0,1
"BIRMA",0,2,0,1,2,0,1,0,1
"BIRON",2,0,1,0,2,1,0,1,0
"BISER",2,0,1,0,2,1,0,1,0
"BISERA",0,2,0,1,2,0,1,0,1
"BISKIT",1,1,.5,.5,2,0,0,0,0
"BISMILLAH",2,0,1,0,2,1,0,1,0
"BITTA",0,2,0,1,2,0,1,0,1
"BITZ",2,0,1,0,2,1,0,1,0
"BIZNESS",2,0,1,0,2,1,0,1,0
"BJARNE",2,0,1,0,2,1,0,1,0
"BJAY",2,0,1,0,2,1,0,1,0
"BLAC",2,0,1,0,2,1,0,1,0
"BLACC",2,0,1,0,2,1,0,1,0
"BLAQUE",1,1,.5,.5,2,0,0,0,0
"BLERO",2,0,1,0,2,1,0,1,0
"BLIKSEM",1,1,.5,.5,2,0,0,0,0
"BMW",2,0,1,0,2,1,0,1,0
"BOANERGES",2,0,1,0,2,1,0,1,0
"BOATENG",1,1,.5,.5,2,0,0,0,0
"BOBBE",0,2,0,1,2,0,1,0,1
"BONGANI",2,0,1,0,2,1,0,1,0
"BONNER",2,0,1,0,2,1,0,1,0
"BONUS",1,1,.5,.5,2,0,0,0,0
"BOOGALOO",2,0,1,0,2,1,0,1,0
"BOOGZ",2,0,1,0,2,1,0,1,0
"BORIQUA",2,0,1,0,2,1,0,1,0
"BOSIE",2,0,1,0,2,1,0,1,0
"BOW",1,1,.5,.5,2,0,0,0,0
"BOYSIE",2,0,1,0,2,1,0,1,0
"BRACK",2,0,1,0,2,1,0,1,0
"BRADLEE",2,0,1,0,2,1,0,1,0
"BRADLY",2,0,1,0,2,1,0,1,0
"BRAN",1,1,.5,.5,2,0,0,0,0
"BRANIMIR",2,0,1,0,2,1,0,1,0
"BRANKICA",0,2,0,1,2,0,1,0,1
"BRASSERIE",1,1,.5,.5,2,0,0,0,0
"BRAUDY",1,1,.5,.5,2,0,0,0,0
"BRAVADO",2,0,1,0,2,1,0,1,0
"BRAVE",2,0,1,0,2,1,0,1,0
"BRAYDON",2,0,1,0,2,1,0,1,0
"BRED",2,0,1,0,2,1,0,1,0
"BREDDY",2,0,1,0,2,1,0,1,0
"BREEN",0,2,0,1,2,0,1,0,1
"BREFFNY",1,1,.5,.5,2,0,0,0,0
"BREI",0,2,0,1,2,0,1,0,1
"BRENDALY",0,2,0,1,2,0,1,0,1
"BRENNON",2,0,1,0,2,1,0,1,0
"BRIANI",0,2,0,1,2,0,1,0,1
"BRICKZ",2,0,1,0,2,1,0,1,0
"BRIDAL",0,2,0,1,2,0,1,0,1
"BRIDEY",0,2,0,1,2,0,1,0,1
"BRINSLEY",2,0,1,0,2,1,0,1,0
"BRISCOE",2,0,1,0,2,1,0,1,0
"BRISTI",0,2,0,1,2,0,1,0,1
"BRONYA",0,2,0,1,2,0,1,0,1
"BROW",2,0,1,0,2,1,0,1,0
"BRUCK",1,1,.5,.5,2,0,0,0,0
"BRUNETTE",0,2,0,1,2,0,1,0,1
"BRUNNIE",0,2,0,1,2,0,1,0,1
"BRUNY",0,2,0,1,2,0,1,0,1
"BRYCEN",2,0,1,0,2,1,0,1,0
"BRYONY",0,2,0,1,2,0,1,0,1
"BUBLY",0,2,0,1,2,0,1,0,1
"BUDD",2,0,1,0,2,1,0,1,0
"BUDDIE",1,1,.5,.5,2,0,0,0,0
"BUKA",1,1,.5,.5,2,0,0,0,0
"BUKKI",0,2,0,1,2,0,1,0,1
"BULAT",2,0,1,0,2,1,0,1,0
"BULLY",2,0,1,0,2,1,0,1,0
"BULUT",2,0,1,0,2,1,0,1,0
"BUMKYU",2,0,1,0,2,1,0,1,0
"BUONO",1,1,.5,.5,2,0,0,0,0
"BUTTERCUP",0,2,0,1,2,0,1,0,1
"BUTTERSCOTCH",0,2,0,1,2,0,1,0,1
"BUTTON",1,1,.5,.5,2,0,0,0,0
"BVILLE",2,0,1,0,2,1,0,1,0
"BÃœÅ_RA",0,2,0,1,2,0,1,0,1
"CACHO",2,0,1,0,2,1,0,1,0
"CADEEM",2,0,1,0,2,1,0,1,0
"CADET",2,0,1,0,2,1,0,1,0
"CAHEEM",2,0,1,0,2,1,0,1,0
"CAITLAN",0,2,0,1,2,0,1,0,1
"CALDEN",1,1,.5,.5,2,0,0,0,0
"CALICHE",2,0,1,0,2,1,0,1,0
"CALINE",0,2,0,1,2,0,1,0,1
"CALISE",0,2,0,1,2,0,1,0,1
"CALLEEN",0,2,0,1,2,0,1,0,1
"CALLOWAY",2,0,1,0,2,1,0,1,0
"CAMA",1,1,.5,.5,2,0,0,0,0
"CAMACHO",1,1,.5,.5,2,0,0,0,0
"CAMALA",0,2,0,1,2,0,1,0,1
"CAMEAL",0,2,0,1,2,0,1,0,1
"CAMIEL",0,2,0,1,2,0,1,0,1
"CANA",1,1,.5,.5,2,0,0,0,0
"CANAL",2,0,1,0,2,1,0,1,0
"CANT",1,1,.5,.5,2,0,0,0,0
"CAPOEIRA",2,0,1,0,2,1,0,1,0
"CAPPY",1,1,.5,.5,2,0,0,0,0
"CARABALLO",1,1,.5,.5,2,0,0,0,0
"CARENA",0,2,0,1,2,0,1,0,1
"CARL-JOHAN",2,0,1,0,2,1,0,1,0
"CARMELIA",0,2,0,1,2,0,1,0,1
"CARMENITA",0,2,0,1,2,0,1,0,1
"CARMENSITA",0,2,0,1,2,0,1,0,1
"CAROLEANN",0,2,0,1,2,0,1,0,1
"CAROLLYN",0,2,0,1,2,0,1,0,1
"CARPENTER",1,1,.5,.5,2,0,0,0,0
"CARTWRIGHT",2,0,1,0,2,1,0,1,0
"CASHA",0,2,0,1,2,0,1,0,1
"CASHFLOW",2,0,1,0,2,1,0,1,0
"CASIMIRO",2,0,1,0,2,1,0,1,0
"CASSIM",2,0,1,0,2,1,0,1,0
"CATCH",2,0,1,0,2,1,0,1,0
"CATHAY",0,2,0,1,2,0,1,0,1
"CATHY-JO",0,2,0,1,2,0,1,0,1
"CATLIN",1,1,.5,.5,2,0,0,0,0
"CATRINEL",0,2,0,1,2,0,1,0,1
"CATS",1,1,.5,.5,2,0,0,0,0
"CAUTION",1,1,.5,.5,2,0,0,0,0
"CAVITA",0,2,0,1,2,0,1,0,1
"CAYLEE",0,2,0,1,2,0,1,0,1
"CECEILIA",0,2,0,1,2,0,1,0,1
"CECILEY",0,2,0,1,2,0,1,0,1
"CEECE",1,1,.5,.5,2,0,0,0,0
"CEEZY",1,1,.5,.5,2,0,0,0,0
"CELITA",0,2,0,1,2,0,1,0,1
"CEMIL",2,0,1,0,2,1,0,1,0
"CENZA",0,2,0,1,2,0,1,0,1
"CERA",0,2,0,1,2,0,1,0,1
"CERWIN",2,0,1,0,2,1,0,1,0
"CESC",2,0,1,0,2,1,0,1,0
"CEVIN",2,0,1,0,2,1,0,1,0
"CHAIA",0,2,0,1,2,0,1,0,1
"CHAIKY",0,2,0,1,2,0,1,0,1
"CHAINA",0,2,0,1,2,0,1,0,1
"CHAKER",2,0,1,0,2,1,0,1,0
"CHAMELEON",0,2,0,1,2,0,1,0,1
"CHAMELLE",0,2,0,1,2,0,1,0,1
"CHAMIKA",1,1,.5,.5,2,0,0,0,0
"CHAMPA",1,1,.5,.5,2,0,0,0,0
"CHAMPAGNE",1,1,.5,.5,2,0,0,0,0
"CHAMPELL",1,1,.5,.5,2,0,0,0,0
"CHANAKA",2,0,1,0,2,1,0,1,0
"CHANDEL",1,1,.5,.5,2,0,0,0,0
"CHANDIRA",0,2,0,1,2,0,1,0,1
"CHANDRESH",2,0,1,0,2,1,0,1,0
"CHANEE",0,2,0,1,2,0,1,0,1
"CHANGCHANG",0,2,0,1,2,0,1,0,1
"CHANGHOON",2,0,1,0,2,1,0,1,0
"CHANON",1,1,.5,.5,2,0,0,0,0
"CHANTA",0,2,0,1,2,0,1,0,1
"CHANTESE",0,2,0,1,2,0,1,0,1
"CHAPELLE",1,1,.5,.5,2,0,0,0,0
"CHAREASE",0,2,0,1,2,0,1,0,1
"CHARILE",2,0,1,0,2,1,0,1,0
"CHARLANA",0,2,0,1,2,0,1,0,1
"CHARLOT",2,0,1,0,2,1,0,1,0
"CHARMELLE",0,2,0,1,2,0,1,0,1
"CHARNETTA",0,2,0,1,2,0,1,0,1
"CHARNICE",0,2,0,1,2,0,1,0,1
"CHAROD",2,0,1,0,2,1,0,1,0
"CHARWYN",2,0,1,0,2,1,0,1,0
"CHASEY",0,2,0,1,2,0,1,0,1
"CHATINA",0,2,0,1,2,0,1,0,1
"CHATMAN",1,1,.5,.5,2,0,0,0,0
"CHAVAH",1,1,.5,.5,2,0,0,0,0
"CHAVON",0,2,0,1,2,0,1,0,1
"CHAWANA",0,2,0,1,2,0,1,0,1
"CHAWN",1,1,.5,.5,2,0,0,0,0
"CHECHE",1,1,.5,.5,2,0,0,0,0
"CHEIK",2,0,1,0,2,1,0,1,0
"CHEKESHA",0,2,0,1,2,0,1,0,1
"CHEMA",1,1,.5,.5,2,0,0,0,0
"CHEMISE",0,2,0,1,2,0,1,0,1
"CHENEL",0,2,0,1,2,0,1,0,1
"CHENGHWA",1,1,.5,.5,2,0,0,0,0
"CHENGLONG",2,0,1,0,2,1,0,1,0
"CHENGQI",1,1,.5,.5,2,0,0,0,0
"CHENGWEI",2,0,1,0,2,1,0,1,0
"CHENGZHI",2,0,1,0,2,1,0,1,0
"CHENNELLE",1,1,.5,.5,2,0,0,0,0
"CHENTA",1,1,.5,.5,2,0,0,0,0
"CHENYANG",2,0,1,0,2,1,0,1,0
"CHEREE",0,2,0,1,2,0,1,0,1
"CHERIESE",0,2,0,1,2,0,1,0,1
"CHERRYLYN",0,2,0,1,2,0,1,0,1
"CHERUB",0,2,0,1,2,0,1,0,1
"CHETHAN",2,0,1,0,2,1,0,1,0
"CHEVAN",2,0,1,0,2,1,0,1,0
"CHEVAUGHN",1,1,.5,.5,2,0,0,0,0
"CHEVEL",0,2,0,1,2,0,1,0,1
"CHIBUIKE",2,0,1,0,2,1,0,1,0
"CHICKS",0,2,0,1,2,0,1,0,1
"CHICKY",1,1,.5,.5,2,0,0,0,0
"CHIKI",1,1,.5,.5,2,0,0,0,0
"CHILD",2,0,1,0,2,1,0,1,0
"CHINEDUM",2,0,1,0,2,1,0,1,0
"CHIRAAG",2,0,1,0,2,1,0,1,0
"CHISTY",2,0,1,0,2,1,0,1,0
"CHIVAS",2,0,1,0,2,1,0,1,0
"CHI-WAI",2,0,1,0,2,1,0,1,0
"CHIYONO",0,2,0,1,2,0,1,0,1
"CHOLA",1,1,.5,.5,2,0,0,0,0
"CHONY",1,1,.5,.5,2,0,0,0,0
"CHOO",2,0,1,0,2,1,0,1,0
"CHOU",0,2,0,1,2,0,1,0,1
"CHOYA",2,0,1,0,2,1,0,1,0
"CHRISANDRA",0,2,0,1,2,0,1,0,1
"CHRIS-ANN",0,2,0,1,2,0,1,0,1
"CHRISANTHI",0,2,0,1,2,0,1,0,1
"CHRISTIANAH",0,2,0,1,2,0,1,0,1
"CHRISTOPHOR",2,0,1,0,2,1,0,1,0
"CHRISTYLEZ",2,0,1,0,2,1,0,1,0
"CHRYSA",0,2,0,1,2,0,1,0,1
"CHRYSOULA",0,2,0,1,2,0,1,0,1
"CHRYSTOPHER",2,0,1,0,2,1,0,1,0
"CHUDE",0,2,0,1,2,0,1,0,1
"CHUKIE",2,0,1,0,2,1,0,1,0
"CHULETA",2,0,1,0,2,1,0,1,0
"CHUMLEY",2,0,1,0,2,1,0,1,0
"CHUNK",2,0,1,0,2,1,0,1,0
"CHUNKY",1,1,.5,.5,2,0,0,0,0
"CHURCHILL",2,0,1,0,2,1,0,1,0
"CHYME",0,2,0,1,2,0,1,0,1
"CHYNAH",0,2,0,1,2,0,1,0,1
"CIBELES",0,2,0,1,2,0,1,0,1
"CIBELI",0,2,0,1,2,0,1,0,1
"CIELITO",0,2,0,1,2,0,1,0,1
"CINDII",0,2,0,1,2,0,1,0,1
"CINDRA",0,2,0,1,2,0,1,0,1
"CINDYANN",0,2,0,1,2,0,1,0,1
"CINSERE",2,0,1,0,2,1,0,1,0
"CINTA",0,2,0,1,2,0,1,0,1
"CIPH",2,0,1,0,2,1,0,1,0
"CITYOF",2,0,1,0,2,1,0,1,0
"CIVIA",0,2,0,1,2,0,1,0,1
"CLARET",0,2,0,1,2,0,1,0,1
"CLARISE",0,2,0,1,2,0,1,0,1
"CLARISEL",0,2,0,1,2,0,1,0,1
"CLARO",2,0,1,0,2,1,0,1,0
"CLARYBEL",0,2,0,1,2,0,1,0,1
"CLAXTON",2,0,1,0,2,1,0,1,0
"CLEMENCIA",0,2,0,1,2,0,1,0,1
"CLETO",2,0,1,0,2,1,0,1,0
"CLEVEN",2,0,1,0,2,1,0,1,0
"CLICK",2,0,1,0,2,1,0,1,0
"CLORINA",0,2,0,1,2,0,1,0,1
"CLOVE",1,1,.5,.5,2,0,0,0,0
"CLUNY",1,1,.5,.5,2,0,0,0,0
"CLYVE",2,0,1,0,2,1,0,1,0
"COL",2,0,1,0,2,1,0,1,0
"COLA",0,2,0,1,2,0,1,0,1
"COLETTA",0,2,0,1,2,0,1,0,1
"COLINA",0,2,0,1,2,0,1,0,1
"COLSON",2,0,1,0,2,1,0,1,0
"COLYN",1,1,.5,.5,2,0,0,0,0
"COMET",2,0,1,0,2,1,0,1,0
"COMPREHENSIVE",1,1,.5,.5,2,0,0,0,0
"CONAL",2,0,1,0,2,1,0,1,0
"CONCHI",1,1,.5,.5,2,0,0,0,0
"CONROD",2,0,1,0,2,1,0,1,0
"CONSEJO",2,0,1,0,2,1,0,1,0
"CONTI",2,0,1,0,2,1,0,1,0
"CONYA",0,2,0,1,2,0,1,0,1
"COOLIE",2,0,1,0,2,1,0,1,0
"COPPER",2,0,1,0,2,1,0,1,0
"CORALY",0,2,0,1,2,0,1,0,1
"COREN",1,1,.5,.5,2,0,0,0,0
"CORKEY",2,0,1,0,2,1,0,1,0
"CORLIS",0,2,0,1,2,0,1,0,1
"CORTNEE",0,2,0,1,2,0,1,0,1
"COSSANDRA",0,2,0,1,2,0,1,0,1
"COSTANTINA",0,2,0,1,2,0,1,0,1
"COTTON",2,0,1,0,2,1,0,1,0
"COURTNE",1,1,.5,.5,2,0,0,0,0
"COVADONGA",0,2,0,1,2,0,1,0,1
"CRAIG-ANTHONY",2,0,1,0,2,1,0,1,0
"CRAMER",2,0,1,0,2,1,0,1,0
"CRAZII",0,2,0,1,2,0,1,0,1
"CRESENCIO",2,0,1,0,2,1,0,1,0
"CRISMELY",0,2,0,1,2,0,1,0,1
"CROOKED",2,0,1,0,2,1,0,1,0
"CROWNED",2,0,1,0,2,1,0,1,0
"CRYSTALLEE",0,2,0,1,2,0,1,0,1
"CUN",2,0,1,0,2,1,0,1,0
"CUNNEL",2,0,1,0,2,1,0,1,0
"CURIE",0,2,0,1,2,0,1,0,1
"CURLINE",0,2,0,1,2,0,1,0,1
"CURVIN",2,0,1,0,2,1,0,1,0
"CUT",1,1,.5,.5,2,0,0,0,0
"CVETELINA",0,2,0,1,2,0,1,0,1
"CW",2,0,1,0,2,1,0,1,0
"CYA",2,0,1,0,2,1,0,1,0
"CYPRESS",0,2,0,1,2,0,1,0,1
"CZARINNA",0,2,0,1,2,0,1,0,1
"DAAIYAH",0,2,0,1,2,0,1,0,1
"DABEIBA",0,2,0,1,2,0,1,0,1
"DACIAN",2,0,1,0,2,1,0,1,0
"DACY",1,1,.5,.5,2,0,0,0,0
"DAEKEUN",2,0,1,0,2,1,0,1,0
"DAHALIA",0,2,0,1,2,0,1,0,1
"DAHI",2,0,1,0,2,1,0,1,0
"DAHIANNA",0,2,0,1,2,0,1,0,1
"DAIAN",1,1,.5,.5,2,0,0,0,0
"DAIKI",2,0,1,0,2,1,0,1,0
"DAIONNE",0,2,0,1,2,0,1,0,1
"DAISAKU",2,0,1,0,2,1,0,1,0
"DAISEY",0,2,0,1,2,0,1,0,1
"DAISSY",0,2,0,1,2,0,1,0,1
"DAJA",0,2,0,1,2,0,1,0,1
"DAJUNG",0,2,0,1,2,0,1,0,1
"DAKAI",2,0,1,0,2,1,0,1,0
"DAKIN",2,0,1,0,2,1,0,1,0
"DALEEN",0,2,0,1,2,0,1,0,1
"DALISSA",0,2,0,1,2,0,1,0,1
"DALJEET",2,0,1,0,2,1,0,1,0
"DALLION",1,1,.5,.5,2,0,0,0,0
"DALWIN",2,0,1,0,2,1,0,1,0
"DAMA",1,1,.5,.5,2,0,0,0,0
"DAMAIN",2,0,1,0,2,1,0,1,0
"DAMEION",2,0,1,0,2,1,0,1,0
"DAMN",1,1,.5,.5,2,0,0,0,0
"DANDRIDGE",1,1,.5,.5,2,0,0,0,0
"DANELL",1,1,.5,.5,2,0,0,0,0
"DANESKA",0,2,0,1,2,0,1,0,1
"DANIELITO",2,0,1,0,2,1,0,1,0
"DANILDA",0,2,0,1,2,0,1,0,1
"DANILLE",0,2,0,1,2,0,1,0,1
"DANIZA",0,2,0,1,2,0,1,0,1
"DANTES",2,0,1,0,2,1,0,1,0
"DANTON",1,1,.5,.5,2,0,0,0,0
"DAQUANNA",0,2,0,1,2,0,1,0,1
"DAREE",0,2,0,1,2,0,1,0,1
"DARIAH",0,2,0,1,2,0,1,0,1
"DARIJA",0,2,0,1,2,0,1,0,1
"DARLENA",0,2,0,1,2,0,1,0,1
"DARLISA",0,2,0,1,2,0,1,0,1
"DARLY",1,1,.5,.5,2,0,0,0,0
"DARREIN",1,1,.5,.5,2,0,0,0,0
"DARSHINI",0,2,0,1,2,0,1,0,1
"DARTEL",2,0,1,0,2,1,0,1,0
"DARWEN",2,0,1,0,2,1,0,1,0
"DARYUS",2,0,1,0,2,1,0,1,0
"DASHER",2,0,1,0,2,1,0,1,0
"DAUGHTER",0,2,0,1,2,0,1,0,1
"DAVEEN",0,2,0,1,2,0,1,0,1
"DAVIES",2,0,1,0,2,1,0,1,0
"DAWNIE",0,2,0,1,2,0,1,0,1
"DAWOUD",2,0,1,0,2,1,0,1,0
"DAYANI",0,2,0,1,2,0,1,0,1
"DAYLENE",0,2,0,1,2,0,1,0,1
"DAYNELLE",0,2,0,1,2,0,1,0,1
"DAYNESHA",0,2,0,1,2,0,1,0,1
"DAYWON",2,0,1,0,2,1,0,1,0
"DAZ",2,0,1,0,2,1,0,1,0
"DAÅ A",0,2,0,1,2,0,1,0,1
"DEBABRATA",2,0,1,0,2,1,0,1,0
"DEBANJAN",2,0,1,0,2,1,0,1,0
"DEBARSHI",2,0,1,0,2,1,0,1,0
"DEBBEE",0,2,0,1,2,0,1,0,1
"DEBBIEANN",0,2,0,1,2,0,1,0,1
"DEC",1,1,.5,.5,2,0,0,0,0
"DEEKRON",2,0,1,0,2,1,0,1,0
"DEITRA",0,2,0,1,2,0,1,0,1
"DEJAH",0,2,0,1,2,0,1,0,1
"DELANCE",2,0,1,0,2,1,0,1,0
"DELANE",0,2,0,1,2,0,1,0,1
"DELBIS",2,0,1,0,2,1,0,1,0
"DELBY",2,0,1,0,2,1,0,1,0
"DELCENIA",0,2,0,1,2,0,1,0,1
"DELCIA",0,2,0,1,2,0,1,0,1
"DELISE",0,2,0,1,2,0,1,0,1
"DELKI",0,2,0,1,2,0,1,0,1
"DELLANIRA",0,2,0,1,2,0,1,0,1
"DELLIMORE",1,1,.5,.5,2,0,0,0,0
"DELLRE",0,2,0,1,2,0,1,0,1
"DELMER",2,0,1,0,2,1,0,1,0
"DELPHI",0,2,0,1,2,0,1,0,1
"DELSA",0,2,0,1,2,0,1,0,1
"DELU",1,1,.5,.5,2,0,0,0,0
"DELYA",0,2,0,1,2,0,1,0,1
"DEMETRE",2,0,1,0,2,1,0,1,0
"DEMITA",0,2,0,1,2,0,1,0,1
"DEMOSTHENES",2,0,1,0,2,1,0,1,0
"DEMS",2,0,1,0,2,1,0,1,0
"DENECIA",0,2,0,1,2,0,1,0,1
"DENEENE",0,2,0,1,2,0,1,0,1
"DENICA",0,2,0,1,2,0,1,0,1
"DENISLAV",2,0,1,0,2,1,0,1,0
"DENITRA",0,2,0,1,2,0,1,0,1
"DENNEY",1,1,.5,.5,2,0,0,0,0
"DENNISHA",0,2,0,1,2,0,1,0,1
"DENVILLE",2,0,1,0,2,1,0,1,0
"DEOLINDA",0,2,0,1,2,0,1,0,1
"DEREON",1,1,.5,.5,2,0,0,0,0
"DERVISH",2,0,1,0,2,1,0,1,0
"DERWYN",2,0,1,0,2,1,0,1,0
"DERYL",1,1,.5,.5,2,0,0,0,0
"DESDEMONA",0,2,0,1,2,0,1,0,1
"DESHAE",1,1,.5,.5,2,0,0,0,0
"DESHANNA",0,2,0,1,2,0,1,0,1
"DESMA",0,2,0,1,2,0,1,0,1
"DESMON",2,0,1,0,2,1,0,1,0
"DESMONIQUE",0,2,0,1,2,0,1,0,1
"DESOUZA",2,0,1,0,2,1,0,1,0
"DESTAN",2,0,1,0,2,1,0,1,0
"DETTY",0,2,0,1,2,0,1,0,1
"DEVASHISH",2,0,1,0,2,1,0,1,0
"DEVINN",2,0,1,0,2,1,0,1,0
"DEVLYN",1,1,.5,.5,2,0,0,0,0
"DEVONN",2,0,1,0,2,1,0,1,0
"DEVRIN",2,0,1,0,2,1,0,1,0
"DEW",0,2,0,1,2,0,1,0,1
"DEYON",2,0,1,0,2,1,0,1,0
"DEZO",2,0,1,0,2,1,0,1,0
"DEZZY",1,1,.5,.5,2,0,0,0,0
"DHAN",2,0,1,0,2,1,0,1,0
"DHANA",1,1,.5,.5,2,0,0,0,0
"DHANESH",2,0,1,0,2,1,0,1,0
"DHARMINDER",1,1,.5,.5,2,0,0,0,0
"DHARSHANA",2,0,1,0,2,1,0,1,0
"DHAWAL",2,0,1,0,2,1,0,1,0
"DHRUVI",0,2,0,1,2,0,1,0,1
"DHVANIL",2,0,1,0,2,1,0,1,0
"DHYAN",2,0,1,0,2,1,0,1,0
"DIAA",2,0,1,0,2,1,0,1,0
"DIAMONIQUE",0,2,0,1,2,0,1,0,1
"DIANDREA",0,2,0,1,2,0,1,0,1
"DIASIA",0,2,0,1,2,0,1,0,1
"DIGBY",2,0,1,0,2,1,0,1,0
"DILANI",0,2,0,1,2,0,1,0,1
"DILLI",1,1,.5,.5,2,0,0,0,0
"DILOVAR",2,0,1,0,2,1,0,1,0
"DILPREET",2,0,1,0,2,1,0,1,0
"DILSON",2,0,1,0,2,1,0,1,0
"DIMAN",2,0,1,0,2,1,0,1,0
"DIMITER",2,0,1,0,2,1,0,1,0
"DIMONA",0,2,0,1,2,0,1,0,1
"DINAMARIE",0,2,0,1,2,0,1,0,1
"DINC",2,0,1,0,2,1,0,1,0
"DINELIA",0,2,0,1,2,0,1,0,1
"DINIECE",0,2,0,1,2,0,1,0,1
"DINUSHA",2,0,1,0,2,1,0,1,0
"DIONEL",2,0,1,0,2,1,0,1,0
"DIOSELINA",0,2,0,1,2,0,1,0,1
"DIS",2,0,1,0,2,1,0,1,0
"DISMAS",2,0,1,0,2,1,0,1,0
"DITZA",0,2,0,1,2,0,1,0,1
"DIVAL",2,0,1,0,2,1,0,1,0
"DIZ",1,1,.5,.5,2,0,0,0,0
"DJAMILA",0,2,0,1,2,0,1,0,1
"DJEINA",0,2,0,1,2,0,1,0,1
"DJELI",2,0,1,0,2,1,0,1,0
"DJIBY",2,0,1,0,2,1,0,1,0
"DJO",2,0,1,0,2,1,0,1,0
"DJUNA",0,2,0,1,2,0,1,0,1
"DNA",1,1,.5,.5,2,0,0,0,0
"DOA",0,2,0,1,2,0,1,0,1
"DODGE",2,0,1,0,2,1,0,1,0
"DODIE",0,2,0,1,2,0,1,0,1
"DOINA",0,2,0,1,2,0,1,0,1
"DOLETHA",0,2,0,1,2,0,1,0,1
"DOLINA",0,2,0,1,2,0,1,0,1
"DOMAGOJ",2,0,1,0,2,1,0,1,0
"DOMINA",0,2,0,1,2,0,1,0,1
"DOMINICK-DANIEL",2,0,1,0,2,1,0,1,0
"DOMONIC",2,0,1,0,2,1,0,1,0
"DONCLARK",2,0,1,0,2,1,0,1,0
"DONDRE",2,0,1,0,2,1,0,1,0
"DONG-WOOK",2,0,1,0,2,1,0,1,0
"DONICE",0,2,0,1,2,0,1,0,1
"DONLYNN",2,0,1,0,2,1,0,1,0
"DONNE",0,2,0,1,2,0,1,0,1
"DONNER",1,1,.5,.5,2,0,0,0,0
"DONNET",0,2,0,1,2,0,1,0,1
"DONNICA",0,2,0,1,2,0,1,0,1
"DOOBIE",2,0,1,0,2,1,0,1,0
"DOPE",2,0,1,0,2,1,0,1,0
"DOREAN",0,2,0,1,2,0,1,0,1
"DORETHEA",0,2,0,1,2,0,1,0,1
"DORJAY",1,1,.5,.5,2,0,0,0,0
"DORLA",0,2,0,1,2,0,1,0,1
"DORTHY",0,2,0,1,2,0,1,0,1
"DORYNE",0,2,0,1,2,0,1,0,1
"DOS",2,0,1,0,2,1,0,1,0
"DOSHA",0,2,0,1,2,0,1,0,1
"DOTSIE",0,2,0,1,2,0,1,0,1
"DOUHA",0,2,0,1,2,0,1,0,1
"DOW",1,1,.5,.5,2,0,0,0,0
"DOZER",2,0,1,0,2,1,0,1,0
"DRAZEN",2,0,1,0,2,1,0,1,0
"DRENA",0,2,0,1,2,0,1,0,1
"DRIEA",0,2,0,1,2,0,1,0,1
"DRINK",1,1,.5,.5,2,0,0,0,0
"DRISANA",0,2,0,1,2,0,1,0,1
"DRISCOLL",2,0,1,0,2,1,0,1,0
"DROP",2,0,1,0,2,1,0,1,0
"DUCARMEL",2,0,1,0,2,1,0,1,0
"DUENDE",2,0,1,0,2,1,0,1,0
"DUGGINS",2,0,1,0,2,1,0,1,0
"DUKENS",2,0,1,0,2,1,0,1,0
"DUNKLEY",1,1,.5,.5,2,0,0,0,0
"DURREL",2,0,1,0,2,1,0,1,0
"DUSTAN",2,0,1,0,2,1,0,1,0
"DUYEN",0,2,0,1,2,0,1,0,1
"DWYANE",2,0,1,0,2,1,0,1,0
"DYMETRIUS",2,0,1,0,2,1,0,1,0
"DZEVAT",2,0,1,0,2,1,0,1,0
"EA",0,2,0,1,2,0,1,0,1
"EADAOIN",0,2,0,1,2,0,1,0,1
"EASTERN",1,1,.5,.5,2,0,0,0,0
"EASWAR",2,0,1,0,2,1,0,1,0
"EBO",0,2,0,1,2,0,1,0,1
"EDDER",2,0,1,0,2,1,0,1,0
"EDELYNE",0,2,0,1,2,0,1,0,1
"EDIK",2,0,1,0,2,1,0,1,0
"EDILMA",0,2,0,1,2,0,1,0,1
"EDIXON",2,0,1,0,2,1,0,1,0
"EDMAN",2,0,1,0,2,1,0,1,0
"EDRINA",0,2,0,1,2,0,1,0,1
"EDUCATED",2,0,1,0,2,1,0,1,0
"EDUVIGIS",0,2,0,1,2,0,1,0,1
"EDVIGE",0,2,0,1,2,0,1,0,1
"EFF",2,0,1,0,2,1,0,1,0
"EFTIHIA",0,2,0,1,2,0,1,0,1
"EGLANTINE",0,2,0,1,2,0,1,0,1
"EGRIS",1,1,.5,.5,2,0,0,0,0
"EIA",0,2,0,1,2,0,1,0,1
"EIDA",0,2,0,1,2,0,1,0,1
"EIDY",0,2,0,1,2,0,1,0,1
"EIZ",2,0,1,0,2,1,0,1,0
"EIZA",0,2,0,1,2,0,1,0,1
"EJIMA",1,1,.5,.5,2,0,0,0,0
"ELANGOVAN",2,0,1,0,2,1,0,1,0
"ELEASE",0,2,0,1,2,0,1,0,1
"ELEAZER",2,0,1,0,2,1,0,1,0
"ELEGANT",2,0,1,0,2,1,0,1,0
"ELETTRA",0,2,0,1,2,0,1,0,1
"ELEWIS",2,0,1,0,2,1,0,1,0
"ELFY",0,2,0,1,2,0,1,0,1
"ELGA",0,2,0,1,2,0,1,0,1
"ELICE",0,2,0,1,2,0,1,0,1
"ELIJHA",2,0,1,0,2,1,0,1,0
"ELISABETE",0,2,0,1,2,0,1,0,1
"ELISANGELA",0,2,0,1,2,0,1,0,1
"ELISAVETA",0,2,0,1,2,0,1,0,1
"ELISSE",0,2,0,1,2,0,1,0,1
"ELIU",2,0,1,0,2,1,0,1,0
"ELLENIA",0,2,0,1,2,0,1,0,1
"ELLINGSWORTH",2,0,1,0,2,1,0,1,0
"ELLISA",0,2,0,1,2,0,1,0,1
"ELLISSIA",0,2,0,1,2,0,1,0,1
"ELSIA",0,2,0,1,2,0,1,0,1
"ELSTON",2,0,1,0,2,1,0,1,0
"ELVIZ",2,0,1,0,2,1,0,1,0
"ELYSEE",0,2,0,1,2,0,1,0,1
"EMANOUIL",2,0,1,0,2,1,0,1,0
"EMANUELLA",0,2,0,1,2,0,1,0,1
"EMELINA",0,2,0,1,2,0,1,0,1
"EMERITO",2,0,1,0,2,1,0,1,0
"EMILIAN",2,0,1,0,2,1,0,1,0
"EMILIOS",2,0,1,0,2,1,0,1,0
"EMILSE",0,2,0,1,2,0,1,0,1
"EMILSEN",0,2,0,1,2,0,1,0,1
"EMILYA",0,2,0,1,2,0,1,0,1
"EMMALYN",0,2,0,1,2,0,1,0,1
"EMMIT",2,0,1,0,2,1,0,1,0
"EMOKE",0,2,0,1,2,0,1,0,1
"EMRULLAH",2,0,1,0,2,1,0,1,0
"EMSON",2,0,1,0,2,1,0,1,0
"ENDANG",0,2,0,1,2,0,1,0,1
"ENESSA",0,2,0,1,2,0,1,0,1
"ENILCE",0,2,0,1,2,0,1,0,1
"ENIXA",0,2,0,1,2,0,1,0,1
"ENYINNAYA",2,0,1,0,2,1,0,1,0
"EQUASIA",0,2,0,1,2,0,1,0,1
"ERAJ",1,1,.5,.5,2,0,0,0,0
"ERENDIRA",0,2,0,1,2,0,1,0,1
"ERINI",0,2,0,1,2,0,1,0,1
"ERISON",2,0,1,0,2,1,0,1,0
"ERLANDA",0,2,0,1,2,0,1,0,1
"ERMIAS",2,0,1,0,2,1,0,1,0
"ERMIRA",0,2,0,1,2,0,1,0,1
"ERNAD",2,0,1,0,2,1,0,1,0
"ERNYS",2,0,1,0,2,1,0,1,0
"ERSON",2,0,1,0,2,1,0,1,0
"ERVINE",1,1,.5,.5,2,0,0,0,0
"ESAT",2,0,1,0,2,1,0,1,0
"ESFIRA",0,2,0,1,2,0,1,0,1
"ESMIE",0,2,0,1,2,0,1,0,1
"ESMIN",2,0,1,0,2,1,0,1,0
"ESP",2,0,1,0,2,1,0,1,0
"ESSIET",2,0,1,0,2,1,0,1,0
"ESTARE",0,2,0,1,2,0,1,0,1
"ESYNCE",0,2,0,1,2,0,1,0,1
"ETELKA",0,2,0,1,2,0,1,0,1
"ETELLA",0,2,0,1,2,0,1,0,1
"ETHON",2,0,1,0,2,1,0,1,0
"ETINA",0,2,0,1,2,0,1,0,1
"ETO",2,0,1,0,2,1,0,1,0
"EUCLIDES",2,0,1,0,2,1,0,1,0
"EUDEL",2,0,1,0,2,1,0,1,0
"EUJIN",0,2,0,1,2,0,1,0,1
"EULAN",1,1,.5,.5,2,0,0,0,0
"EULIS",2,0,1,0,2,1,0,1,0
"EUNBEE",0,2,0,1,2,0,1,0,1
"EUNBI",0,2,0,1,2,0,1,0,1
"EUNMIN",1,1,.5,.5,2,0,0,0,0
"EVALUNA",0,2,0,1,2,0,1,0,1
"EVA-MARIE",0,2,0,1,2,0,1,0,1
"EVANGEL",1,1,.5,.5,2,0,0,0,0
"EVANNA",0,2,0,1,2,0,1,0,1
"EVANNE",0,2,0,1,2,0,1,0,1
"EVELEEN",0,2,0,1,2,0,1,0,1
"EVELYNN",0,2,0,1,2,0,1,0,1
"EVERET",2,0,1,0,2,1,0,1,0
"EVERICK",2,0,1,0,2,1,0,1,0
"EVERIN",1,1,.5,.5,2,0,0,0,0
"EVERLYNE",0,2,0,1,2,0,1,0,1
"EVERT",1,1,.5,.5,2,0,0,0,0
"EVIAN",1,1,.5,.5,2,0,0,0,0
"EVIMER",0,2,0,1,2,0,1,0,1
"EVOLUTION",1,1,.5,.5,2,0,0,0,0
"EVVON",1,1,.5,.5,2,0,0,0,0
"EWALD",2,0,1,0,2,1,0,1,0
"EWING",1,1,.5,.5,2,0,0,0,0
"EXCEL",2,0,1,0,2,1,0,1,0
"EXEL",2,0,1,0,2,1,0,1,0
"EXEQUIEL",2,0,1,0,2,1,0,1,0
"EXILUS",2,0,1,0,2,1,0,1,0
"EYES",2,0,1,0,2,1,0,1,0
"EYOB",2,0,1,0,2,1,0,1,0
"EYONNA",0,2,0,1,2,0,1,0,1
"EZECHIEL",2,0,1,0,2,1,0,1,0
"FABS",0,2,0,1,2,0,1,0,1
"FACELESS",1,1,.5,.5,2,0,0,0,0
"FADA",2,0,1,0,2,1,0,1,0
"FADILA",0,2,0,1,2,0,1,0,1
"FAH",0,2,0,1,2,0,1,0,1
"FAHID",2,0,1,0,2,1,0,1,0
"FAIRLIE",0,2,0,1,2,0,1,0,1
"FAKRUL",2,0,1,0,2,1,0,1,0
"FALENE",0,2,0,1,2,0,1,0,1
"FALY",1,1,.5,.5,2,0,0,0,0
"FALYN",0,2,0,1,2,0,1,0,1
"FALYNE",0,2,0,1,2,0,1,0,1
"FAM",1,1,.5,.5,2,0,0,0,0
"FANIE",1,1,.5,.5,2,0,0,0,0
"FANOR",2,0,1,0,2,1,0,1,0
"FAREEDA",0,2,0,1,2,0,1,0,1
"FARIDE",0,2,0,1,2,0,1,0,1
"FARIHAH",0,2,0,1,2,0,1,0,1
"FARRAD",2,0,1,0,2,1,0,1,0
"FATHI",2,0,1,0,2,1,0,1,0
"FATION",2,0,1,0,2,1,0,1,0
"FATMAWATI",0,2,0,1,2,0,1,0,1
"FATOUMATTA",0,2,0,1,2,0,1,0,1
"FATUMATA",0,2,0,1,2,0,1,0,1
"FAUN",1,1,.5,.5,2,0,0,0,0
"FAUSTIN",2,0,1,0,2,1,0,1,0
"FAUZIYA",0,2,0,1,2,0,1,0,1
"FAYA",0,2,0,1,2,0,1,0,1
"FAYAZ",2,0,1,0,2,1,0,1,0
"FAYETTE",0,2,0,1,2,0,1,0,1
"FAYGA",0,2,0,1,2,0,1,0,1
"FAZIER",0,2,0,1,2,0,1,0,1
"FAZINA",0,2,0,1,2,0,1,0,1
"FDNY",2,0,1,0,2,1,0,1,0
"FEATHER",0,2,0,1,2,0,1,0,1
"FEBY",1,1,.5,.5,2,0,0,0,0
"FEDE",1,1,.5,.5,2,0,0,0,0
"FEH",2,0,1,0,2,1,0,1,0
"FEIGI",0,2,0,1,2,0,1,0,1
"FELENE",0,2,0,1,2,0,1,0,1
"FELICIEN",2,0,1,0,2,1,0,1,0
"FENWAY",2,0,1,0,2,1,0,1,0
"FEQUIERE",1,1,.5,.5,2,0,0,0,0
"FERA",0,2,0,1,2,0,1,0,1
"FERAZ",2,0,1,0,2,1,0,1,0
"FERDANE",0,2,0,1,2,0,1,0,1
"FERESHTEH",0,2,0,1,2,0,1,0,1
"FERNAN",2,0,1,0,2,1,0,1,0
"FERNE",0,2,0,1,2,0,1,0,1
"FEROCIA",0,2,0,1,2,0,1,0,1
"FIDELA",0,2,0,1,2,0,1,0,1
"FIDELE",2,0,1,0,2,1,0,1,0
"FIDELMA",0,2,0,1,2,0,1,0,1
"FIDENCIA",0,2,0,1,2,0,1,0,1
"FIDIAS",1,1,.5,.5,2,0,0,0,0
"FIELDING",2,0,1,0,2,1,0,1,0
"FIKA",1,1,.5,.5,2,0,0,0,0
"FILBERT",2,0,1,0,2,1,0,1,0
"FIMA",2,0,1,0,2,1,0,1,0
"FINLAY",1,1,.5,.5,2,0,0,0,0
"FIORENZA",0,2,0,1,2,0,1,0,1
"FIRAN",2,0,1,0,2,1,0,1,0
"FIRAZ",2,0,1,0,2,1,0,1,0
"FIRUZEH",0,2,0,1,2,0,1,0,1
"FITO",2,0,1,0,2,1,0,1,0
"FIYA",1,1,.5,.5,2,0,0,0,0
"FLEMING",1,1,.5,.5,2,0,0,0,0
"FLEURETTE",0,2,0,1,2,0,1,0,1
"FLORALBA",0,2,0,1,2,0,1,0,1
"FLORDELIZ",0,2,0,1,2,0,1,0,1
"FLORENTIN",2,0,1,0,2,1,0,1,0
"FLORIM",2,0,1,0,2,1,0,1,0
"FLORRIE",0,2,0,1,2,0,1,0,1
"FLYBOI",2,0,1,0,2,1,0,1,0
"FLYNESS",2,0,1,0,2,1,0,1,0
"FOLABI",2,0,1,0,2,1,0,1,0
"FOLAYAN",1,1,.5,.5,2,0,0,0,0
"FOLKERT",2,0,1,0,2,1,0,1,0
"FONSECA",0,2,0,1,2,0,1,0,1
"FOOK",2,0,1,0,2,1,0,1,0
"FOUFA",1,1,.5,.5,2,0,0,0,0
"FOXIE",0,2,0,1,2,0,1,0,1
"FRADY",0,2,0,1,2,0,1,0,1
"FRANCELINE",0,2,0,1,2,0,1,0,1
"FRANCENA",0,2,0,1,2,0,1,0,1
"FRANCHELLY",1,1,.5,.5,2,0,0,0,0
"FRANCHESCO",2,0,1,0,2,1,0,1,0
"FRANSISCO",2,0,1,0,2,1,0,1,0
"FRANSISKUS",2,0,1,0,2,1,0,1,0
"FRANSUA",1,1,.5,.5,2,0,0,0,0
"FRANZI",0,2,0,1,2,0,1,0,1
"FRANZINE",0,2,0,1,2,0,1,0,1
"FREDE",1,1,.5,.5,2,0,0,0,0
"FREDERIKA",0,2,0,1,2,0,1,0,1
"FRESCA",0,2,0,1,2,0,1,0,1
"FRESCO",2,0,1,0,2,1,0,1,0
"FRIEDEL",1,1,.5,.5,2,0,0,0,0
"FRIEDERIKE",0,2,0,1,2,0,1,0,1
"FRING",1,1,.5,.5,2,0,0,0,0
"FRITH",1,1,.5,.5,2,0,0,0,0
"FRITZY",0,2,0,1,2,0,1,0,1
"FRONK",2,0,1,0,2,1,0,1,0
"FUCHSIA",0,2,0,1,2,0,1,0,1
"FULLY",0,2,0,1,2,0,1,0,1
"FUMIHIKO",2,0,1,0,2,1,0,1,0
"FUNMILAYO",0,2,0,1,2,0,1,0,1
"FURBY",1,1,.5,.5,2,0,0,0,0
"FURI",2,0,1,0,2,1,0,1,0
"FURNITURE",2,0,1,0,2,1,0,1,0
"FYODOR",2,0,1,0,2,1,0,1,0
"GABIE",0,2,0,1,2,0,1,0,1
"GABRIELL",0,2,0,1,2,0,1,0,1
"GAC",2,0,1,0,2,1,0,1,0
"GADDIEL",2,0,1,0,2,1,0,1,0
"GADY",1,1,.5,.5,2,0,0,0,0
"GAFAR",2,0,1,0,2,1,0,1,0
"GAILENE",0,2,0,1,2,0,1,0,1
"GAINES",2,0,1,0,2,1,0,1,0
"GAITRI",0,2,0,1,2,0,1,0,1
"GAITRIE",0,2,0,1,2,0,1,0,1
"GALILA",0,2,0,1,2,0,1,0,1
"GALILEO",1,1,.5,.5,2,0,0,0,0
"GALYN",0,2,0,1,2,0,1,0,1
"GAMALIER",2,0,1,0,2,1,0,1,0
"GANDOLFA",0,2,0,1,2,0,1,0,1
"GARADA",1,1,.5,.5,2,0,0,0,0
"GARIK",2,0,1,0,2,1,0,1,0
"GARNETTE",1,1,.5,.5,2,0,0,0,0
"GARRETH",2,0,1,0,2,1,0,1,0
"GARRETTE",2,0,1,0,2,1,0,1,0
"GARRIS",2,0,1,0,2,1,0,1,0
"GARSON",2,0,1,0,2,1,0,1,0
"GASHI",2,0,1,0,2,1,0,1,0
"GATE",2,0,1,0,2,1,0,1,0
"GAVO",2,0,1,0,2,1,0,1,0
"GAYANE",0,2,0,1,2,0,1,0,1
"GAZA",2,0,1,0,2,1,0,1,0
"GEAROID",2,0,1,0,2,1,0,1,0
"GEDDES",2,0,1,0,2,1,0,1,0
"GELINA",0,2,0,1,2,0,1,0,1
"GELISA",0,2,0,1,2,0,1,0,1
"GELO",2,0,1,0,2,1,0,1,0
"GELYA",0,2,0,1,2,0,1,0,1
"GENEE",0,2,0,1,2,0,1,0,1
"GENEISE",0,2,0,1,2,0,1,0,1
"GENERO",2,0,1,0,2,1,0,1,0
"GENETTE",0,2,0,1,2,0,1,0,1
"GENOVEVA",0,2,0,1,2,0,1,0,1
"GEOF",2,0,1,0,2,1,0,1,0
"GEOFREY",2,0,1,0,2,1,0,1,0
"GEORGANN",0,2,0,1,2,0,1,0,1
"GEORGIANN",0,2,0,1,2,0,1,0,1
"GERLANDO",2,0,1,0,2,1,0,1,0
"GERLINDE",0,2,0,1,2,0,1,0,1
"GERMEL",2,0,1,0,2,1,0,1,0
"GERTIE",0,2,0,1,2,0,1,0,1
"GERTY",0,2,0,1,2,0,1,0,1
"GESNER",2,0,1,0,2,1,0,1,0
"GEZEL",0,2,0,1,2,0,1,0,1
"GHAILE",0,2,0,1,2,0,1,0,1
"GIANINNA",0,2,0,1,2,0,1,0,1
"GIANNELLA",0,2,0,1,2,0,1,0,1
"GIAVANNA",0,2,0,1,2,0,1,0,1
"GIEFAAN",2,0,1,0,2,1,0,1,0
"GIEUN",0,2,0,1,2,0,1,0,1
"GIHO",2,0,1,0,2,1,0,1,0
"GILLIE",0,2,0,1,2,0,1,0,1
"GIMEL",2,0,1,0,2,1,0,1,0
"GINESSA",0,2,0,1,2,0,1,0,1
"GINNINE",0,2,0,1,2,0,1,0,1
"GINSBERG",1,1,.5,.5,2,0,0,0,0
"GINTAUTAS",2,0,1,0,2,1,0,1,0
"GIORGY",1,1,.5,.5,2,0,0,0,0
"GIOUX",2,0,1,0,2,1,0,1,0
"GIOVANNIA",0,2,0,1,2,0,1,0,1
"GIRA",0,2,0,1,2,0,1,0,1
"GIRIJA",0,2,0,1,2,0,1,0,1
"GISELLET",0,2,0,1,2,0,1,0,1
"GIWA",2,0,1,0,2,1,0,1,0
"GIZETTE",0,2,0,1,2,0,1,0,1
"GIZMO",2,0,1,0,2,1,0,1,0
"GLADIA",0,2,0,1,2,0,1,0,1
"GLAMARIS",0,2,0,1,2,0,1,0,1
"GLINDA",0,2,0,1,2,0,1,0,1
"GLOBE",1,1,.5,.5,2,0,0,0,0
"GLORIANN",0,2,0,1,2,0,1,0,1
"G-MONEY",2,0,1,0,2,1,0,1,0
"GODDES",0,2,0,1,2,0,1,0,1
"GODDY",2,0,1,0,2,1,0,1,0
"GODESS",0,2,0,1,2,0,1,0,1
"GOGY",2,0,1,0,2,1,0,1,0
"GOKAY",2,0,1,0,2,1,0,1,0
"GONEN",2,0,1,0,2,1,0,1,0
"GONI",2,0,1,0,2,1,0,1,0
"GORDO",2,0,1,0,2,1,0,1,0
"GOSSIIP",0,2,0,1,2,0,1,0,1
"GOTO",2,0,1,0,2,1,0,1,0
"GOUN",0,2,0,1,2,0,1,0,1
"GOVANNY",1,1,.5,.5,2,0,0,0,0
"GOVIN",2,0,1,0,2,1,0,1,0
"GRACELYNN",0,2,0,1,2,0,1,0,1
"GRAMPA",2,0,1,0,2,1,0,1,0
"GRANERO",1,1,.5,.5,2,0,0,0,0
"GRAVES",1,1,.5,.5,2,0,0,0,0
"GREGGY",2,0,1,0,2,1,0,1,0
"GREGROY",2,0,1,0,2,1,0,1,0
"GREN",2,0,1,0,2,1,0,1,0
"GRIGORIY",2,0,1,0,2,1,0,1,0
"GRILLO",1,1,.5,.5,2,0,0,0,0
"GRIND",1,1,.5,.5,2,0,0,0,0
"GRISELL",0,2,0,1,2,0,1,0,1
"GRU",0,2,0,1,2,0,1,0,1
"GUAPO",2,0,1,0,2,1,0,1,0
"GUENTER",2,0,1,0,2,1,0,1,0
"GUERSCHON",2,0,1,0,2,1,0,1,0
"GUESS",2,0,1,0,2,1,0,1,0
"GUGA",2,0,1,0,2,1,0,1,0
"GUGU",1,1,.5,.5,2,0,0,0,0
"GUILTY",2,0,1,0,2,1,0,1,0
"GUIYO",2,0,1,0,2,1,0,1,0
"GULHAN",1,1,.5,.5,2,0,0,0,0
"GULISTAN",0,2,0,1,2,0,1,0,1
"GULSHAN",0,2,0,1,2,0,1,0,1
"GUNILLA",0,2,0,1,2,0,1,0,1
"GUNN",2,0,1,0,2,1,0,1,0
"GUOXIN",2,0,1,0,2,1,0,1,0
"GURBIR",2,0,1,0,2,1,0,1,0
"GYAN",2,0,1,0,2,1,0,1,0
"GYORGY",2,0,1,0,2,1,0,1,0
"HABIBAH",0,2,0,1,2,0,1,0,1
"HABIBI",1,1,.5,.5,2,0,0,0,0
"HACER",0,2,0,1,2,0,1,0,1
"HACI",2,0,1,0,2,1,0,1,0
"HADASS",0,2,0,1,2,0,1,0,1
"HADDY",2,0,1,0,2,1,0,1,0
"HADER",2,0,1,0,2,1,0,1,0
"HADES",2,0,1,0,2,1,0,1,0
"HADIA",0,2,0,1,2,0,1,0,1
"HADIYA",0,2,0,1,2,0,1,0,1
"HAELIN",0,2,0,1,2,0,1,0,1
"HAIHONG",0,2,0,1,2,0,1,0,1
"HAILIE",0,2,0,1,2,0,1,0,1
"HAITI",2,0,1,0,2,1,0,1,0
"HAITIAN",2,0,1,0,2,1,0,1,0
"HAIYING",1,1,.5,.5,2,0,0,0,0
"HAIYUN",1,1,.5,.5,2,0,0,0,0
"HAJIN",2,0,1,0,2,1,0,1,0
"HAMEL",2,0,1,0,2,1,0,1,0
"HAMIDA",0,2,0,1,2,0,1,0,1
"HAMOUDA",2,0,1,0,2,1,0,1,0
"HANE",0,2,0,1,2,0,1,0,1
"HANEY",1,1,.5,.5,2,0,0,0,0
"HANIFF",2,0,1,0,2,1,0,1,0
"HANIN",0,2,0,1,2,0,1,0,1
"HANNELORE",0,2,0,1,2,0,1,0,1
"HANNIEL",1,1,.5,.5,2,0,0,0,0
"HANSER",2,0,1,0,2,1,0,1,0
"HANSI",0,2,0,1,2,0,1,0,1
"HANSIKA",0,2,0,1,2,0,1,0,1
"HANSY",2,0,1,0,2,1,0,1,0
"HAPP",1,1,.5,.5,2,0,0,0,0
"HARDEN",2,0,1,0,2,1,0,1,0
"HAREL",2,0,1,0,2,1,0,1,0
"HARJINDER",2,0,1,0,2,1,0,1,0
"HAROLDO",2,0,1,0,2,1,0,1,0
"HAROLYN",0,2,0,1,2,0,1,0,1
"HARPA",0,2,0,1,2,0,1,0,1
"HARPAL",2,0,1,0,2,1,0,1,0
"HARRIETTE",0,2,0,1,2,0,1,0,1
"HARSIMRAN",2,0,1,0,2,1,0,1,0
"HARVARD",2,0,1,0,2,1,0,1,0
"HARVEST",1,1,.5,.5,2,0,0,0,0
"HASSANA",0,2,0,1,2,0,1,0,1
"HATHOR",0,2,0,1,2,0,1,0,1
"HAUWA",0,2,0,1,2,0,1,0,1
"HAV",1,1,.5,.5,2,0,0,0,0
"HAXHI",2,0,1,0,2,1,0,1,0
"HAYASHI",0,2,0,1,2,0,1,0,1
"HAYATO",2,0,1,0,2,1,0,1,0
"HAYDAR",2,0,1,0,2,1,0,1,0
"HAYDEEN",2,0,1,0,2,1,0,1,0
"HAYDI",0,2,0,1,2,0,1,0,1
"HAYLE",1,1,.5,.5,2,0,0,0,0
"HAYMAN",2,0,1,0,2,1,0,1,0
"HEADS",2,0,1,0,2,1,0,1,0
"HEALING",0,2,0,1,2,0,1,0,1
"HEARD",1,1,.5,.5,2,0,0,0,0
"HEARNS",1,1,.5,.5,2,0,0,0,0
"HEDIEH",0,2,0,1,2,0,1,0,1
"HEEKYOUNG",0,2,0,1,2,0,1,0,1
"HEELS",1,1,.5,.5,2,0,0,0,0
"HEERAN",1,1,.5,.5,2,0,0,0,0
"HEIMY",0,2,0,1,2,0,1,0,1
"HEITOR",2,0,1,0,2,1,0,1,0
"HEIZAR",2,0,1,0,2,1,0,1,0
"HELAI",0,2,0,1,2,0,1,0,1
"HELEEN",0,2,0,1,2,0,1,0,1
"HELMA",0,2,0,1,2,0,1,0,1
"HEMDI",1,1,.5,.5,2,0,0,0,0
"HEMEN",2,0,1,0,2,1,0,1,0
"HEMI",2,0,1,0,2,1,0,1,0
"HENDARTA",2,0,1,0,2,1,0,1,0
"HENDI",2,0,1,0,2,1,0,1,0
"HENGKY",2,0,1,0,2,1,0,1,0
"HENLEY",1,1,.5,.5,2,0,0,0,0
"HENNESSEY",0,2,0,1,2,0,1,0,1
"HENY",2,0,1,0,2,1,0,1,0
"HENZ",2,0,1,0,2,1,0,1,0
"HERIK",2,0,1,0,2,1,0,1,0
"HERMENECK",2,0,1,0,2,1,0,1,0
"HERMIT",2,0,1,0,2,1,0,1,0
"HERSSON",2,0,1,0,2,1,0,1,0
"HESKY",2,0,1,0,2,1,0,1,0
"HIDEOUT",1,1,.5,.5,2,0,0,0,0
"HIDETO",2,0,1,0,2,1,0,1,0
"HIEDI",0,2,0,1,2,0,1,0,1
"HIGHEND",2,0,1,0,2,1,0,1,0
"HIJIRI",1,1,.5,.5,2,0,0,0,0
"HIKARI",0,2,0,1,2,0,1,0,1
"HILDEBRANDO",2,0,1,0,2,1,0,1,0
"HILDEGARDE",0,2,0,1,2,0,1,0,1
"HILI",0,2,0,1,2,0,1,0,1
"HILLI",0,2,0,1,2,0,1,0,1
"HIMALAYAN",1,1,.5,.5,2,0,0,0,0
"HIMI",1,1,.5,.5,2,0,0,0,0
"HIROE",0,2,0,1,2,0,1,0,1
"HIROFUMI",2,0,1,0,2,1,0,1,0
"HIROYO",0,2,0,1,2,0,1,0,1
"HISAKI",2,0,1,0,2,1,0,1,0
"HODGES",2,0,1,0,2,1,0,1,0
"HOFIT",0,2,0,1,2,0,1,0,1
"HOJUN",2,0,1,0,2,1,0,1,0
"HOLANDA",0,2,0,1,2,0,1,0,1
"HOLDIN",2,0,1,0,2,1,0,1,0
"HOLLDEN",2,0,1,0,2,1,0,1,0
"HOLLYANN",0,2,0,1,2,0,1,0,1
"HOMAN",2,0,1,0,2,1,0,1,0
"HONEYLET",0,2,0,1,2,0,1,0,1
"HONGFENG",1,1,.5,.5,2,0,0,0,0
"HONGTAO",2,0,1,0,2,1,0,1,0
"HONORABLE",2,0,1,0,2,1,0,1,0
"HOONEY",1,1,.5,.5,2,0,0,0,0
"HORIA",2,0,1,0,2,1,0,1,0
"HOSEIN",2,0,1,0,2,1,0,1,0
"HOWL",2,0,1,0,2,1,0,1,0
"HRANT",2,0,1,0,2,1,0,1,0
"HRVOJE",2,0,1,0,2,1,0,1,0
"HUD",2,0,1,0,2,1,0,1,0
"HUIHUI",0,2,0,1,2,0,1,0,1
"HUIPING",1,1,.5,.5,2,0,0,0,0
"HUIYI",0,2,0,1,2,0,1,0,1
"HUM",2,0,1,0,2,1,0,1,0
"HUMAIR",2,0,1,0,2,1,0,1,0
"HUMERA",0,2,0,1,2,0,1,0,1
"HUMMUS",2,0,1,0,2,1,0,1,0
"HUO",2,0,1,0,2,1,0,1,0
"HUSO",2,0,1,0,2,1,0,1,0
"HUSSIÃ‰N",2,0,1,0,2,1,0,1,0
"HUXLEY",2,0,1,0,2,1,0,1,0
"HYBRID",2,0,1,0,2,1,0,1,0
"HYELIM",0,2,0,1,2,0,1,0,1
"HYOMIN",1,1,.5,.5,2,0,0,0,0
"HYORI",0,2,0,1,2,0,1,0,1
"HYOSUN",0,2,0,1,2,0,1,0,1
"HYPNO",2,0,1,0,2,1,0,1,0
"HYPNOTIC",2,0,1,0,2,1,0,1,0
"HYUNJU",0,2,0,1,2,0,1,0,1
"HYUN-JU",0,2,0,1,2,0,1,0,1
"HYUNNIE",0,2,0,1,2,0,1,0,1
"HYUNYOUNG",0,2,0,1,2,0,1,0,1
"IANCU",2,0,1,0,2,1,0,1,0
"IANNIS",2,0,1,0,2,1,0,1,0
"IASHIA",0,2,0,1,2,0,1,0,1
"IBE",1,1,.5,.5,2,0,0,0,0
"IBEL",0,2,0,1,2,0,1,0,1
"IBELKA",0,2,0,1,2,0,1,0,1
"IBRAGIMOV",2,0,1,0,2,1,0,1,0
"ICEL",0,2,0,1,2,0,1,0,1
"ICILMA",0,2,0,1,2,0,1,0,1
"ICKY",1,1,.5,.5,2,0,0,0,0
"IDALINA",0,2,0,1,2,0,1,0,1
"IDALMY",0,2,0,1,2,0,1,0,1
"IDINA",0,2,0,1,2,0,1,0,1
"IDONGESIT",0,2,0,1,2,0,1,0,1
"IDRIYS",2,0,1,0,2,1,0,1,0
"IESUS",2,0,1,0,2,1,0,1,0
"IFIGENEIA",0,2,0,1,2,0,1,0,1
"IFOMA",1,1,.5,.5,2,0,0,0,0
"IFRAH",0,2,0,1,2,0,1,0,1
"IHOR",2,0,1,0,2,1,0,1,0
"IHSAAN",2,0,1,0,2,1,0,1,0
"IJ",0,2,0,1,2,0,1,0,1
"IKESHA",0,2,0,1,2,0,1,0,1
"IKIDA",0,2,0,1,2,0,1,0,1
"IKRAN",0,2,0,1,2,0,1,0,1
"IKUE",0,2,0,1,2,0,1,0,1
"IKUMI",1,1,.5,.5,2,0,0,0,0
"ILDE",1,1,.5,.5,2,0,0,0,0
"ILDEFONSO",2,0,1,0,2,1,0,1,0
"ILU",2,0,1,0,2,1,0,1,0
"IMARA",0,2,0,1,2,0,1,0,1
"IMAT",2,0,1,0,2,1,0,1,0
"IMEL",1,1,.5,.5,2,0,0,0,0
"IMHOTEP",2,0,1,0,2,1,0,1,0
"IMMACULA",0,2,0,1,2,0,1,0,1
"IMRAAN",2,0,1,0,2,1,0,1,0
"IMRUL",2,0,1,0,2,1,0,1,0
"INAS",0,2,0,1,2,0,1,0,1
"INAYA",0,2,0,1,2,0,1,0,1
"INDERA",0,2,0,1,2,0,1,0,1
"INDO",1,1,.5,.5,2,0,0,0,0
"INDRAJEET",2,0,1,0,2,1,0,1,0
"INDRIA",0,2,0,1,2,0,1,0,1
"INGRY",0,2,0,1,2,0,1,0,1
"INKED",2,0,1,0,2,1,0,1,0
"INKYU",2,0,1,0,2,1,0,1,0
"INMACULADA",0,2,0,1,2,0,1,0,1
"INSAN",2,0,1,0,2,1,0,1,0
"INSHA",0,2,0,1,2,0,1,0,1
"INSHAN",2,0,1,0,2,1,0,1,0
"INSPECTAH",2,0,1,0,2,1,0,1,0
"INTRO",2,0,1,0,2,1,0,1,0
"INU",1,1,.5,.5,2,0,0,0,0
"IO",0,2,0,1,2,0,1,0,1
"IOAN",2,0,1,0,2,1,0,1,0
"IOLA",0,2,0,1,2,0,1,0,1
"IRENES",0,2,0,1,2,0,1,0,1
"IRLANDA",0,2,0,1,2,0,1,0,1
"IRONELYS",0,2,0,1,2,0,1,0,1
"IRWAN",2,0,1,0,2,1,0,1,0
"ISIDOR",2,0,1,0,2,1,0,1,0
"ISMAY",0,2,0,1,2,0,1,0,1
"ISMENIA",0,2,0,1,2,0,1,0,1
"ISOLDE",0,2,0,1,2,0,1,0,1
"ISSACHAR",1,1,.5,.5,2,0,0,0,0
"ISY",0,2,0,1,2,0,1,0,1
"ITSIK",2,0,1,0,2,1,0,1,0
"IVELIN",2,0,1,0,2,1,0,1,0
"IVELISA",0,2,0,1,2,0,1,0,1
"IVERSON",2,0,1,0,2,1,0,1,0
"IVIN",2,0,1,0,2,1,0,1,0
"IVYS",0,2,0,1,2,0,1,0,1
"IYKE",2,0,1,0,2,1,0,1,0
"IZOLA",0,2,0,1,2,0,1,0,1
"IZORA",0,2,0,1,2,0,1,0,1
"IZY",2,0,1,0,2,1,0,1,0
"JAANA",0,2,0,1,2,0,1,0,1
"JABBER",1,1,.5,.5,2,0,0,0,0
"JACC",2,0,1,0,2,1,0,1,0
"JACELYN",0,2,0,1,2,0,1,0,1
"JACENTA",0,2,0,1,2,0,1,0,1
"JACINTHA",0,2,0,1,2,0,1,0,1
"JACINTHE",0,2,0,1,2,0,1,0,1
"JACKE",1,1,.5,.5,2,0,0,0,0
"JACLENE",0,2,0,1,2,0,1,0,1
"JACORY",2,0,1,0,2,1,0,1,0
"JADDA",2,0,1,0,2,1,0,1,0
"JADEL",0,2,0,1,2,0,1,0,1
"JAEKYUNG",2,0,1,0,2,1,0,1,0
"JAEO",2,0,1,0,2,1,0,1,0
"JAFRIN",0,2,0,1,2,0,1,0,1
"JAGADEESH",2,0,1,0,2,1,0,1,0
"JAGADISH",2,0,1,0,2,1,0,1,0
"JAGDIP",2,0,1,0,2,1,0,1,0
"JAGDISH",2,0,1,0,2,1,0,1,0
"JAHAAD",2,0,1,0,2,1,0,1,0
"JAHAIDA",0,2,0,1,2,0,1,0,1
"JAH-KAYIA",0,2,0,1,2,0,1,0,1
"JAHMANI",1,1,.5,.5,2,0,0,0,0
"JAHMEEL",2,0,1,0,2,1,0,1,0
"JAHNETTE",0,2,0,1,2,0,1,0,1
"JAHQUAN",2,0,1,0,2,1,0,1,0
"JAHRED",2,0,1,0,2,1,0,1,0
"JAHRON",2,0,1,0,2,1,0,1,0
"JAIDEV",2,0,1,0,2,1,0,1,0
"JAINABA",0,2,0,1,2,0,1,0,1
"JAINARINE",2,0,1,0,2,1,0,1,0
"JAIPAL",2,0,1,0,2,1,0,1,0
"JAIS",2,0,1,0,2,1,0,1,0
"JAJUAN",2,0,1,0,2,1,0,1,0
"JAKEA",0,2,0,1,2,0,1,0,1
"JAKIE",0,2,0,1,2,0,1,0,1
"JALANDA",0,2,0,1,2,0,1,0,1
"JALANE",1,1,.5,.5,2,0,0,0,0
"JALANI",2,0,1,0,2,1,0,1,0
"JALEELA",0,2,0,1,2,0,1,0,1
"JALIZA",0,2,0,1,2,0,1,0,1
"JALLOH",2,0,1,0,2,1,0,1,0
"JALPA",0,2,0,1,2,0,1,0,1
"JAMAEL",2,0,1,0,2,1,0,1,0
"JAMEEK",2,0,1,0,2,1,0,1,0
"JAMEEN",1,1,.5,.5,2,0,0,0,0
"JAMEILA",0,2,0,1,2,0,1,0,1
"JAMELE",2,0,1,0,2,1,0,1,0
"JAMESS",2,0,1,0,2,1,0,1,0
"JAMIEANN",0,2,0,1,2,0,1,0,1
"JAMIELA",0,2,0,1,2,0,1,0,1
"JAMIEY",0,2,0,1,2,0,1,0,1
"JAMIK",2,0,1,0,2,1,0,1,0
"JAMILL",1,1,.5,.5,2,0,0,0,0
"JAMIRA",0,2,0,1,2,0,1,0,1
"JANAINE",0,2,0,1,2,0,1,0,1
"JANEK",2,0,1,0,2,1,0,1,0
"JANELLI",0,2,0,1,2,0,1,0,1
"JANELY",0,2,0,1,2,0,1,0,1
"JANERA",0,2,0,1,2,0,1,0,1
"JANICELYN",0,2,0,1,2,0,1,0,1
"JANIKA",0,2,0,1,2,0,1,0,1
"JANISSE",0,2,0,1,2,0,1,0,1
"JANNEH",1,1,.5,.5,2,0,0,0,0
"JAQUANN",2,0,1,0,2,1,0,1,0
"JAQUELINA",0,2,0,1,2,0,1,0,1
"JAQUES",2,0,1,0,2,1,0,1,0
"JARDINE",1,1,.5,.5,2,0,0,0,0
"JARENA",0,2,0,1,2,0,1,0,1
"JARICE",2,0,1,0,2,1,0,1,0
"JARRON",2,0,1,0,2,1,0,1,0
"JASHAWN",2,0,1,0,2,1,0,1,0
"JASHIN",0,2,0,1,2,0,1,0,1
"JASICA",0,2,0,1,2,0,1,0,1
"JASIRY",0,2,0,1,2,0,1,0,1
"JASON-MICHAEL",2,0,1,0,2,1,0,1,0
"JASSIN",2,0,1,0,2,1,0,1,0
"JASSY",0,2,0,1,2,0,1,0,1
"JAVAIRIA",0,2,0,1,2,0,1,0,1
"JAVAR",2,0,1,0,2,1,0,1,0
"JAVE",1,1,.5,.5,2,0,0,0,0
"JAVETTE",0,2,0,1,2,0,1,0,1
"JAVIEL",2,0,1,0,2,1,0,1,0
"JAWA",1,1,.5,.5,2,0,0,0,0
"JAWAN",2,0,1,0,2,1,0,1,0
"JAWANN",2,0,1,0,2,1,0,1,0
"JAYAN",2,0,1,0,2,1,0,1,0
"JAYASRI",0,2,0,1,2,0,1,0,1
"JAYH",1,1,.5,.5,2,0,0,0,0
"JAYJ",2,0,1,0,2,1,0,1,0
"JAYO",2,0,1,0,2,1,0,1,0
"JAYR",2,0,1,0,2,1,0,1,0
"JAY-Z",2,0,1,0,2,1,0,1,0
"JAZLINE",0,2,0,1,2,0,1,0,1
"JAZZEE",1,1,.5,.5,2,0,0,0,0
"JEA",2,0,1,0,2,1,0,1,0
"JEANDARCEL",2,0,1,0,2,1,0,1,0
"JEANEEN",0,2,0,1,2,0,1,0,1
"JEANELL",0,2,0,1,2,0,1,0,1
"JEANELLA",0,2,0,1,2,0,1,0,1
"JEANNETTA",0,2,0,1,2,0,1,0,1
"JEANO",2,0,1,0,2,1,0,1,0
"JECA",0,2,0,1,2,0,1,0,1
"JEDA",1,1,.5,.5,2,0,0,0,0
"JEEMIN",1,1,.5,.5,2,0,0,0,0
"JEENO",2,0,1,0,2,1,0,1,0
"JEFFER",2,0,1,0,2,1,0,1,0
"JEFFERS",2,0,1,0,2,1,0,1,0
"JENDY",1,1,.5,.5,2,0,0,0,0
"JENET",0,2,0,1,2,0,1,0,1
"JENJIRA",0,2,0,1,2,0,1,0,1
"JENNEE",0,2,0,1,2,0,1,0,1
"JENNEH",0,2,0,1,2,0,1,0,1
"JENNIECE",0,2,0,1,2,0,1,0,1
"JENNILEE",0,2,0,1,2,0,1,0,1
"JENNIQUE",0,2,0,1,2,0,1,0,1
"JENNISE",0,2,0,1,2,0,1,0,1
"JENNIVA",0,2,0,1,2,0,1,0,1
"JENRY",2,0,1,0,2,1,0,1,0
"JEO",1,1,.5,.5,2,0,0,0,0
"JEONGHEE",2,0,1,0,2,1,0,1,0
"JEOVANNY",2,0,1,0,2,1,0,1,0
"JEPHTE",2,0,1,0,2,1,0,1,0
"JERAMI",2,0,1,0,2,1,0,1,0
"JEREME",2,0,1,0,2,1,0,1,0
"JEREMEY",2,0,1,0,2,1,0,1,0
"JERIMIAH",2,0,1,0,2,1,0,1,0
"JERINE",0,2,0,1,2,0,1,0,1
"JERM",2,0,1,0,2,1,0,1,0
"JERMELL",1,1,.5,.5,2,0,0,0,0
"JERMYN",2,0,1,0,2,1,0,1,0
"JERRAH",1,1,.5,.5,2,0,0,0,0
"JERRARD",2,0,1,0,2,1,0,1,0
"JERVE",2,0,1,0,2,1,0,1,0
"JESCA",0,2,0,1,2,0,1,0,1
"JESHER",1,1,.5,.5,2,0,0,0,0
"JESMY",0,2,0,1,2,0,1,0,1
"JESSANN",0,2,0,1,2,0,1,0,1
"JESSEE",0,2,0,1,2,0,1,0,1
"JESSELLE",0,2,0,1,2,0,1,0,1
"JESSICA-",0,2,0,1,2,0,1,0,1
"JESSII",0,2,0,1,2,0,1,0,1
"JESTYN",2,0,1,0,2,1,0,1,0
"JESUSITA",0,2,0,1,2,0,1,0,1
"JETTINA",0,2,0,1,2,0,1,0,1
"JEXSENIA",0,2,0,1,2,0,1,0,1
"JHOVANA",0,2,0,1,2,0,1,0,1
"JIAJUN",2,0,1,0,2,1,0,1,0
"JIAMING",2,0,1,0,2,1,0,1,0
"JIAQI",1,1,.5,.5,2,0,0,0,0
"JIA-YI",1,1,.5,.5,2,0,0,0,0
"JIAYIN",0,2,0,1,2,0,1,0,1
"JIBRAIL",2,0,1,0,2,1,0,1,0
"JIBREEL",2,0,1,0,2,1,0,1,0
"JIBRIL",2,0,1,0,2,1,0,1,0
"JIGISHA",0,2,0,1,2,0,1,0,1
"JIJO",2,0,1,0,2,1,0,1,0
"JILLA",0,2,0,1,2,0,1,0,1
"JILLIANA",0,2,0,1,2,0,1,0,1
"JILYAN",0,2,0,1,2,0,1,0,1
"JIMOND",2,0,1,0,2,1,0,1,0
"JIMS",2,0,1,0,2,1,0,1,0
"JINBIN",1,1,.5,.5,2,0,0,0,0
"JINETT",0,2,0,1,2,0,1,0,1
"JINGJIN",0,2,0,1,2,0,1,0,1
"JINHONG",2,0,1,0,2,1,0,1,0
"JINHUA",1,1,.5,.5,2,0,0,0,0
"JIONG",2,0,1,0,2,1,0,1,0
"JIOVANNY",2,0,1,0,2,1,0,1,0
"JISSELLE",0,2,0,1,2,0,1,0,1
"JITTO",1,1,.5,.5,2,0,0,0,0
"JIYANG",1,1,.5,.5,2,0,0,0,0
"JIYEA",0,2,0,1,2,0,1,0,1
"JIYOUN",0,2,0,1,2,0,1,0,1
"JIZELLE",0,2,0,1,2,0,1,0,1
"JO-ANA",0,2,0,1,2,0,1,0,1
"JOCABED",0,2,0,1,2,0,1,0,1
"JOCKO",2,0,1,0,2,1,0,1,0
"JOE-JOE",2,0,1,0,2,1,0,1,0
"JOFRE",2,0,1,0,2,1,0,1,0
"JOGY",2,0,1,0,2,1,0,1,0
"JOH",1,1,.5,.5,2,0,0,0,0
"JOHAIRA",0,2,0,1,2,0,1,0,1
"JOHAM",2,0,1,0,2,1,0,1,0
"JOHANSSON",1,1,.5,.5,2,0,0,0,0
"JOHHNY",2,0,1,0,2,1,0,1,0
"JOHNATAN",2,0,1,0,2,1,0,1,0
"JOHNS",2,0,1,0,2,1,0,1,0
"JOJIE",0,2,0,1,2,0,1,0,1
"JOKING",1,1,.5,.5,2,0,0,0,0
"JOLEAN",0,2,0,1,2,0,1,0,1
"JOLINDA",0,2,0,1,2,0,1,0,1
"JOLIVIA",0,2,0,1,2,0,1,0,1
"JOMAIRA",0,2,0,1,2,0,1,0,1
"JOMAL",2,0,1,0,2,1,0,1,0
"JOMY",0,2,0,1,2,0,1,0,1
"JONAR",2,0,1,0,2,1,0,1,0
"JONBOY",2,0,1,0,2,1,0,1,0
"JONCARLO",2,0,1,0,2,1,0,1,0
"JONGWOO",2,0,1,0,2,1,0,1,0
"JONH",1,1,.5,.5,2,0,0,0,0
"JONIECE",0,2,0,1,2,0,1,0,1
"JON-MARC",2,0,1,0,2,1,0,1,0
"JONMICHAEL",2,0,1,0,2,1,0,1,0
"JONNELL",1,1,.5,.5,2,0,0,0,0
"JONNEY",2,0,1,0,2,1,0,1,0
"JOOIN",0,2,0,1,2,0,1,0,1
"JOONSANG",2,0,1,0,2,1,0,1,0
"JOOYONG",1,1,.5,.5,2,0,0,0,0
"JOOYOUN",0,2,0,1,2,0,1,0,1
"JORDAE",0,2,0,1,2,0,1,0,1
"JORDANE",0,2,0,1,2,0,1,0,1
"JORDANI",1,1,.5,.5,2,0,0,0,0
"JORDANIA",0,2,0,1,2,0,1,0,1
"JORDIN",0,2,0,1,2,0,1,0,1
"JORGY",2,0,1,0,2,1,0,1,0
"JORJE",2,0,1,0,2,1,0,1,0
"JOSE-LUIS",2,0,1,0,2,1,0,1,0
"JOSIA",1,1,.5,.5,2,0,0,0,0
"JOSSETTE",0,2,0,1,2,0,1,0,1
"JOTHAM",2,0,1,0,2,1,0,1,0
"JOUNG",1,1,.5,.5,2,0,0,0,0
"JOVA",2,0,1,0,2,1,0,1,0
"JOVAUN",2,0,1,0,2,1,0,1,0
"JOVIAN",2,0,1,0,2,1,0,1,0
"JOVINA",0,2,0,1,2,0,1,0,1
"JOWEL",1,1,.5,.5,2,0,0,0,0
"JOYETTE",0,2,0,1,2,0,1,0,1
"JOYNER",2,0,1,0,2,1,0,1,0
"JOZI",0,2,0,1,2,0,1,0,1
"JOZY",0,2,0,1,2,0,1,0,1
"JUA",1,1,.5,.5,2,0,0,0,0
"JUANDA",1,1,.5,.5,2,0,0,0,0
"JUANETTA",0,2,0,1,2,0,1,0,1
"JUDEAN",0,2,0,1,2,0,1,0,1
"JUDEE",0,2,0,1,2,0,1,0,1
"JUDES",2,0,1,0,2,1,0,1,0
"JUDEX",2,0,1,0,2,1,0,1,0
"JUDIAN",0,2,0,1,2,0,1,0,1
"JUDILYN",0,2,0,1,2,0,1,0,1
"JUDYANN",0,2,0,1,2,0,1,0,1
"JUDYTA",0,2,0,1,2,0,1,0,1
"JUEN",1,1,.5,.5,2,0,0,0,0
"JUGURTHA",2,0,1,0,2,1,0,1,0
"JUHN",2,0,1,0,2,1,0,1,0
"JULIANI",2,0,1,0,2,1,0,1,0
"JULITA",0,2,0,1,2,0,1,0,1
"JULJAN",2,0,1,0,2,1,0,1,0
"JUNFEI",2,0,1,0,2,1,0,1,0
"JUNIEL",1,1,.5,.5,2,0,0,0,0
"JUNIO",2,0,1,0,2,1,0,1,0
"JUNIS",1,1,.5,.5,2,0,0,0,0
"JUNMING",1,1,.5,.5,2,0,0,0,0
"JUNNY",1,1,.5,.5,2,0,0,0,0
"JUNWOO",2,0,1,0,2,1,0,1,0
"JUREK",2,0,1,0,2,1,0,1,0
"JURELL",2,0,1,0,2,1,0,1,0
"JURGA",0,2,0,1,2,0,1,0,1
"JURGITA",0,2,0,1,2,0,1,0,1
"JURO",2,0,1,0,2,1,0,1,0
"JUSS",1,1,.5,.5,2,0,0,0,0
"JUSTAN",2,0,1,0,2,1,0,1,0
"JUSUF",2,0,1,0,2,1,0,1,0
"KAASHIF",2,0,1,0,2,1,0,1,0
"KABUS",2,0,1,0,2,1,0,1,0
"KACHINA",0,2,0,1,2,0,1,0,1
"KADEJIAH",0,2,0,1,2,0,1,0,1
"KAEDE",1,1,.5,.5,2,0,0,0,0
"KAELEN",0,2,0,1,2,0,1,0,1
"KAHEEM",2,0,1,0,2,1,0,1,0
"KAHIL",2,0,1,0,2,1,0,1,0
"KAHLUA",0,2,0,1,2,0,1,0,1
"KAILEI",0,2,0,1,2,0,1,0,1
"KAILY",0,2,0,1,2,0,1,0,1
"KAIMI",1,1,.5,.5,2,0,0,0,0
"KAIRON",2,0,1,0,2,1,0,1,0
"KAITIE",0,2,0,1,2,0,1,0,1
"KAITLEN",0,2,0,1,2,0,1,0,1
"KAIVAN",2,0,1,0,2,1,0,1,0
"KAIZAD",2,0,1,0,2,1,0,1,0
"KAJI",2,0,1,0,2,1,0,1,0
"KAKIA",0,2,0,1,2,0,1,0,1
"KAKOLI",0,2,0,1,2,0,1,0,1
"KALAI",1,1,.5,.5,2,0,0,0,0
"KALEE",1,1,.5,.5,2,0,0,0,0
"KALIDA",0,2,0,1,2,0,1,0,1
"KALIF",2,0,1,0,2,1,0,1,0
"KALISSA",0,2,0,1,2,0,1,0,1
"KALLEN",0,2,0,1,2,0,1,0,1
"KAMALESH",2,0,1,0,2,1,0,1,0
"KAMAYA",0,2,0,1,2,0,1,0,1
"KAMDEN",2,0,1,0,2,1,0,1,0
"KAMEIKA",0,2,0,1,2,0,1,0,1
"KAMESH",2,0,1,0,2,1,0,1,0
"KAMIEL",0,2,0,1,2,0,1,0,1
"KAMIESHA",0,2,0,1,2,0,1,0,1
"KAMIKAZE",1,1,.5,.5,2,0,0,0,0
"KAMILE",0,2,0,1,2,0,1,0,1
"KAMNI",0,2,0,1,2,0,1,0,1
"KAMOY",0,2,0,1,2,0,1,0,1
"KAMRUZZAMAN",2,0,1,0,2,1,0,1,0
"KAMTA",2,0,1,0,2,1,0,1,0
"KANAYA",1,1,.5,.5,2,0,0,0,0
"KANDE",2,0,1,0,2,1,0,1,0
"KANDII",0,2,0,1,2,0,1,0,1
"KANDRA",0,2,0,1,2,0,1,0,1
"KANGA",2,0,1,0,2,1,0,1,0
"KANGHEE",2,0,1,0,2,1,0,1,0
"KAPTAIN",2,0,1,0,2,1,0,1,0
"KAPTAN",2,0,1,0,2,1,0,1,0
"KARAH",0,2,0,1,2,0,1,0,1
"KAREEF",2,0,1,0,2,1,0,1,0
"KAREME",2,0,1,0,2,1,0,1,0
"KARENN",0,2,0,1,2,0,1,0,1
"KARIMANASSERI",2,0,1,0,2,1,0,1,0
"KARLEN",1,1,.5,.5,2,0,0,0,0
"KARL-ERIK",2,0,1,0,2,1,0,1,0
"KARLOZ",2,0,1,0,2,1,0,1,0
"KARMITA",0,2,0,1,2,0,1,0,1
"KAROLL",0,2,0,1,2,0,1,0,1
"KARTHIKA",0,2,0,1,2,0,1,0,1
"KARTIKA",0,2,0,1,2,0,1,0,1
"KARU",2,0,1,0,2,1,0,1,0
"KARYM",0,2,0,1,2,0,1,0,1
"KARYNE",0,2,0,1,2,0,1,0,1
"KASEAN",2,0,1,0,2,1,0,1,0
"KASHEIM",2,0,1,0,2,1,0,1,0
"KASHIEF",2,0,1,0,2,1,0,1,0
"KASHIEM",2,0,1,0,2,1,0,1,0
"KASHON",1,1,.5,.5,2,0,0,0,0
"KASI",0,2,0,1,2,0,1,0,1
"KASRIEL",2,0,1,0,2,1,0,1,0
"KASSAN",2,0,1,0,2,1,0,1,0
"KASUAL",2,0,1,0,2,1,0,1,0
"KATELY",0,2,0,1,2,0,1,0,1
"KATERIA",0,2,0,1,2,0,1,0,1
"KATHALINA",0,2,0,1,2,0,1,0,1
"KATHELYN",0,2,0,1,2,0,1,0,1
"KATHIRIA",0,2,0,1,2,0,1,0,1
"KATHIUSKA",0,2,0,1,2,0,1,0,1
"KATHRICE",0,2,0,1,2,0,1,0,1
"KATI-ANN",0,2,0,1,2,0,1,0,1
"KATLYNN",0,2,0,1,2,0,1,0,1
"KATSURA",0,2,0,1,2,0,1,0,1
"KATYE",0,2,0,1,2,0,1,0,1
"KAUSAR",0,2,0,1,2,0,1,0,1
"KAVIR",2,0,1,0,2,1,0,1,0
"KAWON",2,0,1,0,2,1,0,1,0
"KAYANA",0,2,0,1,2,0,1,0,1
"KAYANNE",0,2,0,1,2,0,1,0,1
"KAYIN",1,1,.5,.5,2,0,0,0,0
"KAYKAY",2,0,1,0,2,1,0,1,0
"KAYMA",0,2,0,1,2,0,1,0,1
"KAZUTAKA",2,0,1,0,2,1,0,1,0
"KEAGAN",2,0,1,0,2,1,0,1,0
"KEDNER",2,0,1,0,2,1,0,1,0
"KEEF",2,0,1,0,2,1,0,1,0
"KEELA",0,2,0,1,2,0,1,0,1
"KEENIA",0,2,0,1,2,0,1,0,1
"KEEVIN",2,0,1,0,2,1,0,1,0
"KEIDI",1,1,.5,.5,2,0,0,0,0
"KEILAH",0,2,0,1,2,0,1,0,1
"KEISA",0,2,0,1,2,0,1,0,1
"KEISHAN",2,0,1,0,2,1,0,1,0
"KEISHANA",0,2,0,1,2,0,1,0,1
"KEISHER",0,2,0,1,2,0,1,0,1
"KEITHER",2,0,1,0,2,1,0,1,0
"KEITON",2,0,1,0,2,1,0,1,0
"KEIVA",0,2,0,1,2,0,1,0,1
"KEJI",1,1,.5,.5,2,0,0,0,0
"KELESHIA",0,2,0,1,2,0,1,0,1
"KELIN",1,1,.5,.5,2,0,0,0,0
"KELLYROSE",0,2,0,1,2,0,1,0,1
"KELS",1,1,.5,.5,2,0,0,0,0
"KELVYN",2,0,1,0,2,1,0,1,0
"KEMIA",0,2,0,1,2,0,1,0,1
"KEMO",2,0,1,0,2,1,0,1,0
"KEMPTON",2,0,1,0,2,1,0,1,0
"KENDER",1,1,.5,.5,2,0,0,0,0
"KENDIA",0,2,0,1,2,0,1,0,1
"KENEE",2,0,1,0,2,1,0,1,0
"KENEIL",2,0,1,0,2,1,0,1,0
"KENESIA",0,2,0,1,2,0,1,0,1
"KENIESHA",0,2,0,1,2,0,1,0,1
"KENLOY",2,0,1,0,2,1,0,1,0
"KENNE",1,1,.5,.5,2,0,0,0,0
"KENNEN",1,1,.5,.5,2,0,0,0,0
"KENNIESHA",0,2,0,1,2,0,1,0,1
"KENY",1,1,.5,.5,2,0,0,0,0
"KENYATTE",1,1,.5,.5,2,0,0,0,0
"KEONA",0,2,0,1,2,0,1,0,1
"KERAN",2,0,1,0,2,1,0,1,0
"KEREEM",2,0,1,0,2,1,0,1,0
"KERISA",0,2,0,1,2,0,1,0,1
"KERLENE",0,2,0,1,2,0,1,0,1
"KERLENS",2,0,1,0,2,1,0,1,0
"KERNEL",2,0,1,0,2,1,0,1,0
"KERONDA",0,2,0,1,2,0,1,0,1
"KERRI-ANNE",0,2,0,1,2,0,1,0,1
"KERRIGAN",2,0,1,0,2,1,0,1,0
"KERRION",1,1,.5,.5,2,0,0,0,0
"KERRIS",1,1,.5,.5,2,0,0,0,0
"KERRISA",0,2,0,1,2,0,1,0,1
"KERRITH",0,2,0,1,2,0,1,0,1
"KERSTYN",0,2,0,1,2,0,1,0,1
"KERWYN",2,0,1,0,2,1,0,1,0
"KESHAUN",2,0,1,0,2,1,0,1,0
"KESTA",2,0,1,0,2,1,0,1,0
"KET",0,2,0,1,2,0,1,0,1
"KETLY",0,2,0,1,2,0,1,0,1
"KETSY",0,2,0,1,2,0,1,0,1
"KEVIE",2,0,1,0,2,1,0,1,0
"KEVSER",0,2,0,1,2,0,1,0,1
"KEVY",1,1,.5,.5,2,0,0,0,0
"KEWL",2,0,1,0,2,1,0,1,0
"KEYNA",0,2,0,1,2,0,1,0,1
"KHAALID",2,0,1,0,2,1,0,1,0
"KHAALIQ",2,0,1,0,2,1,0,1,0
"KHAIRUL",2,0,1,0,2,1,0,1,0
"KHALAF",2,0,1,0,2,1,0,1,0
"KHALFANI",2,0,1,0,2,1,0,1,0
"KHALIK",2,0,1,0,2,1,0,1,0
"KHEIL",2,0,1,0,2,1,0,1,0
"KHERRI",0,2,0,1,2,0,1,0,1
"KHIO",1,1,.5,.5,2,0,0,0,0
"KHRYS",0,2,0,1,2,0,1,0,1
"KHRYS-ANN",0,2,0,1,2,0,1,0,1
"KHURSHED",2,0,1,0,2,1,0,1,0
"KHURSHID",2,0,1,0,2,1,0,1,0
"KIBAKI",2,0,1,0,2,1,0,1,0
"KIEFER",2,0,1,0,2,1,0,1,0
"KIEMA",0,2,0,1,2,0,1,0,1
"KIERIE",0,2,0,1,2,0,1,0,1
"KIJANA",2,0,1,0,2,1,0,1,0
"KIKY",1,1,.5,.5,2,0,0,0,0
"KIMARI",1,1,.5,.5,2,0,0,0,0
"KIMB",0,2,0,1,2,0,1,0,1
"KIMBERT",2,0,1,0,2,1,0,1,0
"KIMBLEY",0,2,0,1,2,0,1,0,1
"KIMBO",2,0,1,0,2,1,0,1,0
"KIMKISHA",0,2,0,1,2,0,1,0,1
"KIMM",0,2,0,1,2,0,1,0,1
"KIMMON",0,2,0,1,2,0,1,0,1
"KIMY",0,2,0,1,2,0,1,0,1
"KINESH",2,0,1,0,2,1,0,1,0
"KINGOF",2,0,1,0,2,1,0,1,0
"KIRAH",0,2,0,1,2,0,1,0,1
"KIRIAKOS",2,0,1,0,2,1,0,1,0
"KIRIKO",0,2,0,1,2,0,1,0,1
"KIRLYN",0,2,0,1,2,0,1,0,1
"KIRSTAN",0,2,0,1,2,0,1,0,1
"KISAAN",1,1,.5,.5,2,0,0,0,0
"KISCHA",0,2,0,1,2,0,1,0,1
"KISHAL",1,1,.5,.5,2,0,0,0,0
"KISHEN",2,0,1,0,2,1,0,1,0
"KISHMA",0,2,0,1,2,0,1,0,1
"KISSI",1,1,.5,.5,2,0,0,0,0
"KISSINGER",2,0,1,0,2,1,0,1,0
"KITAE",2,0,1,0,2,1,0,1,0
"KITANA",0,2,0,1,2,0,1,0,1
"KITRA",0,2,0,1,2,0,1,0,1
"KITRENA",0,2,0,1,2,0,1,0,1
"KITTIPONG",2,0,1,0,2,1,0,1,0
"KIWANA",0,2,0,1,2,0,1,0,1
"KIYANNA",0,2,0,1,2,0,1,0,1
"KLODJAN",2,0,1,0,2,1,0,1,0
"KLOE",0,2,0,1,2,0,1,0,1
"KNICK",1,1,.5,.5,2,0,0,0,0
"KNOX",2,0,1,0,2,1,0,1,0
"KOALA",0,2,0,1,2,0,1,0,1
"KOBA",2,0,1,0,2,1,0,1,0
"KOCO",1,1,.5,.5,2,0,0,0,0
"KOLYN",1,1,.5,.5,2,0,0,0,0
"KOMATSU",1,1,.5,.5,2,0,0,0,0
"KONAIN",2,0,1,0,2,1,0,1,0
"KOOLA",2,0,1,0,2,1,0,1,0
"KORINNA",0,2,0,1,2,0,1,0,1
"KORNELIA",0,2,0,1,2,0,1,0,1
"KOSI",1,1,.5,.5,2,0,0,0,0
"KOU",0,2,0,1,2,0,1,0,1
"KOUAME",1,1,.5,.5,2,0,0,0,0
"KRAM",1,1,.5,.5,2,0,0,0,0
"KRISTABEL",0,2,0,1,2,0,1,0,1
"KRISTOFF",2,0,1,0,2,1,0,1,0
"KRSNAA",0,2,0,1,2,0,1,0,1
"KRYSTL",0,2,0,1,2,0,1,0,1
"KUDIRAT",0,2,0,1,2,0,1,0,1
"KUGEL",1,1,.5,.5,2,0,0,0,0
"KUHU",0,2,0,1,2,0,1,0,1
"KUNCHOK",2,0,1,0,2,1,0,1,0
"KUNGFU",2,0,1,0,2,1,0,1,0
"KUNIHIRO",2,0,1,0,2,1,0,1,0
"KURL",0,2,0,1,2,0,1,0,1
"KUTAY",2,0,1,0,2,1,0,1,0
"KWAB",2,0,1,0,2,1,0,1,0
"KWANE",2,0,1,0,2,1,0,1,0
"KWANZAA",1,1,.5,.5,2,0,0,0,0
"KWAO",2,0,1,0,2,1,0,1,0
"KYLESHA",0,2,0,1,2,0,1,0,1
"KYMBERLEE",0,2,0,1,2,0,1,0,1
"KYMBERLIE",0,2,0,1,2,0,1,0,1
"KYMONE",0,2,0,1,2,0,1,0,1
"KYONNA",0,2,0,1,2,0,1,0,1
"KYRE",1,1,.5,.5,2,0,0,0,0
"KYROLLOS",2,0,1,0,2,1,0,1,0
"KYSHIA",0,2,0,1,2,0,1,0,1
"KYUNGHOON",2,0,1,0,2,1,0,1,0
"LACHANDA",0,2,0,1,2,0,1,0,1
"LADONYA",0,2,0,1,2,0,1,0,1
"LAERTE",2,0,1,0,2,1,0,1,0
"LAH",1,1,.5,.5,2,0,0,0,0
"LAILONA",0,2,0,1,2,0,1,0,1
"LAJARA",0,2,0,1,2,0,1,0,1
"LAKEISHIA",0,2,0,1,2,0,1,0,1
"LAKENYA",0,2,0,1,2,0,1,0,1
"LAKHBIR",2,0,1,0,2,1,0,1,0
"LAKOTA",1,1,.5,.5,2,0,0,0,0
"LAMECCA",0,2,0,1,2,0,1,0,1
"LAMMY",1,1,.5,.5,2,0,0,0,0
"LAMON",0,2,0,1,2,0,1,0,1
"LAMOND",2,0,1,0,2,1,0,1,0
"LAMPROS",2,0,1,0,2,1,0,1,0
"LANCINE",2,0,1,0,2,1,0,1,0
"LANDA",0,2,0,1,2,0,1,0,1
"LANEISHA",0,2,0,1,2,0,1,0,1
"LANESHA",0,2,0,1,2,0,1,0,1
"LANFANG",0,2,0,1,2,0,1,0,1
"LANNETTA",0,2,0,1,2,0,1,0,1
"LAPORSHA",0,2,0,1,2,0,1,0,1
"LAQUANDRA",0,2,0,1,2,0,1,0,1
"LAQWANA",0,2,0,1,2,0,1,0,1
"LARENA",0,2,0,1,2,0,1,0,1
"LARNEY",2,0,1,0,2,1,0,1,0
"LARONDA",0,2,0,1,2,0,1,0,1
"LARRON",2,0,1,0,2,1,0,1,0
"LARRYS",2,0,1,0,2,1,0,1,0
"LARYN",0,2,0,1,2,0,1,0,1
"LASAUN",2,0,1,0,2,1,0,1,0
"LASEON",0,2,0,1,2,0,1,0,1
"LASHEIKA",0,2,0,1,2,0,1,0,1
"LASHEILA",0,2,0,1,2,0,1,0,1
"LASKY",2,0,1,0,2,1,0,1,0
"LASSO",1,1,.5,.5,2,0,0,0,0
"LASTARR",0,2,0,1,2,0,1,0,1
"LATAYA",0,2,0,1,2,0,1,0,1
"LATEEK",2,0,1,0,2,1,0,1,0
"LATIEF",2,0,1,0,2,1,0,1,0
"LATIEK",2,0,1,0,2,1,0,1,0
"LATIK",2,0,1,0,2,1,0,1,0
"LATKA",2,0,1,0,2,1,0,1,0
"LAUGHTON",2,0,1,0,2,1,0,1,0
"LAUNCELOT",2,0,1,0,2,1,0,1,0
"LAURA-ANN",0,2,0,1,2,0,1,0,1
"LAURALEA",0,2,0,1,2,0,1,0,1
"LAUREA",0,2,0,1,2,0,1,0,1
"LAURENN",0,2,0,1,2,0,1,0,1
"LAURIAN",1,1,.5,.5,2,0,0,0,0
"LAURIANNE",0,2,0,1,2,0,1,0,1
"LAURIELYN",0,2,0,1,2,0,1,0,1
"LAURYNAS",2,0,1,0,2,1,0,1,0
"LAUTARO",2,0,1,0,2,1,0,1,0
"LAVANNA",0,2,0,1,2,0,1,0,1
"LAVANTE",2,0,1,0,2,1,0,1,0
"LAVARE",2,0,1,0,2,1,0,1,0
"LAVENDA",0,2,0,1,2,0,1,0,1
"LAVETTA",0,2,0,1,2,0,1,0,1
"LAVITA",0,2,0,1,2,0,1,0,1
"LAWTON",2,0,1,0,2,1,0,1,0
"LAYE",2,0,1,0,2,1,0,1,0
"LAZE",2,0,1,0,2,1,0,1,0
"LAZY",1,1,.5,.5,2,0,0,0,0
"LDOT",2,0,1,0,2,1,0,1,0
"LEACROFT",2,0,1,0,2,1,0,1,0
"LEADER",1,1,.5,.5,2,0,0,0,0
"LEANDROS",2,0,1,0,2,1,0,1,0
"LEANG",1,1,.5,.5,2,0,0,0,0
"LEBBY",1,1,.5,.5,2,0,0,0,0
"LEBERT",2,0,1,0,2,1,0,1,0
"LEED",1,1,.5,.5,2,0,0,0,0
"LEGACY",1,1,.5,.5,2,0,0,0,0
"LEIBA",0,2,0,1,2,0,1,0,1
"LEIBEL",2,0,1,0,2,1,0,1,0
"LEIBI",2,0,1,0,2,1,0,1,0
"LEJUAN",1,1,.5,.5,2,0,0,0,0
"LELOUCH",2,0,1,0,2,1,0,1,0
"LEMARR",2,0,1,0,2,1,0,1,0
"LENAYA",0,2,0,1,2,0,1,0,1
"LENDELL",2,0,1,0,2,1,0,1,0
"LENICA",0,2,0,1,2,0,1,0,1
"LENISSA",0,2,0,1,2,0,1,0,1
"LENNYN",2,0,1,0,2,1,0,1,0
"LEONDRA",0,2,0,1,2,0,1,0,1
"LEONIDA",0,2,0,1,2,0,1,0,1
"LEONIDE",1,1,.5,.5,2,0,0,0,0
"LEQUAN",2,0,1,0,2,1,0,1,0
"LESELLE",0,2,0,1,2,0,1,0,1
"LESHAN",0,2,0,1,2,0,1,0,1
"LESHANE",2,0,1,0,2,1,0,1,0
"LETHAL",2,0,1,0,2,1,0,1,0
"LETHIA",0,2,0,1,2,0,1,0,1
"LETISIA",0,2,0,1,2,0,1,0,1
"LETON",2,0,1,0,2,1,0,1,0
"LETYCIA",0,2,0,1,2,0,1,0,1
"LEVANA",0,2,0,1,2,0,1,0,1
"LEVENTE",2,0,1,0,2,1,0,1,0
"LEVINE",0,2,0,1,2,0,1,0,1
"LEVITICUS",2,0,1,0,2,1,0,1,0
"LEVITT",1,1,.5,.5,2,0,0,0,0
"LEXINGTON",1,1,.5,.5,2,0,0,0,0
"LEYBI",1,1,.5,.5,2,0,0,0,0
"LEYDIS",0,2,0,1,2,0,1,0,1
"LEYLAND",2,0,1,0,2,1,0,1,0
"LICA",0,2,0,1,2,0,1,0,1
"LIDY",0,2,0,1,2,0,1,0,1
"LIESA",0,2,0,1,2,0,1,0,1
"LIEVE",0,2,0,1,2,0,1,0,1
"LIEVEN",2,0,1,0,2,1,0,1,0
"LIEZEL",0,2,0,1,2,0,1,0,1
"LIGAYA",0,2,0,1,2,0,1,0,1
"LIJ",2,0,1,0,2,1,0,1,0
"LILBETH",0,2,0,1,2,0,1,0,1
"LILIK",2,0,1,0,2,1,0,1,0
"LILIT",0,2,0,1,2,0,1,0,1
"LILJANA",0,2,0,1,2,0,1,0,1
"LILLIETH",0,2,0,1,2,0,1,0,1
"LILYANA",0,2,0,1,2,0,1,0,1
"LINDZ",0,2,0,1,2,0,1,0,1
"LINES",1,1,.5,.5,2,0,0,0,0
"LINGYAN",0,2,0,1,2,0,1,0,1
"LINPEI",1,1,.5,.5,2,0,0,0,0
"LINSON",2,0,1,0,2,1,0,1,0
"LIONA",0,2,0,1,2,0,1,0,1
"LIP",1,1,.5,.5,2,0,0,0,0
"LISARAE",0,2,0,1,2,0,1,0,1
"LISELLE",0,2,0,1,2,0,1,0,1
"LISSE",0,2,0,1,2,0,1,0,1
"LISTON",2,0,1,0,2,1,0,1,0
"LITISHIA",0,2,0,1,2,0,1,0,1
"LITTLES",2,0,1,0,2,1,0,1,0
"LITZ",1,1,.5,.5,2,0,0,0,0
"LIYANA",0,2,0,1,2,0,1,0,1
"LIZELLE",0,2,0,1,2,0,1,0,1
"LIZZET",0,2,0,1,2,0,1,0,1
"LJUBA",0,2,0,1,2,0,1,0,1
"LLONA",0,2,0,1,2,0,1,0,1
"LOC",1,1,.5,.5,2,0,0,0,0
"LOFTON",1,1,.5,.5,2,0,0,0,0
"LOHAN",1,1,.5,.5,2,0,0,0,0
"LOISANN",0,2,0,1,2,0,1,0,1
"LONNA",0,2,0,1,2,0,1,0,1
"LONY",1,1,.5,.5,2,0,0,0,0
"LOOK",2,0,1,0,2,1,0,1,0
"LORELEY",0,2,0,1,2,0,1,0,1
"LORELL",0,2,0,1,2,0,1,0,1
"LORELLA",0,2,0,1,2,0,1,0,1
"LORENSO",2,0,1,0,2,1,0,1,0
"LORENY",0,2,0,1,2,0,1,0,1
"LORIAN",0,2,0,1,2,0,1,0,1
"LORICK",1,1,.5,.5,2,0,0,0,0
"LORINA",0,2,0,1,2,0,1,0,1
"LORINNE",0,2,0,1,2,0,1,0,1
"LORRENE",0,2,0,1,2,0,1,0,1
"LORRIN",0,2,0,1,2,0,1,0,1
"LOU-ANN",0,2,0,1,2,0,1,0,1
"LOUANNA",0,2,0,1,2,0,1,0,1
"LOVASIA",0,2,0,1,2,0,1,0,1
"LOVEEN",1,1,.5,.5,2,0,0,0,0
"LOVELEE",0,2,0,1,2,0,1,0,1
"LOVELEEN",0,2,0,1,2,0,1,0,1
"LUBI",2,0,1,0,2,1,0,1,0
"LUBOMIRA",0,2,0,1,2,0,1,0,1
"LUCEL",1,1,.5,.5,2,0,0,0,0
"LUCELIA",0,2,0,1,2,0,1,0,1
"LUCEY",0,2,0,1,2,0,1,0,1
"LUCHIA",0,2,0,1,2,0,1,0,1
"LUCILIA",0,2,0,1,2,0,1,0,1
"LUCYANN",0,2,0,1,2,0,1,0,1
"LUDLOW",2,0,1,0,2,1,0,1,0
"LUIDGY",2,0,1,0,2,1,0,1,0
"LUIE",2,0,1,0,2,1,0,1,0
"LUIGGY",2,0,1,0,2,1,0,1,0
"LUISENRIQUE",2,0,1,0,2,1,0,1,0
"LUKEMAN",2,0,1,0,2,1,0,1,0
"LUKO",2,0,1,0,2,1,0,1,0
"LULZIM",2,0,1,0,2,1,0,1,0
"LUMII",1,1,.5,.5,2,0,0,0,0
"LUMING",1,1,.5,.5,2,0,0,0,0
"LUMUMBA",2,0,1,0,2,1,0,1,0
"LUNDY",0,2,0,1,2,0,1,0,1
"LUNY",1,1,.5,.5,2,0,0,0,0
"LUREEN",0,2,0,1,2,0,1,0,1
"LURIANNE",0,2,0,1,2,0,1,0,1
"LUSI",0,2,0,1,2,0,1,0,1
"LUT",1,1,.5,.5,2,0,0,0,0
"LUTCHMAN",2,0,1,0,2,1,0,1,0
"LUZETT",0,2,0,1,2,0,1,0,1
"LYDE",0,2,0,1,2,0,1,0,1
"LYELL",2,0,1,0,2,1,0,1,0
"LYNDONNA",0,2,0,1,2,0,1,0,1
"LYNECIA",0,2,0,1,2,0,1,0,1
"LYNNELL",0,2,0,1,2,0,1,0,1
"LYNSON",2,0,1,0,2,1,0,1,0
"LYNWOOD",2,0,1,0,2,1,0,1,0
"LYRIKAL",1,1,.5,.5,2,0,0,0,0
"LYSANNE",0,2,0,1,2,0,1,0,1
"LYSE",0,2,0,1,2,0,1,0,1
"LYTESHA",0,2,0,1,2,0,1,0,1
"LYZBETH",0,2,0,1,2,0,1,0,1
"MAA",0,2,0,1,2,0,1,0,1
"MABELL",0,2,0,1,2,0,1,0,1
"MACARONI",1,1,.5,.5,2,0,0,0,0
"MACARTHUR",2,0,1,0,2,1,0,1,0
"MACBETH",1,1,.5,.5,2,0,0,0,0
"MACEDO",2,0,1,0,2,1,0,1,0
"MACKA",0,2,0,1,2,0,1,0,1
"MADAME",0,2,0,1,2,0,1,0,1
"MADANI",1,1,.5,.5,2,0,0,0,0
"MADE",2,0,1,0,2,1,0,1,0
"MADEA",0,2,0,1,2,0,1,0,1
"MADHUKAR",2,0,1,0,2,1,0,1,0
"MAGARITA",0,2,0,1,2,0,1,0,1
"MAGDALI",0,2,0,1,2,0,1,0,1
"MAGNO",2,0,1,0,2,1,0,1,0
"MAHABUB",2,0,1,0,2,1,0,1,0
"MAHAGONY",0,2,0,1,2,0,1,0,1
"MAHELIA",0,2,0,1,2,0,1,0,1
"MAIESHA",0,2,0,1,2,0,1,0,1
"MAI-LING",0,2,0,1,2,0,1,0,1
"MAINAK",1,1,.5,.5,2,0,0,0,0
"MAISSA",0,2,0,1,2,0,1,0,1
"MAJEDA",0,2,0,1,2,0,1,0,1
"MAJESTA",0,2,0,1,2,0,1,0,1
"MAJIC",2,0,1,0,2,1,0,1,0
"MAJIK",1,1,.5,.5,2,0,0,0,0
"MAKAVELLI",2,0,1,0,2,1,0,1,0
"MAKEEVA",0,2,0,1,2,0,1,0,1
"MAKEIA",0,2,0,1,2,0,1,0,1
"MAKESHA",0,2,0,1,2,0,1,0,1
"MALADO",0,2,0,1,2,0,1,0,1
"MALADY",0,2,0,1,2,0,1,0,1
"MALAKAI",2,0,1,0,2,1,0,1,0
"MALIBU",1,1,.5,.5,2,0,0,0,0
"MALINE",0,2,0,1,2,0,1,0,1
"MALLORI",0,2,0,1,2,0,1,0,1
"MALON",1,1,.5,.5,2,0,0,0,0
"MALTIE",0,2,0,1,2,0,1,0,1
"MAM",1,1,.5,.5,2,0,0,0,0
"MANDARIN",1,1,.5,.5,2,0,0,0,0
"MANDINGO",2,0,1,0,2,1,0,1,0
"MANIE",2,0,1,0,2,1,0,1,0
"MANIFEST",1,1,.5,.5,2,0,0,0,0
"MANIL",2,0,1,0,2,1,0,1,0
"MANOLA",1,1,.5,.5,2,0,0,0,0
"MANSFIELD",1,1,.5,.5,2,0,0,0,0
"MANTAS",2,0,1,0,2,1,0,1,0
"MANUCHEHR",2,0,1,0,2,1,0,1,0
"MANUELLA",0,2,0,1,2,0,1,0,1
"MANUNG",2,0,1,0,2,1,0,1,0
"MANZANA",0,2,0,1,2,0,1,0,1
"MARALYNN",0,2,0,1,2,0,1,0,1
"MARANGELY",0,2,0,1,2,0,1,0,1
"MARAWAN",2,0,1,0,2,1,0,1,0
"MARC-ANDRE",2,0,1,0,2,1,0,1,0
"MARCANTHONY",2,0,1,0,2,1,0,1,0
"MARCH",1,1,.5,.5,2,0,0,0,0
"MARCHA",0,2,0,1,2,0,1,0,1
"MAREKA",2,0,1,0,2,1,0,1,0
"MARENA",0,2,0,1,2,0,1,0,1
"MAREZA",0,2,0,1,2,0,1,0,1
"MARGARETHA",0,2,0,1,2,0,1,0,1
"MARIA-JOSE",0,2,0,1,2,0,1,0,1
"MARIANGELI",0,2,0,1,2,0,1,0,1
"MARIAPIA",0,2,0,1,2,0,1,0,1
"MARICKA",0,2,0,1,2,0,1,0,1
"MARICOR",0,2,0,1,2,0,1,0,1
"MARIE-ANNE",0,2,0,1,2,0,1,0,1
"MARIELIZ",0,2,0,1,2,0,1,0,1
"MARIGLEN",2,0,1,0,2,1,0,1,0
"MARIK",2,0,1,0,2,1,0,1,0
"MARIKIT",0,2,0,1,2,0,1,0,1
"MARILENE",0,2,0,1,2,0,1,0,1
"MARIMBA",0,2,0,1,2,0,1,0,1
"MARINELL",0,2,0,1,2,0,1,0,1
"MARINELLE",0,2,0,1,2,0,1,0,1
"MARINELLY",0,2,0,1,2,0,1,0,1
"MARINOS",2,0,1,0,2,1,0,1,0
"MARITIME",2,0,1,0,2,1,0,1,0
"MARITZABEL",0,2,0,1,2,0,1,0,1
"MARIU",0,2,0,1,2,0,1,0,1
"MARJANI",0,2,0,1,2,0,1,0,1
"MARKEE",2,0,1,0,2,1,0,1,0
"MARKENSON",2,0,1,0,2,1,0,1,0
"MARKETTA",0,2,0,1,2,0,1,0,1
"MARKIS",2,0,1,0,2,1,0,1,0
"MARLEA",0,2,0,1,2,0,1,0,1
"MAROS",2,0,1,0,2,1,0,1,0
"MAROUANE",2,0,1,0,2,1,0,1,0
"MARQUITOS",2,0,1,0,2,1,0,1,0
"MARSHALYN",0,2,0,1,2,0,1,0,1
"MARSIA",0,2,0,1,2,0,1,0,1
"MARTYNAS",2,0,1,0,2,1,0,1,0
"MARUFUL",2,0,1,0,2,1,0,1,0
"MARVETTE",0,2,0,1,2,0,1,0,1
"MARY-",0,2,0,1,2,0,1,0,1
"MARY-CATHERINE",0,2,0,1,2,0,1,0,1
"MARYLYNNE",0,2,0,1,2,0,1,0,1
"MASAFUMI",2,0,1,0,2,1,0,1,0
"MASAHIKO",2,0,1,0,2,1,0,1,0
"MASARU",2,0,1,0,2,1,0,1,0
"MASHANNA",0,2,0,1,2,0,1,0,1
"MASHAWN",2,0,1,0,2,1,0,1,0
"MASHEA",0,2,0,1,2,0,1,0,1
"MASHIACH",2,0,1,0,2,1,0,1,0
"MASHUD",2,0,1,0,2,1,0,1,0
"MASIKA",1,1,.5,.5,2,0,0,0,0
"MASONYA",0,2,0,1,2,0,1,0,1
"MASROOR",2,0,1,0,2,1,0,1,0
"MASSEY",1,1,.5,.5,2,0,0,0,0
"MATHILDA",0,2,0,1,2,0,1,0,1
"MATHIS",1,1,.5,.5,2,0,0,0,0
"MATRICE",0,2,0,1,2,0,1,0,1
"MATVEY",2,0,1,0,2,1,0,1,0
"MAU",0,2,0,1,2,0,1,0,1
"MAUDELINE",0,2,0,1,2,0,1,0,1
"MAUZZAM",2,0,1,0,2,1,0,1,0
"MAXIMOS",2,0,1,0,2,1,0,1,0
"MAXY",1,1,.5,.5,2,0,0,0,0
"MAYADA",0,2,0,1,2,0,1,0,1
"MAYEN",0,2,0,1,2,0,1,0,1
"MCARTHUR",2,0,1,0,2,1,0,1,0
"MCCLAIN",1,1,.5,.5,2,0,0,0,0
"MCKAYLA",0,2,0,1,2,0,1,0,1
"MCLAUGHLIN",0,2,0,1,2,0,1,0,1
"MDOT",0,2,0,1,2,0,1,0,1
"MEADHBH",0,2,0,1,2,0,1,0,1
"MEAGEN",0,2,0,1,2,0,1,0,1
"MEAKA",0,2,0,1,2,0,1,0,1
"MEANNE",0,2,0,1,2,0,1,0,1
"MEARA",0,2,0,1,2,0,1,0,1
"MEDARD",2,0,1,0,2,1,0,1,0
"MEDEL",1,1,.5,.5,2,0,0,0,0
"MEDENA",0,2,0,1,2,0,1,0,1
"MEEM",1,1,.5,.5,2,0,0,0,0
"MEETTHE",2,0,1,0,2,1,0,1,0
"MEGANN",0,2,0,1,2,0,1,0,1
"MEGEN",1,1,.5,.5,2,0,0,0,0
"MEHBUB",2,0,1,0,2,1,0,1,0
"MEHGAN",0,2,0,1,2,0,1,0,1
"MEHRET",0,2,0,1,2,0,1,0,1
"MEICHA",0,2,0,1,2,0,1,0,1
"MEIYING",0,2,0,1,2,0,1,0,1
"MEIYUN",0,2,0,1,2,0,1,0,1
"MEKEL",1,1,.5,.5,2,0,0,0,0
"MELAKA",0,2,0,1,2,0,1,0,1
"MELESSA",0,2,0,1,2,0,1,0,1
"MELESSIA",0,2,0,1,2,0,1,0,1
"MELIAH",0,2,0,1,2,0,1,0,1
"MELIANA",0,2,0,1,2,0,1,0,1
"MELINE",0,2,0,1,2,0,1,0,1
"MELODIC",2,0,1,0,2,1,0,1,0
"MEMEN",0,2,0,1,2,0,1,0,1
"MEMON",1,1,.5,.5,2,0,0,0,0
"MENI",2,0,1,0,2,1,0,1,0
"MENNA",0,2,0,1,2,0,1,0,1
"MER",1,1,.5,.5,2,0,0,0,0
"MERAB",2,0,1,0,2,1,0,1,0
"MERCUTIO",2,0,1,0,2,1,0,1,0
"MERIAN",0,2,0,1,2,0,1,0,1
"MERIL",0,2,0,1,2,0,1,0,1
"MERLIE",1,1,.5,.5,2,0,0,0,0
"MERLINO",2,0,1,0,2,1,0,1,0
"MEROPE",0,2,0,1,2,0,1,0,1
"MEROPI",0,2,0,1,2,0,1,0,1
"MERSEDEH",0,2,0,1,2,0,1,0,1
"MESBA",2,0,1,0,2,1,0,1,0
"MESERET",0,2,0,1,2,0,1,0,1
"MESHU",2,0,1,0,2,1,0,1,0
"MESIAH",2,0,1,0,2,1,0,1,0
"MESMIN",2,0,1,0,2,1,0,1,0
"MESSY",0,2,0,1,2,0,1,0,1
"MEZ",0,2,0,1,2,0,1,0,1
"MIAOYI",0,2,0,1,2,0,1,0,1
"MIASIA",0,2,0,1,2,0,1,0,1
"MICHAH",2,0,1,0,2,1,0,1,0
"MICHALINA",0,2,0,1,2,0,1,0,1
"MICHEL-ANGE",2,0,1,0,2,1,0,1,0
"MICHEL-ANN",0,2,0,1,2,0,1,0,1
"MICO",2,0,1,0,2,1,0,1,0
"MIDE",1,1,.5,.5,2,0,0,0,0
"MIEKO",0,2,0,1,2,0,1,0,1
"MIELLE",0,2,0,1,2,0,1,0,1
"MIGDOEL",2,0,1,0,2,1,0,1,0
"MIGGIE",0,2,0,1,2,0,1,0,1
"MIGS",2,0,1,0,2,1,0,1,0
"MIHAEL",2,0,1,0,2,1,0,1,0
"MIKIA",0,2,0,1,2,0,1,0,1
"MILEENA",0,2,0,1,2,0,1,0,1
"MILIN",1,1,.5,.5,2,0,0,0,0
"MILL",1,1,.5,.5,2,0,0,0,0
"MILOVAN",2,0,1,0,2,1,0,1,0
"MILWOOD",2,0,1,0,2,1,0,1,0
"MINAXI",0,2,0,1,2,0,1,0,1
"MINCONG",1,1,.5,.5,2,0,0,0,0
"MINKYUNG",0,2,0,1,2,0,1,0,1
"MIQDAD",2,0,1,0,2,1,0,1,0
"MIQUELLE",0,2,0,1,2,0,1,0,1
"MIRAC",2,0,1,0,2,1,0,1,0
"MIRANDY",0,2,0,1,2,0,1,0,1
"MIROSLAVA",1,1,.5,.5,2,0,0,0,0
"MIROSLAW",2,0,1,0,2,1,0,1,0
"MIRYANA",0,2,0,1,2,0,1,0,1
"MISHAEL",2,0,1,0,2,1,0,1,0
"MISHU",0,2,0,1,2,0,1,0,1
"MISKI",0,2,0,1,2,0,1,0,1
"MITHA",0,2,0,1,2,0,1,0,1
"MIYAMOTO",2,0,1,0,2,1,0,1,0
"MMED",2,0,1,0,2,1,0,1,0
"MNCEDISI",2,0,1,0,2,1,0,1,0
"MOACYR",2,0,1,0,2,1,0,1,0
"MODE",1,1,.5,.5,2,0,0,0,0
"MODINAT",0,2,0,1,2,0,1,0,1
"MOEED",2,0,1,0,2,1,0,1,0
"MOEEN",2,0,1,0,2,1,0,1,0
"MOHEB",2,0,1,0,2,1,0,1,0
"MOHMED",2,0,1,0,2,1,0,1,0
"MOISHIE",2,0,1,0,2,1,0,1,0
"MOJISOLA",0,2,0,1,2,0,1,0,1
"MOKO",1,1,.5,.5,2,0,0,0,0
"MOLI",0,2,0,1,2,0,1,0,1
"MOMOYO",0,2,0,1,2,0,1,0,1
"MONESSAH",0,2,0,1,2,0,1,0,1
"MONIPHIA",0,2,0,1,2,0,1,0,1
"MONIQUEA",0,2,0,1,2,0,1,0,1
"MONISE",0,2,0,1,2,0,1,0,1
"MONTEGO",2,0,1,0,2,1,0,1,0
"MOOKY",1,1,.5,.5,2,0,0,0,0
"MOOMOO",0,2,0,1,2,0,1,0,1
"MOREIRA",1,1,.5,.5,2,0,0,0,0
"MORIN",0,2,0,1,2,0,1,0,1
"MORSE",2,0,1,0,2,1,0,1,0
"MORSHED",2,0,1,0,2,1,0,1,0
"MOSAMMAT",0,2,0,1,2,0,1,0,1
"MOSELY",2,0,1,0,2,1,0,1,0
"MOSEPH",2,0,1,0,2,1,0,1,0
"MOSEY",2,0,1,0,2,1,0,1,0
"MOSHI",1,1,.5,.5,2,0,0,0,0
"MOSHOOD",2,0,1,0,2,1,0,1,0
"MOUSIE",1,1,.5,.5,2,0,0,0,0
"MOYANO",0,2,0,1,2,0,1,0,1
"MOYE",2,0,1,0,2,1,0,1,0
"MOZELLE",0,2,0,1,2,0,1,0,1
"MPHO",2,0,1,0,2,1,0,1,0
"MTA",1,1,.5,.5,2,0,0,0,0
"MUATH",2,0,1,0,2,1,0,1,0
"MUDASSIR",2,0,1,0,2,1,0,1,0
"MUFASA",2,0,1,0,2,1,0,1,0
"MUFIT",2,0,1,0,2,1,0,1,0
"MUHAIMIN",2,0,1,0,2,1,0,1,0
"MUHAMAD",2,0,1,0,2,1,0,1,0
"MUNNY",0,2,0,1,2,0,1,0,1
"MUNY",1,1,.5,.5,2,0,0,0,0
"MURALIKRISHNAN",2,0,1,0,2,1,0,1,0
"MURPH",1,1,.5,.5,2,0,0,0,0
"MURR",0,2,0,1,2,0,1,0,1
"MUSAH",2,0,1,0,2,1,0,1,0
"MUSHI",2,0,1,0,2,1,0,1,0
"MUSHROOM",0,2,0,1,2,0,1,0,1
"MUSLIMAH",0,2,0,1,2,0,1,0,1
"MUSONDA",0,2,0,1,2,0,1,0,1
"MUTIU",2,0,1,0,2,1,0,1,0
"MYKO",1,1,.5,.5,2,0,0,0,0
"MY-LAN",0,2,0,1,2,0,1,0,1
"MYLIKA",0,2,0,1,2,0,1,0,1
"MYRIAH",0,2,0,1,2,0,1,0,1
"MYRL",0,2,0,1,2,0,1,0,1
"MYRTHO",0,2,0,1,2,0,1,0,1
"MYSTER",2,0,1,0,2,1,0,1,0
"MYSTERIO",2,0,1,0,2,1,0,1,0
"MYZZ",0,2,0,1,2,0,1,0,1
"NA-ASIA",0,2,0,1,2,0,1,0,1
"NABOR",2,0,1,0,2,1,0,1,0
"NACHSHON",2,0,1,0,2,1,0,1,0
"NACO",2,0,1,0,2,1,0,1,0
"NACOLA",0,2,0,1,2,0,1,0,1
"NADELYN",0,2,0,1,2,0,1,0,1
"NADO",1,1,.5,.5,2,0,0,0,0
"NADRE",0,2,0,1,2,0,1,0,1
"NAFISSATOU",0,2,0,1,2,0,1,0,1
"NAGARAJAN",2,0,1,0,2,1,0,1,0
"NAGHAM",0,2,0,1,2,0,1,0,1
"NAH",1,1,.5,.5,2,0,0,0,0
"NAHOMY",0,2,0,1,2,0,1,0,1
"NAHYSHENE",0,2,0,1,2,0,1,0,1
"NAINESH",2,0,1,0,2,1,0,1,0
"NAJADA",0,2,0,1,2,0,1,0,1
"NAJAM",2,0,1,0,2,1,0,1,0
"NAJETTE",0,2,0,1,2,0,1,0,1
"NAJIYYAH",0,2,0,1,2,0,1,0,1
"NAJMUL",2,0,1,0,2,1,0,1,0
"NAK",2,0,1,0,2,1,0,1,0
"NAKAJIMA",1,1,.5,.5,2,0,0,0,0
"NAKEAH",0,2,0,1,2,0,1,0,1
"NAKEEM",2,0,1,0,2,1,0,1,0
"NAKIESHA",0,2,0,1,2,0,1,0,1
"NAKKIA",0,2,0,1,2,0,1,0,1
"NALINA",0,2,0,1,2,0,1,0,1
"NAMIT",2,0,1,0,2,1,0,1,0
"NAMJU",0,2,0,1,2,0,1,0,1
"NAMS",1,1,.5,.5,2,0,0,0,0
"NANCYANN",0,2,0,1,2,0,1,0,1
"NAND",2,0,1,0,2,1,0,1,0
"NANNE",0,2,0,1,2,0,1,0,1
"NANUET",1,1,.5,.5,2,0,0,0,0
"NAOME",0,2,0,1,2,0,1,0,1
"NAPON",2,0,1,0,2,1,0,1,0
"NAQUISHA",0,2,0,1,2,0,1,0,1
"NAREA",0,2,0,1,2,0,1,0,1
"NAREK",2,0,1,0,2,1,0,1,0
"NARELLE",0,2,0,1,2,0,1,0,1
"NARGES",0,2,0,1,2,0,1,0,1
"NASA",1,1,.5,.5,2,0,0,0,0
"NASHI",1,1,.5,.5,2,0,0,0,0
"NASI",1,1,.5,.5,2,0,0,0,0
"NASLY",0,2,0,1,2,0,1,0,1
"NASSIF",2,0,1,0,2,1,0,1,0
"NASTASHA",0,2,0,1,2,0,1,0,1
"NASTIA",0,2,0,1,2,0,1,0,1
"NASYA",0,2,0,1,2,0,1,0,1
"NATASHUA",0,2,0,1,2,0,1,0,1
"NATERA",0,2,0,1,2,0,1,0,1
"NATHACHA",0,2,0,1,2,0,1,0,1
"NATILY",0,2,0,1,2,0,1,0,1
"NATISHIA",0,2,0,1,2,0,1,0,1
"NATTALIA",0,2,0,1,2,0,1,0,1
"NATU",1,1,.5,.5,2,0,0,0,0
"NAVIE",2,0,1,0,2,1,0,1,0
"NAWANG",2,0,1,0,2,1,0,1,0
"NAYAR",2,0,1,0,2,1,0,1,0
"NAYEL",2,0,1,0,2,1,0,1,0
"NAYI",1,1,.5,.5,2,0,0,0,0
"NAYIVE",0,2,0,1,2,0,1,0,1
"NAYMAN",2,0,1,0,2,1,0,1,0
"NAYOBI",0,2,0,1,2,0,1,0,1
"NAYOUN",0,2,0,1,2,0,1,0,1
"NAYROBI",0,2,0,1,2,0,1,0,1
"NAYROBY",0,2,0,1,2,0,1,0,1
"NAZARIA",0,2,0,1,2,0,1,0,1
"NAZMIN",0,2,0,1,2,0,1,0,1
"NEALE",2,0,1,0,2,1,0,1,0
"NEAT",0,2,0,1,2,0,1,0,1
"NEBU",2,0,1,0,2,1,0,1,0
"NECE",0,2,0,1,2,0,1,0,1
"NECHEMYA",2,0,1,0,2,1,0,1,0
"NEEN",0,2,0,1,2,0,1,0,1
"NEENEE",0,2,0,1,2,0,1,0,1
"NEHRU",2,0,1,0,2,1,0,1,0
"NEILE",0,2,0,1,2,0,1,0,1
"NEILON",2,0,1,0,2,1,0,1,0
"NEIMAN",2,0,1,0,2,1,0,1,0
"NEIVA",0,2,0,1,2,0,1,0,1
"NEJIB",2,0,1,0,2,1,0,1,0
"NEKORO",2,0,1,0,2,1,0,1,0
"NELANI",0,2,0,1,2,0,1,0,1
"NELCY",0,2,0,1,2,0,1,0,1
"NELINI",0,2,0,1,2,0,1,0,1
"NELSIE",0,2,0,1,2,0,1,0,1
"NELVIE",0,2,0,1,2,0,1,0,1
"NENITA",0,2,0,1,2,0,1,0,1
"NEPHI",2,0,1,0,2,1,0,1,0
"NEPTALI",2,0,1,0,2,1,0,1,0
"NEROLI",0,2,0,1,2,0,1,0,1
"NEV",2,0,1,0,2,1,0,1,0
"NEWAZ",2,0,1,0,2,1,0,1,0
"NEWMONEY",2,0,1,0,2,1,0,1,0
"NEZIR",2,0,1,0,2,1,0,1,0
"NGÃ”",2,0,1,0,2,1,0,1,0
"NICANOR",2,0,1,0,2,1,0,1,0
"NICKCOLE",0,2,0,1,2,0,1,0,1
"NICOLET",0,2,0,1,2,0,1,0,1
"NIEDJA",0,2,0,1,2,0,1,0,1
"NIELSEN",0,2,0,1,2,0,1,0,1
"NIGIA",1,1,.5,.5,2,0,0,0,0
"NIJIA",0,2,0,1,2,0,1,0,1
"NIKETTA",0,2,0,1,2,0,1,0,1
"NIKKIYA",0,2,0,1,2,0,1,0,1
"NIKKYA",0,2,0,1,2,0,1,0,1
"NIKOLIA",2,0,1,0,2,1,0,1,0
"NIKOLL",2,0,1,0,2,1,0,1,0
"NILLY",0,2,0,1,2,0,1,0,1
"NILSSON",2,0,1,0,2,1,0,1,0
"NIMER",2,0,1,0,2,1,0,1,0
"NIMI",0,2,0,1,2,0,1,0,1
"NIMO",1,1,.5,.5,2,0,0,0,0
"NIN",2,0,1,0,2,1,0,1,0
"NINNETTE",0,2,0,1,2,0,1,0,1
"NIOKA",0,2,0,1,2,0,1,0,1
"NIOVI",0,2,0,1,2,0,1,0,1
"NIROSHI",0,2,0,1,2,0,1,0,1
"NITHA",0,2,0,1,2,0,1,0,1
"NITISH",2,0,1,0,2,1,0,1,0
"NIVALDO",2,0,1,0,2,1,0,1,0
"NIXZA",0,2,0,1,2,0,1,0,1
"NOAL",2,0,1,0,2,1,0,1,0
"NOBI",2,0,1,0,2,1,0,1,0
"NOBUAKI",2,0,1,0,2,1,0,1,0
"NOELEEN",0,2,0,1,2,0,1,0,1
"NOELINE",0,2,0,1,2,0,1,0,1
"NOH",2,0,1,0,2,1,0,1,0
"NOHEMI",0,2,0,1,2,0,1,0,1
"NOHORA",0,2,0,1,2,0,1,0,1
"NOIR",2,0,1,0,2,1,0,1,0
"NOLO",2,0,1,0,2,1,0,1,0
"NOMIE",1,1,.5,.5,2,0,0,0,0
"NOMUSA",0,2,0,1,2,0,1,0,1
"NONSO",2,0,1,0,2,1,0,1,0
"NOO",0,2,0,1,2,0,1,0,1
"NOORDIN",2,0,1,0,2,1,0,1,0
"NORALBA",0,2,0,1,2,0,1,0,1
"NORALIS",0,2,0,1,2,0,1,0,1
"NORCIA",1,1,.5,.5,2,0,0,0,0
"NORIAKI",2,0,1,0,2,1,0,1,0
"NORILYN",0,2,0,1,2,0,1,0,1
"NORRISA",0,2,0,1,2,0,1,0,1
"NOSSON",2,0,1,0,2,1,0,1,0
"NOVELL",2,0,1,0,2,1,0,1,0
"NOVIE",1,1,.5,.5,2,0,0,0,0
"NOVLETTE",0,2,0,1,2,0,1,0,1
"NOYAN",2,0,1,0,2,1,0,1,0
"NTINA",0,2,0,1,2,0,1,0,1
"NUM",2,0,1,0,2,1,0,1,0
"NURHAN",2,0,1,0,2,1,0,1,0
"NWE",0,2,0,1,2,0,1,0,1
"NYAN",2,0,1,0,2,1,0,1,0
"NYEEMA",0,2,0,1,2,0,1,0,1
"NYEKA",0,2,0,1,2,0,1,0,1
"NYI",2,0,1,0,2,1,0,1,0
"NYTE",2,0,1,0,2,1,0,1,0
"OASIA",0,2,0,1,2,0,1,0,1
"OBAIDULLAH",2,0,1,0,2,1,0,1,0
"OBDULIA",0,2,0,1,2,0,1,0,1
"OBEDIAH",2,0,1,0,2,1,0,1,0
"OBIAGELI",0,2,0,1,2,0,1,0,1
"OCHA",2,0,1,0,2,1,0,1,0
"OCTANE",2,0,1,0,2,1,0,1,0
"ODALIZ",0,2,0,1,2,0,1,0,1
"ODEMARIS",0,2,0,1,2,0,1,0,1
"OENDRILA",0,2,0,1,2,0,1,0,1
"OGE",0,2,0,1,2,0,1,0,1
"OGUNKOYA",2,0,1,0,2,1,0,1,0
"OGUNSANYA",1,1,.5,.5,2,0,0,0,0
"OHIOMA",2,0,1,0,2,1,0,1,0
"OJO",2,0,1,0,2,1,0,1,0
"OJUS",2,0,1,0,2,1,0,1,0
"OKEISHA",0,2,0,1,2,0,1,0,1
"OKI",1,1,.5,.5,2,0,0,0,0
"OKOJIE",2,0,1,0,2,1,0,1,0
"OKON",1,1,.5,.5,2,0,0,0,0
"OLANA",1,1,.5,.5,2,0,0,0,0
"OLATUNBOSUN",2,0,1,0,2,1,0,1,0
"OLENKA",0,2,0,1,2,0,1,0,1
"OLITA",0,2,0,1,2,0,1,0,1
"OLIVEA",0,2,0,1,2,0,1,0,1
"OLIVEIRA",1,1,.5,.5,2,0,0,0,0
"OLIWIA",0,2,0,1,2,0,1,0,1
"OLUWASEGUN",2,0,1,0,2,1,0,1,0
"OMERCAN",2,0,1,0,2,1,0,1,0
"OMOBA",2,0,1,0,2,1,0,1,0
"OMOWALE",2,0,1,0,2,1,0,1,0
"ONAIDA",0,2,0,1,2,0,1,0,1
"ONAN",2,0,1,0,2,1,0,1,0
"ONECA",0,2,0,1,2,0,1,0,1
"ONEILL",2,0,1,0,2,1,0,1,0
"ONESSA",0,2,0,1,2,0,1,0,1
"ONG",1,1,.5,.5,2,0,0,0,0
"ONICIAN",2,0,1,0,2,1,0,1,0
"ONIDA",0,2,0,1,2,0,1,0,1
"ONIQUA",0,2,0,1,2,0,1,0,1
"ONNIK",2,0,1,0,2,1,0,1,0
"ONORIA",0,2,0,1,2,0,1,0,1
"OOH",2,0,1,0,2,1,0,1,0
"OPEYEMI",0,2,0,1,2,0,1,0,1
"OPHER",2,0,1,0,2,1,0,1,0
"ORALIA",0,2,0,1,2,0,1,0,1
"ORE",2,0,1,0,2,1,0,1,0
"ORIA",0,2,0,1,2,0,1,0,1
"ORIALYS",0,2,0,1,2,0,1,0,1
"ORISI",2,0,1,0,2,1,0,1,0
"ORLANDITO",2,0,1,0,2,1,0,1,0
"ORONDE",2,0,1,0,2,1,0,1,0
"ORQUESTA",2,0,1,0,2,1,0,1,0
"ORVIN",2,0,1,0,2,1,0,1,0
"ORY",2,0,1,0,2,1,0,1,0
"ORYSIA",0,2,0,1,2,0,1,0,1
"OSCARINA",0,2,0,1,2,0,1,0,1
"OSO",2,0,1,0,2,1,0,1,0
"OSONDU",2,0,1,0,2,1,0,1,0
"OSP",1,1,.5,.5,2,0,0,0,0
"OTAVIO",2,0,1,0,2,1,0,1,0
"OTELLO",2,0,1,0,2,1,0,1,0
"OTTILIE",0,2,0,1,2,0,1,0,1
"OTUNBA",2,0,1,0,2,1,0,1,0
"OURI",2,0,1,0,2,1,0,1,0
"OV",2,0,1,0,2,1,0,1,0
"OVIDIO",2,0,1,0,2,1,0,1,0
"OYINKAN",0,2,0,1,2,0,1,0,1
"OYINKANSOLA",0,2,0,1,2,0,1,0,1
"OZER",2,0,1,0,2,1,0,1,0
"OZIAS",1,1,.5,.5,2,0,0,0,0
"OZMAN",2,0,1,0,2,1,0,1,0
"OZZI",2,0,1,0,2,1,0,1,0
"PACIFIC",1,1,.5,.5,2,0,0,0,0
"PACINO",2,0,1,0,2,1,0,1,0
"PACKIE",2,0,1,0,2,1,0,1,0
"PADDINGTON",0,2,0,1,2,0,1,0,1
"PADILLA",2,0,1,0,2,1,0,1,0
"PAGET",2,0,1,0,2,1,0,1,0
"PAH",2,0,1,0,2,1,0,1,0
"PAIK",1,1,.5,.5,2,0,0,0,0
"PAKII",1,1,.5,.5,2,0,0,0,0
"PAKORN",2,0,1,0,2,1,0,1,0
"PALACIO",2,0,1,0,2,1,0,1,0
"PALOMINO",1,1,.5,.5,2,0,0,0,0
"PAOLINO",2,0,1,0,2,1,0,1,0
"PAPOOSE",2,0,1,0,2,1,0,1,0
"PARAM",2,0,1,0,2,1,0,1,0
"PARAMJIT",2,0,1,0,2,1,0,1,0
"PARHAM",2,0,1,0,2,1,0,1,0
"PARIKSHIT",2,0,1,0,2,1,0,1,0
"PARKS",2,0,1,0,2,1,0,1,0
"PARMOD",2,0,1,0,2,1,0,1,0
"PARS",2,0,1,0,2,1,0,1,0
"PARTHASARATHI",2,0,1,0,2,1,0,1,0
"PATA",1,1,.5,.5,2,0,0,0,0
"PATIE",0,2,0,1,2,0,1,0,1
"PATRCIA",0,2,0,1,2,0,1,0,1
"PATRINE",0,2,0,1,2,0,1,0,1
"PATTRICE",0,2,0,1,2,0,1,0,1
"PAULEEN",0,2,0,1,2,0,1,0,1
"PAULITA",0,2,0,1,2,0,1,0,1
"PAULOS",2,0,1,0,2,1,0,1,0
"PAURIC",2,0,1,0,2,1,0,1,0
"PAXDORA",0,2,0,1,2,0,1,0,1
"PAZZO",2,0,1,0,2,1,0,1,0
"PCOM",1,1,.5,.5,2,0,0,0,0
"PEARLA",0,2,0,1,2,0,1,0,1
"PEEDI",2,0,1,0,2,1,0,1,0
"PENO",2,0,1,0,2,1,0,1,0
"PEPPY",1,1,.5,.5,2,0,0,0,0
"PERCEVAL",2,0,1,0,2,1,0,1,0
"PERFUME",1,1,.5,.5,2,0,0,0,0
"PERIC",2,0,1,0,2,1,0,1,0
"PERRIER",1,1,.5,.5,2,0,0,0,0
"PERSHAWNA",0,2,0,1,2,0,1,0,1
"PERSIS",0,2,0,1,2,0,1,0,1
"PETAX",2,0,1,0,2,1,0,1,0
"PETRE",2,0,1,0,2,1,0,1,0
"PETRIKA",0,2,0,1,2,0,1,0,1
"PETRONA",0,2,0,1,2,0,1,0,1
"PETRONILA",0,2,0,1,2,0,1,0,1
"PETTRINA",0,2,0,1,2,0,1,0,1
"PHEDRA",0,2,0,1,2,0,1,0,1
"PHEOBE",0,2,0,1,2,0,1,0,1
"PHILECIA",0,2,0,1,2,0,1,0,1
"PHILISHA",0,2,0,1,2,0,1,0,1
"PHILROY",2,0,1,0,2,1,0,1,0
"PHOTOS",1,1,.5,.5,2,0,0,0,0
"PHYLLICIA",0,2,0,1,2,0,1,0,1
"PHYLLIE",0,2,0,1,2,0,1,0,1
"PICCORO",2,0,1,0,2,1,0,1,0
"PICS",2,0,1,0,2,1,0,1,0
"PIERE",2,0,1,0,2,1,0,1,0
"PIERGIOVANNI",2,0,1,0,2,1,0,1,0
"PIERPAOLO",2,0,1,0,2,1,0,1,0
"PIERSON",2,0,1,0,2,1,0,1,0
"PIKA",0,2,0,1,2,0,1,0,1
"PIMENTEL",1,1,.5,.5,2,0,0,0,0
"PINCKNEY",1,1,.5,.5,2,0,0,0,0
"PINKU",1,1,.5,.5,2,0,0,0,0
"PINTO",2,0,1,0,2,1,0,1,0
"PINTU",2,0,1,0,2,1,0,1,0
"PIRKKO",0,2,0,1,2,0,1,0,1
"PISIDIA",1,1,.5,.5,2,0,0,0,0
"PIYAL",2,0,1,0,2,1,0,1,0
"PLABAN",2,0,1,0,2,1,0,1,0
"PLATINUM",2,0,1,0,2,1,0,1,0
"PLUM",1,1,.5,.5,2,0,0,0,0
"PLUTO",1,1,.5,.5,2,0,0,0,0
"POCHO",2,0,1,0,2,1,0,1,0
"POE",2,0,1,0,2,1,0,1,0
"POLAT",2,0,1,0,2,1,0,1,0
"POOKY",1,1,.5,.5,2,0,0,0,0
"POOL",2,0,1,0,2,1,0,1,0
"POORAN",2,0,1,0,2,1,0,1,0
"POPA",2,0,1,0,2,1,0,1,0
"POPOY",1,1,.5,.5,2,0,0,0,0
"POR",1,1,.5,.5,2,0,0,0,0
"PORK",1,1,.5,.5,2,0,0,0,0
"PORSHIA",0,2,0,1,2,0,1,0,1
"POUR",1,1,.5,.5,2,0,0,0,0
"POUYAN",2,0,1,0,2,1,0,1,0
"POWERFUL",1,1,.5,.5,2,0,0,0,0
"PRADIPTA",2,0,1,0,2,1,0,1,0
"PRAGEETH",2,0,1,0,2,1,0,1,0
"PRANAB",2,0,1,0,2,1,0,1,0
"PRANEE",0,2,0,1,2,0,1,0,1
"PRATHAM",2,0,1,0,2,1,0,1,0
"PRATHAP",2,0,1,0,2,1,0,1,0
"PRAVESH",2,0,1,0,2,1,0,1,0
"PRECISE",2,0,1,0,2,1,0,1,0
"PREETIE",0,2,0,1,2,0,1,0,1
"PREEYA",0,2,0,1,2,0,1,0,1
"PREME",2,0,1,0,2,1,0,1,0
"PREMO",2,0,1,0,2,1,0,1,0
"PRENTIS",2,0,1,0,2,1,0,1,0
"PRIMETIME",2,0,1,0,2,1,0,1,0
"PRINCIPE",2,0,1,0,2,1,0,1,0
"PRINGLE",1,1,.5,.5,2,0,0,0,0
"PRISCILLIA",0,2,0,1,2,0,1,0,1
"PRISM",0,2,0,1,2,0,1,0,1
"PRIT",1,1,.5,.5,2,0,0,0,0
"PRITA",0,2,0,1,2,0,1,0,1
"PRIYADARSHAN",2,0,1,0,2,1,0,1,0
"PRIYANGA",0,2,0,1,2,0,1,0,1
"PROBUS",2,0,1,0,2,1,0,1,0
"PRODIGY",2,0,1,0,2,1,0,1,0
"PROMZY",2,0,1,0,2,1,0,1,0
"PRONAB",2,0,1,0,2,1,0,1,0
"PU",1,1,.5,.5,2,0,0,0,0
"PUNK",0,2,0,1,2,0,1,0,1
"PURAV",2,0,1,0,2,1,0,1,0
"PURVIS",2,0,1,0,2,1,0,1,0
"PUTZ",1,1,.5,.5,2,0,0,0,0
"PYE",2,0,1,0,2,1,0,1,0
"QAAIM",2,0,1,0,2,1,0,1,0
"QIKUN",2,0,1,0,2,1,0,1,0
"QINA",0,2,0,1,2,0,1,0,1
"QUADIR",2,0,1,0,2,1,0,1,0
"QUAISHA",0,2,0,1,2,0,1,0,1
"QUAKE",2,0,1,0,2,1,0,1,0
"QUAMI",2,0,1,0,2,1,0,1,0
"QUANEISHA",0,2,0,1,2,0,1,0,1
"QUANN",2,0,1,0,2,1,0,1,0
"QUAYSHAWN",2,0,1,0,2,1,0,1,0
"QUAZI",1,1,.5,.5,2,0,0,0,0
"QUEN",2,0,1,0,2,1,0,1,0
"QUETCY",0,2,0,1,2,0,1,0,1
"QUINESHA",0,2,0,1,2,0,1,0,1
"QUINETTE",0,2,0,1,2,0,1,0,1
"QUINNEL",2,0,1,0,2,1,0,1,0
"QUINONES",0,2,0,1,2,0,1,0,1
"QUIRICO",2,0,1,0,2,1,0,1,0
"QUISQUELLA",0,2,0,1,2,0,1,0,1
"QURAT",0,2,0,1,2,0,1,0,1
"QUWAN",1,1,.5,.5,2,0,0,0,0
"QUY",1,1,.5,.5,2,0,0,0,0
"QWAME",2,0,1,0,2,1,0,1,0
"RAAB",2,0,1,0,2,1,0,1,0
"RABIYAH",0,2,0,1,2,0,1,0,1
"RACHITA",0,2,0,1,2,0,1,0,1
"RADICAL",2,0,1,0,2,1,0,1,0
"RADYS",1,1,.5,.5,2,0,0,0,0
"RAEDAWN",0,2,0,1,2,0,1,0,1
"RAFIKI",0,2,0,1,2,0,1,0,1
"RAGGI",1,1,.5,.5,2,0,0,0,0
"RAHKEEM",2,0,1,0,2,1,0,1,0
"RAHSEAN",2,0,1,0,2,1,0,1,0
"RAHSHA",0,2,0,1,2,0,1,0,1
"RAINMAKER",2,0,1,0,2,1,0,1,0
"RAINN",0,2,0,1,2,0,1,0,1
"RAJASHREE",0,2,0,1,2,0,1,0,1
"RAJE",0,2,0,1,2,0,1,0,1
"RAJH",2,0,1,0,2,1,0,1,0
"RAJIN",2,0,1,0,2,1,0,1,0
"RAJKUMAR",2,0,1,0,2,1,0,1,0
"RAJNEESH",2,0,1,0,2,1,0,1,0
"RAJNESH",2,0,1,0,2,1,0,1,0
"RAKEFET",0,2,0,1,2,0,1,0,1
"RAKHEL",0,2,0,1,2,0,1,0,1
"RAKHIL",1,1,.5,.5,2,0,0,0,0
"RALPHAEL",2,0,1,0,2,1,0,1,0
"RAMATOULAYE",0,2,0,1,2,0,1,0,1
"RAMBERT",2,0,1,0,2,1,0,1,0
"RAME",2,0,1,0,2,1,0,1,0
"RAMEN",2,0,1,0,2,1,0,1,0
"RANALDO",2,0,1,0,2,1,0,1,0
"RANDEL",2,0,1,0,2,1,0,1,0
"RANGANA",2,0,1,0,2,1,0,1,0
"RANJANI",0,2,0,1,2,0,1,0,1
"RANN",1,1,.5,.5,2,0,0,0,0
"RANNIE",1,1,.5,.5,2,0,0,0,0
"RANU",1,1,.5,.5,2,0,0,0,0
"RAPHEL",2,0,1,0,2,1,0,1,0
"RAQUEA",0,2,0,1,2,0,1,0,1
"RASCHID",2,0,1,0,2,1,0,1,0
"RASHAE",0,2,0,1,2,0,1,0,1
"RASHANDA",0,2,0,1,2,0,1,0,1
"RASHEEMA",0,2,0,1,2,0,1,0,1
"RASHITA",0,2,0,1,2,0,1,0,1
"RAT",1,1,.5,.5,2,0,0,0,0
"RATI",1,1,.5,.5,2,0,0,0,0
"RATIH",0,2,0,1,2,0,1,0,1
"RATIQUE",2,0,1,0,2,1,0,1,0
"RAUDO",2,0,1,0,2,1,0,1,0
"RAULY",1,1,.5,.5,2,0,0,0,0
"RAVEENA",0,2,0,1,2,0,1,0,1
"RAWAD",2,0,1,0,2,1,0,1,0
"RAYANNE",0,2,0,1,2,0,1,0,1
"RAYGAN",1,1,.5,.5,2,0,0,0,0
"RAYMAR",2,0,1,0,2,1,0,1,0
"RAYNITA",0,2,0,1,2,0,1,0,1
"RAYNOLD",2,0,1,0,2,1,0,1,0
"RAYVONNE",1,1,.5,.5,2,0,0,0,0
"RAZMIG",2,0,1,0,2,1,0,1,0
"REBBECA",0,2,0,1,2,0,1,0,1
"RECE",0,2,0,1,2,0,1,0,1
"RECESSION",2,0,1,0,2,1,0,1,0
"REDI",2,0,1,0,2,1,0,1,0
"REDOY",2,0,1,0,2,1,0,1,0
"REEF",2,0,1,0,2,1,0,1,0
"REENIE",0,2,0,1,2,0,1,0,1
"REFAAT",2,0,1,0,2,1,0,1,0
"REFI",1,1,.5,.5,2,0,0,0,0
"REFLECTION",2,0,1,0,2,1,0,1,0
"REFUGIO",2,0,1,0,2,1,0,1,0
"REGENE",0,2,0,1,2,0,1,0,1
"REGIANE",0,2,0,1,2,0,1,0,1
"REGIE",1,1,.5,.5,2,0,0,0,0
"REHAB",0,2,0,1,2,0,1,0,1
"REIS",2,0,1,0,2,1,0,1,0
"REKI",2,0,1,0,2,1,0,1,0
"REKO",2,0,1,0,2,1,0,1,0
"RELLO",2,0,1,0,2,1,0,1,0
"REMEE",0,2,0,1,2,0,1,0,1
"REMICK",1,1,.5,.5,2,0,0,0,0
"REMMY",2,0,1,0,2,1,0,1,0
"REMONIA",0,2,0,1,2,0,1,0,1
"RENAISSANCE",2,0,1,0,2,1,0,1,0
"RENCE",2,0,1,0,2,1,0,1,0
"RENEE-MARIE",0,2,0,1,2,0,1,0,1
"RENEL",2,0,1,0,2,1,0,1,0
"RENETTA",0,2,0,1,2,0,1,0,1
"RENOLY",2,0,1,0,2,1,0,1,0
"RENSO",2,0,1,0,2,1,0,1,0
"REPS",2,0,1,0,2,1,0,1,0
"REVEKA",0,2,0,1,2,0,1,0,1
"REYLIN",1,1,.5,.5,2,0,0,0,0
"REYNALD",2,0,1,0,2,1,0,1,0
"REYNIR",2,0,1,0,2,1,0,1,0
"RHEN",2,0,1,0,2,1,0,1,0
"RHEYA",0,2,0,1,2,0,1,0,1
"RICARDA",0,2,0,1,2,0,1,0,1
"RICCY",1,1,.5,.5,2,0,0,0,0
"RICHBOY",2,0,1,0,2,1,0,1,0
"RICHERT",2,0,1,0,2,1,0,1,0
"RICKERBY",0,2,0,1,2,0,1,0,1
"RIDER",1,1,.5,.5,2,0,0,0,0
"RIDLEY",2,0,1,0,2,1,0,1,0
"RIFA",0,2,0,1,2,0,1,0,1
"RIINA",0,2,0,1,2,0,1,0,1
"RIJIN",1,1,.5,.5,2,0,0,0,0
"RIMMY",0,2,0,1,2,0,1,0,1
"RINDA",0,2,0,1,2,0,1,0,1
"RINKO",1,1,.5,.5,2,0,0,0,0
"RINNA",0,2,0,1,2,0,1,0,1
"RIPPER",2,0,1,0,2,1,0,1,0
"RISEL",1,1,.5,.5,2,0,0,0,0
"RISHARD",2,0,1,0,2,1,0,1,0
"RISHAWN",2,0,1,0,2,1,0,1,0
"RISHIE",2,0,1,0,2,1,0,1,0
"RISTORANTE",2,0,1,0,2,1,0,1,0
"RIT",2,0,1,0,2,1,0,1,0
"RITCHY",2,0,1,0,2,1,0,1,0
"RIVO",2,0,1,0,2,1,0,1,0
"RIVYA",0,2,0,1,2,0,1,0,1
"ROBARE",2,0,1,0,2,1,0,1,0
"ROBESON",2,0,1,0,2,1,0,1,0
"ROCKEEM",2,0,1,0,2,1,0,1,0
"ROCQUEL",0,2,0,1,2,0,1,0,1
"ROCSY",0,2,0,1,2,0,1,0,1
"RODDIE",2,0,1,0,2,1,0,1,0
"RODOLPH",2,0,1,0,2,1,0,1,0
"RODOLPHO",2,0,1,0,2,1,0,1,0
"ROGET",2,0,1,0,2,1,0,1,0
"ROHEEN",2,0,1,0,2,1,0,1,0
"ROKO",2,0,1,0,2,1,0,1,0
"ROLDAN",2,0,1,0,2,1,0,1,0
"ROLFY",2,0,1,0,2,1,0,1,0
"ROLON",1,1,.5,.5,2,0,0,0,0
"ROLSTON",2,0,1,0,2,1,0,1,0
"ROMAH",1,1,.5,.5,2,0,0,0,0
"ROMARIC",2,0,1,0,2,1,0,1,0
"ROMELLO",2,0,1,0,2,1,0,1,0
"RONADA",0,2,0,1,2,0,1,0,1
"RONIECE",0,2,0,1,2,0,1,0,1
"RONO",2,0,1,0,2,1,0,1,0
"ROOMANA",0,2,0,1,2,0,1,0,1
"ROOP",1,1,.5,.5,2,0,0,0,0
"ROOPRAM",2,0,1,0,2,1,0,1,0
"RO-RO",1,1,.5,.5,2,0,0,0,0
"ROSABELLE",0,2,0,1,2,0,1,0,1
"ROSAEL",0,2,0,1,2,0,1,0,1
"ROSALES",1,1,.5,.5,2,0,0,0,0
"ROSALVA",0,2,0,1,2,0,1,0,1
"ROSARITO",0,2,0,1,2,0,1,0,1
"ROSAURO",2,0,1,0,2,1,0,1,0
"ROSE-ANN",0,2,0,1,2,0,1,0,1
"ROSEBUD",0,2,0,1,2,0,1,0,1
"ROSENDA",0,2,0,1,2,0,1,0,1
"ROSHANNA",0,2,0,1,2,0,1,0,1
"ROSHIDA",0,2,0,1,2,0,1,0,1
"ROSIANE",0,2,0,1,2,0,1,0,1
"ROSILAND",0,2,0,1,2,0,1,0,1
"ROSMAN",1,1,.5,.5,2,0,0,0,0
"ROSOLINO",2,0,1,0,2,1,0,1,0
"ROTSEN",2,0,1,0,2,1,0,1,0
"ROYLAND",2,0,1,0,2,1,0,1,0
"ROYWILLIAM",2,0,1,0,2,1,0,1,0
"ROZENN",0,2,0,1,2,0,1,0,1
"RUAIRI",2,0,1,0,2,1,0,1,0
"RUAN",2,0,1,0,2,1,0,1,0
"RUANNY",2,0,1,0,2,1,0,1,0
"RUBYY",0,2,0,1,2,0,1,0,1
"RUCHELLE",0,2,0,1,2,0,1,0,1
"RUD",2,0,1,0,2,1,0,1,0
"RUDRA",2,0,1,0,2,1,0,1,0
"RUKA",1,1,.5,.5,2,0,0,0,0
"RULE",2,0,1,0,2,1,0,1,0
"RUMA",0,2,0,1,2,0,1,0,1
"RUNG",0,2,0,1,2,0,1,0,1
"RUNITA",0,2,0,1,2,0,1,0,1
"RUSHA",0,2,0,1,2,0,1,0,1
"RUSMIR",2,0,1,0,2,1,0,1,0
"RUSSI",2,0,1,0,2,1,0,1,0
"RUSSO",2,0,1,0,2,1,0,1,0
"RUSTEM",2,0,1,0,2,1,0,1,0
"RUTGERS",2,0,1,0,2,1,0,1,0
"RUTHVEN",2,0,1,0,2,1,0,1,0
"RUUD",1,1,.5,.5,2,0,0,0,0
"RUXI",0,2,0,1,2,0,1,0,1
"RYANE",0,2,0,1,2,0,1,0,1
"RYOHEI",2,0,1,0,2,1,0,1,0
"SABELLA",0,2,0,1,2,0,1,0,1
"SABNAM",0,2,0,1,2,0,1,0,1
"SABOORA",0,2,0,1,2,0,1,0,1
"SACHEM",2,0,1,0,2,1,0,1,0
"SACK",2,0,1,0,2,1,0,1,0
"SADEK",2,0,1,0,2,1,0,1,0
"SADET",0,2,0,1,2,0,1,0,1
"SAEIDA",0,2,0,1,2,0,1,0,1
"SAEN",2,0,1,0,2,1,0,1,0
"SAERA",0,2,0,1,2,0,1,0,1
"SAF",2,0,1,0,2,1,0,1,0
"SAFETA",0,2,0,1,2,0,1,0,1
"SAFIRA",0,2,0,1,2,0,1,0,1
"SAHLE",2,0,1,0,2,1,0,1,0
"SAIDU",2,0,1,0,2,1,0,1,0
"SAIKOU",2,0,1,0,2,1,0,1,0
"SAINTS",2,0,1,0,2,1,0,1,0
"SAIRIS",0,2,0,1,2,0,1,0,1
"SAISHA",0,2,0,1,2,0,1,0,1
"SAJIDA",0,2,0,1,2,0,1,0,1
"SAJIV",2,0,1,0,2,1,0,1,0
"SAKO",2,0,1,0,2,1,0,1,0
"SAKURAKO",0,2,0,1,2,0,1,0,1
"SALAHUDIN",2,0,1,0,2,1,0,1,0
"SALAR",2,0,1,0,2,1,0,1,0
"SALIU",2,0,1,0,2,1,0,1,0
"SALVA",1,1,.5,.5,2,0,0,0,0
"SAMBATH",0,2,0,1,2,0,1,0,1
"SAMBIT",2,0,1,0,2,1,0,1,0
"SAMEL",2,0,1,0,2,1,0,1,0
"SAMIKSHA",0,2,0,1,2,0,1,0,1
"SAMIL",2,0,1,0,2,1,0,1,0
"SAMIRAH",0,2,0,1,2,0,1,0,1
"SAMIYAH",0,2,0,1,2,0,1,0,1
"SAMUELS",0,2,0,1,2,0,1,0,1
"SANCHEZ-LOPEZ",1,1,.5,.5,2,0,0,0,0
"SANDMAN",2,0,1,0,2,1,0,1,0
"SANDREEN",0,2,0,1,2,0,1,0,1
"SANDRENE",0,2,0,1,2,0,1,0,1
"SANGA",1,1,.5,.5,2,0,0,0,0
"SANGE",2,0,1,0,2,1,0,1,0
"SANGHYUN",2,0,1,0,2,1,0,1,0
"SANGIE",0,2,0,1,2,0,1,0,1
"SANGRAM",2,0,1,0,2,1,0,1,0
"SANGYUN",2,0,1,0,2,1,0,1,0
"SANIQUE",0,2,0,1,2,0,1,0,1
"SANMI",2,0,1,0,2,1,0,1,0
"SANNIA",0,2,0,1,2,0,1,0,1
"SANON",1,1,.5,.5,2,0,0,0,0
"SANORA",0,2,0,1,2,0,1,0,1
"SANOVIA",0,2,0,1,2,0,1,0,1
"SANTONU",2,0,1,0,2,1,0,1,0
"SANY",1,1,.5,.5,2,0,0,0,0
"SAPHIA",0,2,0,1,2,0,1,0,1
"SARAH-JAYNE",0,2,0,1,2,0,1,0,1
"SARAH-MICHELLE",0,2,0,1,2,0,1,0,1
"SARALYNN",0,2,0,1,2,0,1,0,1
"SARELA",0,2,0,1,2,0,1,0,1
"SAREN",0,2,0,1,2,0,1,0,1
"SARFRAZ",2,0,1,0,2,1,0,1,0
"SARGEANT",2,0,1,0,2,1,0,1,0
"SARGIS",2,0,1,0,2,1,0,1,0
"SARIN",1,1,.5,.5,2,0,0,0,0
"SARMA",0,2,0,1,2,0,1,0,1
"SARPER",2,0,1,0,2,1,0,1,0
"SARTHAK",2,0,1,0,2,1,0,1,0
"SARYTA",0,2,0,1,2,0,1,0,1
"SASE",2,0,1,0,2,1,0,1,0
"SASHAY",0,2,0,1,2,0,1,0,1
"SASHIKA",0,2,0,1,2,0,1,0,1
"SASSA",1,1,.5,.5,2,0,0,0,0
"SATARRA",0,2,0,1,2,0,1,0,1
"SATIA",0,2,0,1,2,0,1,0,1
"SATIAGO",1,1,.5,.5,2,0,0,0,0
"SATTA",0,2,0,1,2,0,1,0,1
"SATYADEEP",2,0,1,0,2,1,0,1,0
"SATYAJEET",2,0,1,0,2,1,0,1,0
"SATYANARAYANA",2,0,1,0,2,1,0,1,0
"SAUCE",1,1,.5,.5,2,0,0,0,0
"SAUGAT",2,0,1,0,2,1,0,1,0
"SAULI",1,1,.5,.5,2,0,0,0,0
"SAUREL",2,0,1,0,2,1,0,1,0
"SAURY",0,2,0,1,2,0,1,0,1
"SAV",2,0,1,0,2,1,0,1,0
"SAVASIA",0,2,0,1,2,0,1,0,1
"SAVENA",0,2,0,1,2,0,1,0,1
"SAVINO",2,0,1,0,2,1,0,1,0
"SAWYER",2,0,1,0,2,1,0,1,0
"SAYAKO",0,2,0,1,2,0,1,0,1
"SAYEDA",0,2,0,1,2,0,1,0,1
"SAYLOR",0,2,0,1,2,0,1,0,1
"SAYYED",2,0,1,0,2,1,0,1,0
"SAYYID",2,0,1,0,2,1,0,1,0
"SAZID",2,0,1,0,2,1,0,1,0
"SCHEHERAZADE",0,2,0,1,2,0,1,0,1
"SCHUBERT",2,0,1,0,2,1,0,1,0
"SCORPEO",2,0,1,0,2,1,0,1,0
"SCORPIAN",2,0,1,0,2,1,0,1,0
"SCREAMING",1,1,.5,.5,2,0,0,0,0
"SCROOGE",2,0,1,0,2,1,0,1,0
"SEANCARLOS",2,0,1,0,2,1,0,1,0
"SEANDELL",1,1,.5,.5,2,0,0,0,0
"SEAON",2,0,1,0,2,1,0,1,0
"SEBAHAT",0,2,0,1,2,0,1,0,1
"SEBANTI",0,2,0,1,2,0,1,0,1
"SEDAR",2,0,1,0,2,1,0,1,0
"SEDLEY",2,0,1,0,2,1,0,1,0
"SEEDY",2,0,1,0,2,1,0,1,0
"SEEFA",0,2,0,1,2,0,1,0,1
"SEF",2,0,1,0,2,1,0,1,0
"SEFRA",0,2,0,1,2,0,1,0,1
"SEFTON",2,0,1,0,2,1,0,1,0
"SEK",2,0,1,0,2,1,0,1,0
"SELECTOR",2,0,1,0,2,1,0,1,0
"SELETA",0,2,0,1,2,0,1,0,1
"SELI",0,2,0,1,2,0,1,0,1
"SEMION",2,0,1,0,2,1,0,1,0
"SENAT",2,0,1,0,2,1,0,1,0
"SENER",2,0,1,0,2,1,0,1,0
"SENSE",2,0,1,0,2,1,0,1,0
"SEONJEONG",0,2,0,1,2,0,1,0,1
"SEPTI",0,2,0,1,2,0,1,0,1
"SEREY",1,1,.5,.5,2,0,0,0,0
"SERGEJ",2,0,1,0,2,1,0,1,0
"SERIF",2,0,1,0,2,1,0,1,0
"SERITI",0,2,0,1,2,0,1,0,1
"SERPENT",1,1,.5,.5,2,0,0,0,0
"SERVON",1,1,.5,.5,2,0,0,0,0
"SESAME",2,0,1,0,2,1,0,1,0
"SESI",1,1,.5,.5,2,0,0,0,0
"SETON",1,1,.5,.5,2,0,0,0,0
"SEUNGWON",2,0,1,0,2,1,0,1,0
"SEUNG-YEON",0,2,0,1,2,0,1,0,1
"SEV",2,0,1,0,2,1,0,1,0
"SEVCAN",0,2,0,1,2,0,1,0,1
"SEVERINO",2,0,1,0,2,1,0,1,0
"SEWIT",1,1,.5,.5,2,0,0,0,0
"SEYIT",2,0,1,0,2,1,0,1,0
"SEYMONE",0,2,0,1,2,0,1,0,1
"SEYMORE",0,2,0,1,2,0,1,0,1
"SHABRIA",0,2,0,1,2,0,1,0,1
"SHACOLE",0,2,0,1,2,0,1,0,1
"SHADDAE",0,2,0,1,2,0,1,0,1
"SHADRA",0,2,0,1,2,0,1,0,1
"SHAFAAT",2,0,1,0,2,1,0,1,0
"SHAFFICK",2,0,1,0,2,1,0,1,0
"SHAFRAZ",2,0,1,0,2,1,0,1,0
"SHAHARYAR",2,0,1,0,2,1,0,1,0
"SHAHI",2,0,1,0,2,1,0,1,0
"SHAHIDUR",2,0,1,0,2,1,0,1,0
"SHAHINA",0,2,0,1,2,0,1,0,1
"SHAHNUR",2,0,1,0,2,1,0,1,0
"SHAHZAIB",2,0,1,0,2,1,0,1,0
"SHAHZEB",2,0,1,0,2,1,0,1,0
"SHAILENDRA",2,0,1,0,2,1,0,1,0
"SHAINDEL",0,2,0,1,2,0,1,0,1
"SHAIRE",0,2,0,1,2,0,1,0,1
"SHAKEEN",1,1,.5,.5,2,0,0,0,0
"SHAKEMIA",0,2,0,1,2,0,1,0,1
"SHAKIEMA",0,2,0,1,2,0,1,0,1
"SHAKILUR",2,0,1,0,2,1,0,1,0
"SHAKITA",0,2,0,1,2,0,1,0,1
"SHAKYA",1,1,.5,.5,2,0,0,0,0
"SHAL",2,0,1,0,2,1,0,1,0
"SHALAH",1,1,.5,.5,2,0,0,0,0
"SHALANA",0,2,0,1,2,0,1,0,1
"SHALAYA",0,2,0,1,2,0,1,0,1
"SHALETTE",0,2,0,1,2,0,1,0,1
"SHALICE",0,2,0,1,2,0,1,0,1
"SHALIK",1,1,.5,.5,2,0,0,0,0
"SHALISSE",0,2,0,1,2,0,1,0,1
"SHALO",1,1,.5,.5,2,0,0,0,0
"SHAMARIE",0,2,0,1,2,0,1,0,1
"SHAMELLA",0,2,0,1,2,0,1,0,1
"SHAMESE",0,2,0,1,2,0,1,0,1
"SHAMIQUA",0,2,0,1,2,0,1,0,1
"SHAMISHA",0,2,0,1,2,0,1,0,1
"SHAMOON",1,1,.5,.5,2,0,0,0,0
"SHANAA",0,2,0,1,2,0,1,0,1
"SHANEI",0,2,0,1,2,0,1,0,1
"SHANEIL",0,2,0,1,2,0,1,0,1
"SHANERA",0,2,0,1,2,0,1,0,1
"SHANIKAH",0,2,0,1,2,0,1,0,1
"SHANKIA",0,2,0,1,2,0,1,0,1
"SHANNAKAY",0,2,0,1,2,0,1,0,1
"SHANNTEL",0,2,0,1,2,0,1,0,1
"SHANOAH",0,2,0,1,2,0,1,0,1
"SHANOI",2,0,1,0,2,1,0,1,0
"SHANTELLA",0,2,0,1,2,0,1,0,1
"SHANTESE",0,2,0,1,2,0,1,0,1
"SHANTHI",0,2,0,1,2,0,1,0,1
"SHANTO",2,0,1,0,2,1,0,1,0
"SHANTRESE",0,2,0,1,2,0,1,0,1
"SHANYN",0,2,0,1,2,0,1,0,1
"SHAQUALA",0,2,0,1,2,0,1,0,1
"SHAQUASIA",0,2,0,1,2,0,1,0,1
"SHAQUAWNA",0,2,0,1,2,0,1,0,1
"SHAQUEENA",0,2,0,1,2,0,1,0,1
"SHAQUONA",0,2,0,1,2,0,1,0,1
"SHAQWAN",1,1,.5,.5,2,0,0,0,0
"SHARAYE",0,2,0,1,2,0,1,0,1
"SHAREETA",0,2,0,1,2,0,1,0,1
"SHAREFA",0,2,0,1,2,0,1,0,1
"SHAREL",0,2,0,1,2,0,1,0,1
"SHARETTA",0,2,0,1,2,0,1,0,1
"SHARMECA",0,2,0,1,2,0,1,0,1
"SHARRY",0,2,0,1,2,0,1,0,1
"SHARUKH",2,0,1,0,2,1,0,1,0
"SHARWAN",2,0,1,0,2,1,0,1,0
"SHASHWAT",2,0,1,0,2,1,0,1,0
"SHATASIA",0,2,0,1,2,0,1,0,1
"SHATERA",0,2,0,1,2,0,1,0,1
"SHATI",0,2,0,1,2,0,1,0,1
"SHATORA",0,2,0,1,2,0,1,0,1
"SHAUGHN",2,0,1,0,2,1,0,1,0
"SHAUNELL",0,2,0,1,2,0,1,0,1
"SHAUNETTA",0,2,0,1,2,0,1,0,1
"SHAURI",0,2,0,1,2,0,1,0,1
"SHAURYA",2,0,1,0,2,1,0,1,0
"SHAVA",1,1,.5,.5,2,0,0,0,0
"SHAVANNA",0,2,0,1,2,0,1,0,1
"SHAWNEEN",0,2,0,1,2,0,1,0,1
"SHAWNTAVIA",0,2,0,1,2,0,1,0,1
"SHAWNTELL",0,2,0,1,2,0,1,0,1
"SHAWNTIA",0,2,0,1,2,0,1,0,1
"SHAYMAA",0,2,0,1,2,0,1,0,1
"SHAYNAE",0,2,0,1,2,0,1,0,1
"SHECKY",0,2,0,1,2,0,1,0,1
"SHEEHAN",2,0,1,0,2,1,0,1,0
"SHEEPSHEAD",2,0,1,0,2,1,0,1,0
"SHEFFALI",0,2,0,1,2,0,1,0,1
"SHEFQET",2,0,1,0,2,1,0,1,0
"SHEILEEN",0,2,0,1,2,0,1,0,1
"SHEKA",0,2,0,1,2,0,1,0,1
"SHEKINAH",0,2,0,1,2,0,1,0,1
"SHELLE",0,2,0,1,2,0,1,0,1
"SHELLION",0,2,0,1,2,0,1,0,1
"SHELLS",1,1,.5,.5,2,0,0,0,0
"SHEMENE",0,2,0,1,2,0,1,0,1
"SHENDY",0,2,0,1,2,0,1,0,1
"SHENGJIE",1,1,.5,.5,2,0,0,0,0
"SHENISE",0,2,0,1,2,0,1,0,1
"SHENOUDA",2,0,1,0,2,1,0,1,0
"SHEPARD",2,0,1,0,2,1,0,1,0
"SHEQUANA",0,2,0,1,2,0,1,0,1
"SHERAH",0,2,0,1,2,0,1,0,1
"SHERANN",0,2,0,1,2,0,1,0,1
"SHERDINA",0,2,0,1,2,0,1,0,1
"SHEREEF",2,0,1,0,2,1,0,1,0
"SHERELYN",0,2,0,1,2,0,1,0,1
"SHERESA",0,2,0,1,2,0,1,0,1
"SHERIAN",0,2,0,1,2,0,1,0,1
"SHERIE-ANN",0,2,0,1,2,0,1,0,1
"SHERLAN",1,1,.5,.5,2,0,0,0,0
"SHERLET",0,2,0,1,2,0,1,0,1
"SHERNA",0,2,0,1,2,0,1,0,1
"SHERNET",0,2,0,1,2,0,1,0,1
"SHERONE",0,2,0,1,2,0,1,0,1
"SHERRARD",2,0,1,0,2,1,0,1,0
"SHERRILYN",0,2,0,1,2,0,1,0,1
"SHEUNG",0,2,0,1,2,0,1,0,1
"SHEVONE",1,1,.5,.5,2,0,0,0,0
"SHEZAD",2,0,1,0,2,1,0,1,0
"SHIDEH",0,2,0,1,2,0,1,0,1
"SHIFFON",0,2,0,1,2,0,1,0,1
"SHIG",2,0,1,0,2,1,0,1,0
"SHIGEO",2,0,1,0,2,1,0,1,0
"SHIKINA",0,2,0,1,2,0,1,0,1
"SHINELLE",0,2,0,1,2,0,1,0,1
"SHINIECE",0,2,0,1,2,0,1,0,1
"SHIQUANA",0,2,0,1,2,0,1,0,1
"SHIRLAND",1,1,.5,.5,2,0,0,0,0
"SHIRLETTA",0,2,0,1,2,0,1,0,1
"SHISHI",0,2,0,1,2,0,1,0,1
"SHIVANG",2,0,1,0,2,1,0,1,0
"SHIVIKA",0,2,0,1,2,0,1,0,1
"SHLONG",2,0,1,0,2,1,0,1,0
"SHOBY",2,0,1,0,2,1,0,1,0
"SHOGUN",2,0,1,0,2,1,0,1,0
"SHOMIT",2,0,1,0,2,1,0,1,0
"SHONALI",0,2,0,1,2,0,1,0,1
"SHONIA",0,2,0,1,2,0,1,0,1
"SHONNI",0,2,0,1,2,0,1,0,1
"SHPENDI",2,0,1,0,2,1,0,1,0
"SHRAVANI",0,2,0,1,2,0,1,0,1
"SHRIDHAR",2,0,1,0,2,1,0,1,0
"SHRINATH",2,0,1,0,2,1,0,1,0
"SHUHRAT",2,0,1,0,2,1,0,1,0
"SHULEM",2,0,1,0,2,1,0,1,0
"SHUTTER",2,0,1,0,2,1,0,1,0
"SHUYING",0,2,0,1,2,0,1,0,1
"SHWAN",1,1,.5,.5,2,0,0,0,0
"SHWETAL",0,2,0,1,2,0,1,0,1
"SHYA",1,1,.5,.5,2,0,0,0,0
"SHYAMALA",0,2,0,1,2,0,1,0,1
"SHYAN",1,1,.5,.5,2,0,0,0,0
"SHYLER",1,1,.5,.5,2,0,0,0,0
"SHYVONNE",0,2,0,1,2,0,1,0,1
"SIBTAIN",2,0,1,0,2,1,0,1,0
"SIDE",0,2,0,1,2,0,1,0,1
"SIEGFRED",2,0,1,0,2,1,0,1,0
"SIF",2,0,1,0,2,1,0,1,0
"SIJIN",2,0,1,0,2,1,0,1,0
"SILDA",0,2,0,1,2,0,1,0,1
"SIMBARASHE",2,0,1,0,2,1,0,1,0
"SIMIA",0,2,0,1,2,0,1,0,1
"SINAR",2,0,1,0,2,1,0,1,0
"SINGER",1,1,.5,.5,2,0,0,0,0
"SINTHYA",0,2,0,1,2,0,1,0,1
"SIRISH",2,0,1,0,2,1,0,1,0
"SISCO",2,0,1,0,2,1,0,1,0
"SIX",2,0,1,0,2,1,0,1,0
"SIXTA",0,2,0,1,2,0,1,0,1
"SKEETER",1,1,.5,.5,2,0,0,0,0
"SKRILLA",2,0,1,0,2,1,0,1,0
"SLADJAN",2,0,1,0,2,1,0,1,0
"SLATER",1,1,.5,.5,2,0,0,0,0
"SLAVO",2,0,1,0,2,1,0,1,0
"SLINDILE",0,2,0,1,2,0,1,0,1
"SMAIL",2,0,1,0,2,1,0,1,0
"SMOKE",2,0,1,0,2,1,0,1,0
"SMOKIE",2,0,1,0,2,1,0,1,0
"SMOOV",2,0,1,0,2,1,0,1,0
"SNORRI",2,0,1,0,2,1,0,1,0
"SOCA",1,1,.5,.5,2,0,0,0,0
"SOEUN",0,2,0,1,2,0,1,0,1
"SOFFY",0,2,0,1,2,0,1,0,1
"SOLIVETTE",0,2,0,1,2,0,1,0,1
"SOM",2,0,1,0,2,1,0,1,0
"SONDA",0,2,0,1,2,0,1,0,1
"SONDES",0,2,0,1,2,0,1,0,1
"SONGS",2,0,1,0,2,1,0,1,0
"SOORAJ",2,0,1,0,2,1,0,1,0
"SOPHANA",1,1,.5,.5,2,0,0,0,0
"SOPHI",0,2,0,1,2,0,1,0,1
"SOPHIANE",2,0,1,0,2,1,0,1,0
"SOR",2,0,1,0,2,1,0,1,0
"SORANA",0,2,0,1,2,0,1,0,1
"SORANGY",0,2,0,1,2,0,1,0,1
"SORELIS",0,2,0,1,2,0,1,0,1
"SORINA",0,2,0,1,2,0,1,0,1
"SOTERO",2,0,1,0,2,1,0,1,0
"SOUHAIL",2,0,1,0,2,1,0,1,0
"SOUKEYNA",0,2,0,1,2,0,1,0,1
"SOYDAN",1,1,.5,.5,2,0,0,0,0
"SPARROW",1,1,.5,.5,2,0,0,0,0
"SPAS",2,0,1,0,2,1,0,1,0
"SPAZ",2,0,1,0,2,1,0,1,0
"SPIEGEL",1,1,.5,.5,2,0,0,0,0
"SPIELBERG",2,0,1,0,2,1,0,1,0
"SPLASH",2,0,1,0,2,1,0,1,0
"SPUNKY",1,1,.5,.5,2,0,0,0,0
"SREEKANTH",2,0,1,0,2,1,0,1,0
"SRIJANA",0,2,0,1,2,0,1,0,1
"SRIKAR",2,0,1,0,2,1,0,1,0
"SRINATH",2,0,1,0,2,1,0,1,0
"STACCI",0,2,0,1,2,0,1,0,1
"STACII",0,2,0,1,2,0,1,0,1
"STAFFAN",2,0,1,0,2,1,0,1,0
"STAIN",2,0,1,0,2,1,0,1,0
"STANIA",0,2,0,1,2,0,1,0,1
"STANISLAW",2,0,1,0,2,1,0,1,0
"STARLINA",0,2,0,1,2,0,1,0,1
"STARLYN",1,1,.5,.5,2,0,0,0,0
"STARRE",0,2,0,1,2,0,1,0,1
"STARS",0,2,0,1,2,0,1,0,1
"STARSCREAM",2,0,1,0,2,1,0,1,0
"STARSHA",0,2,0,1,2,0,1,0,1
"STASIE",0,2,0,1,2,0,1,0,1
"STATUE",0,2,0,1,2,0,1,0,1
"STAVRO",2,0,1,0,2,1,0,1,0
"STEARNS",1,1,.5,.5,2,0,0,0,0
"STEFANA",0,2,0,1,2,0,1,0,1
"STEPHANEE",0,2,0,1,2,0,1,0,1
"STEPHNIE",0,2,0,1,2,0,1,0,1
"STOCKTON",0,2,0,1,2,0,1,0,1
"STONI",1,1,.5,.5,2,0,0,0,0
"STUCKEY",2,0,1,0,2,1,0,1,0
"STYLESZ",2,0,1,0,2,1,0,1,0
"SUBHAN",2,0,1,0,2,1,0,1,0
"SUBWAY",0,2,0,1,2,0,1,0,1
"SUCRE",2,0,1,0,2,1,0,1,0
"SUDHANSHU",2,0,1,0,2,1,0,1,0
"SUDI",1,1,.5,.5,2,0,0,0,0
"SUE-ANNE",0,2,0,1,2,0,1,0,1
"SUELEE",0,2,0,1,2,0,1,0,1
"SUELYN",0,2,0,1,2,0,1,0,1
"SUG",1,1,.5,.5,2,0,0,0,0
"SUHROB",2,0,1,0,2,1,0,1,0
"SUJA",0,2,0,1,2,0,1,0,1
"SUKHA",2,0,1,0,2,1,0,1,0
"SUKHDEV",2,0,1,0,2,1,0,1,0
"SUKHPREET",2,0,1,0,2,1,0,1,0
"SUKHROB",2,0,1,0,2,1,0,1,0
"SULAYMAN",2,0,1,0,2,1,0,1,0
"SULI",2,0,1,0,2,1,0,1,0
"SUMAYAH",0,2,0,1,2,0,1,0,1
"SUMBUL",0,2,0,1,2,0,1,0,1
"SUMER",0,2,0,1,2,0,1,0,1
"SUMERA",0,2,0,1,2,0,1,0,1
"SUMMAIYA",0,2,0,1,2,0,1,0,1
"SUNGAH",0,2,0,1,2,0,1,0,1
"SUNGGUK",2,0,1,0,2,1,0,1,0
"SUNGHOON",2,0,1,0,2,1,0,1,0
"SUNGTAE",2,0,1,0,2,1,0,1,0
"SUNISA",0,2,0,1,2,0,1,0,1
"SUNJOO",0,2,0,1,2,0,1,0,1
"SUNNEY",2,0,1,0,2,1,0,1,0
"SUNYONG",0,2,0,1,2,0,1,0,1
"SURASAK",2,0,1,0,2,1,0,1,0
"SURGE",2,0,1,0,2,1,0,1,0
"SURRENA",0,2,0,1,2,0,1,0,1
"SURUJ",2,0,1,0,2,1,0,1,0
"SUSSAN",0,2,0,1,2,0,1,0,1
"SUSSY",0,2,0,1,2,0,1,0,1
"SUVEKSHYA",0,2,0,1,2,0,1,0,1
"SUYOG",2,0,1,0,2,1,0,1,0
"SUZU",1,1,.5,.5,2,0,0,0,0
"SVETOSLAV",2,0,1,0,2,1,0,1,0
"SVYATOSLAV",2,0,1,0,2,1,0,1,0
"SWEETGIGI",0,2,0,1,2,0,1,0,1
"SWEETZ",0,2,0,1,2,0,1,0,1
"SWING",1,1,.5,.5,2,0,0,0,0
"SWITHIN",2,0,1,0,2,1,0,1,0
"SYAD",2,0,1,0,2,1,0,1,0
"SYLKE",0,2,0,1,2,0,1,0,1
"SYLMA",0,2,0,1,2,0,1,0,1
"SYLVESTRE",2,0,1,0,2,1,0,1,0
"SYMI",0,2,0,1,2,0,1,0,1
"SYNCERE",2,0,1,0,2,1,0,1,0
"SYVEL",0,2,0,1,2,0,1,0,1
"SZILARD",2,0,1,0,2,1,0,1,0
"TAAL",1,1,.5,.5,2,0,0,0,0
"TABARI",2,0,1,0,2,1,0,1,0
"TABRIA",0,2,0,1,2,0,1,0,1
"TACITURN",2,0,1,0,2,1,0,1,0
"TADDEO",2,0,1,0,2,1,0,1,0
"TADEJ",2,0,1,0,2,1,0,1,0
"TAEK",2,0,1,0,2,1,0,1,0
"TAFT",2,0,1,0,2,1,0,1,0
"TAGE",2,0,1,0,2,1,0,1,0
"TAHARKA",2,0,1,0,2,1,0,1,0
"TAHEERA",0,2,0,1,2,0,1,0,1
"TAHIEM",2,0,1,0,2,1,0,1,0
"TAHILIA",0,2,0,1,2,0,1,0,1
"TAISA",0,2,0,1,2,0,1,0,1
"TAITIANA",0,2,0,1,2,0,1,0,1
"TAIWANA",0,2,0,1,2,0,1,0,1
"TAIYE",1,1,.5,.5,2,0,0,0,0
"TAIYYAB",2,0,1,0,2,1,0,1,0
"TAKANORI",2,0,1,0,2,1,0,1,0
"TAKAYUKI",2,0,1,0,2,1,0,1,0
"TAKENIA",0,2,0,1,2,0,1,0,1
"TAKUTO",2,0,1,0,2,1,0,1,0
"TALBERT",1,1,.5,.5,2,0,0,0,0
"TALIANA",0,2,0,1,2,0,1,0,1
"TALISSA",0,2,0,1,2,0,1,0,1
"TAMAL",2,0,1,0,2,1,0,1,0
"TAMATHA",0,2,0,1,2,0,1,0,1
"TAMELL",2,0,1,0,2,1,0,1,0
"TAMIERA",0,2,0,1,2,0,1,0,1
"TAMIKHA",0,2,0,1,2,0,1,0,1
"TAMIS",1,1,.5,.5,2,0,0,0,0
"TAMIZ",2,0,1,0,2,1,0,1,0
"TAMLA",0,2,0,1,2,0,1,0,1
"TAMMER",2,0,1,0,2,1,0,1,0
"TAMMIA",0,2,0,1,2,0,1,0,1
"TAMMOI",1,1,.5,.5,2,0,0,0,0
"TAMON",1,1,.5,.5,2,0,0,0,0
"TANATACH",2,0,1,0,2,1,0,1,0
"TANDI",0,2,0,1,2,0,1,0,1
"TANEJAH",0,2,0,1,2,0,1,0,1
"TANEKQUA",0,2,0,1,2,0,1,0,1
"TANISA",0,2,0,1,2,0,1,0,1
"TANISH",1,1,.5,.5,2,0,0,0,0
"TANMAY",2,0,1,0,2,1,0,1,0
"TANWEER",2,0,1,0,2,1,0,1,0
"TANYI",0,2,0,1,2,0,1,0,1
"TANZ",1,1,.5,.5,2,0,0,0,0
"TANZIN",1,1,.5,.5,2,0,0,0,0
"TAPIO",2,0,1,0,2,1,0,1,0
"TARA-KAY",0,2,0,1,2,0,1,0,1
"TARE",2,0,1,0,2,1,0,1,0
"TARICK",2,0,1,0,2,1,0,1,0
"TARIFF",2,0,1,0,2,1,0,1,0
"TARRENCE",2,0,1,0,2,1,0,1,0
"TARSEM",2,0,1,0,2,1,0,1,0
"TASHAY",0,2,0,1,2,0,1,0,1
"TASHERIA",0,2,0,1,2,0,1,0,1
"TASHIRA",0,2,0,1,2,0,1,0,1
"TASLEEMA",0,2,0,1,2,0,1,0,1
"TASMIN",0,2,0,1,2,0,1,0,1
"TASOULA",0,2,0,1,2,0,1,0,1
"TASYA",0,2,0,1,2,0,1,0,1
"TATENDA",2,0,1,0,2,1,0,1,0
"TATISHA",0,2,0,1,2,0,1,0,1
"TATSUO",2,0,1,0,2,1,0,1,0
"TATTIANA",0,2,0,1,2,0,1,0,1
"TAUHEEDAH",0,2,0,1,2,0,1,0,1
"TAUSHA",0,2,0,1,2,0,1,0,1
"TAVIN",1,1,.5,.5,2,0,0,0,0
"TAWA",1,1,.5,.5,2,0,0,0,0
"TAWAN",0,2,0,1,2,0,1,0,1
"TAWNI",0,2,0,1,2,0,1,0,1
"TAXI",1,1,.5,.5,2,0,0,0,0
"TAYMOUR",2,0,1,0,2,1,0,1,0
"TAYSIA",0,2,0,1,2,0,1,0,1
"TAZIA",0,2,0,1,2,0,1,0,1
"T-BAG",1,1,.5,.5,2,0,0,0,0
"TCHAKA",2,0,1,0,2,1,0,1,0
"TEASHA",0,2,0,1,2,0,1,0,1
"TECHIE",0,2,0,1,2,0,1,0,1
"TEEL",2,0,1,0,2,1,0,1,0
"TEENIE",0,2,0,1,2,0,1,0,1
"TEFLON",2,0,1,0,2,1,0,1,0
"TEGO",2,0,1,0,2,1,0,1,0
"TEILA",0,2,0,1,2,0,1,0,1
"TELIA",0,2,0,1,2,0,1,0,1
"TELISA",0,2,0,1,2,0,1,0,1
"TELISHA",0,2,0,1,2,0,1,0,1
"TEMICA",0,2,0,1,2,0,1,0,1
"TEMILADE",0,2,0,1,2,0,1,0,1
"TEMO",2,0,1,0,2,1,0,1,0
"TENEIKA",0,2,0,1,2,0,1,0,1
"TENNESHA",0,2,0,1,2,0,1,0,1
"TENSIA",0,2,0,1,2,0,1,0,1
"TEOLINDA",0,2,0,1,2,0,1,0,1
"TEQUIA",0,2,0,1,2,0,1,0,1
"TERAN",2,0,1,0,2,1,0,1,0
"TEREK",2,0,1,0,2,1,0,1,0
"TEREL",2,0,1,0,2,1,0,1,0
"TEREZ",0,2,0,1,2,0,1,0,1
"TERIK",2,0,1,0,2,1,0,1,0
"TERRIANNE",0,2,0,1,2,0,1,0,1
"TERRICE",0,2,0,1,2,0,1,0,1
"TERRICK",2,0,1,0,2,1,0,1,0
"TERRILYN",0,2,0,1,2,0,1,0,1
"TERRONE",1,1,.5,.5,2,0,0,0,0
"TESSIER",0,2,0,1,2,0,1,0,1
"THAISA",0,2,0,1,2,0,1,0,1
"THAISHA",0,2,0,1,2,0,1,0,1
"THAMI",1,1,.5,.5,2,0,0,0,0
"THANDIWE",0,2,0,1,2,0,1,0,1
"THAY",1,1,.5,.5,2,0,0,0,0
"THAYNE",2,0,1,0,2,1,0,1,0
"THAYS",0,2,0,1,2,0,1,0,1
"THEADORE",2,0,1,0,2,1,0,1,0
"THEBROOKLYN",2,0,1,0,2,1,0,1,0
"THEDIVA",0,2,0,1,2,0,1,0,1
"THEODOSIA",0,2,0,1,2,0,1,0,1
"THEY",1,1,.5,.5,2,0,0,0,0
"THINA",0,2,0,1,2,0,1,0,1
"THINLAY",1,1,.5,.5,2,0,0,0,0
"THO",1,1,.5,.5,2,0,0,0,0
"THOMASENA",0,2,0,1,2,0,1,0,1
"THOMASINE",0,2,0,1,2,0,1,0,1
"THUMPER",0,2,0,1,2,0,1,0,1
"THURAYA",0,2,0,1,2,0,1,0,1
"THUSHARA",2,0,1,0,2,1,0,1,0
"TIANLE",0,2,0,1,2,0,1,0,1
"TIANXIANG",2,0,1,0,2,1,0,1,0
"TICKETSBROS",0,2,0,1,2,0,1,0,1
"TIFFIANY",0,2,0,1,2,0,1,0,1
"TIGRE",1,1,.5,.5,2,0,0,0,0
"TIJUAN",2,0,1,0,2,1,0,1,0
"TIMESHA",0,2,0,1,2,0,1,0,1
"TIMOUR",2,0,1,0,2,1,0,1,0
"TINEO",2,0,1,0,2,1,0,1,0
"TINKERBELLE",0,2,0,1,2,0,1,0,1
"TIOMA",1,1,.5,.5,2,0,0,0,0
"TIPSY",1,1,.5,.5,2,0,0,0,0
"TISCIA",0,2,0,1,2,0,1,0,1
"TISHAWNA",0,2,0,1,2,0,1,0,1
"TISHONA",0,2,0,1,2,0,1,0,1
"TISSA",1,1,.5,.5,2,0,0,0,0
"TITANIA",0,2,0,1,2,0,1,0,1
"TITIN",0,2,0,1,2,0,1,0,1
"TIWAN",2,0,1,0,2,1,0,1,0
"TIYA",0,2,0,1,2,0,1,0,1
"TOKI",1,1,.5,.5,2,0,0,0,0
"TOLYAN",1,1,.5,.5,2,0,0,0,0
"TOMASITA",0,2,0,1,2,0,1,0,1
"TOMEIKA",0,2,0,1,2,0,1,0,1
"TOMEKIA",0,2,0,1,2,0,1,0,1
"TOMIO",2,0,1,0,2,1,0,1,0
"TOMOHIKO",2,0,1,0,2,1,0,1,0
"TOMOR",2,0,1,0,2,1,0,1,0
"TONGTONG",1,1,.5,.5,2,0,0,0,0
"TONII",0,2,0,1,2,0,1,0,1
"TONKA",1,1,.5,.5,2,0,0,0,0
"TONNI",0,2,0,1,2,0,1,0,1
"TONNIE",1,1,.5,.5,2,0,0,0,0
"TOPANGA",0,2,0,1,2,0,1,0,1
"TOPRAK",2,0,1,0,2,1,0,1,0
"TORCH",1,1,.5,.5,2,0,0,0,0
"TORREAN",2,0,1,0,2,1,0,1,0
"TOS",1,1,.5,.5,2,0,0,0,0
"TOSHIA",0,2,0,1,2,0,1,0,1
"TOSHINORI",2,0,1,0,2,1,0,1,0
"TOTIANA",0,2,0,1,2,0,1,0,1
"TOURIA",0,2,0,1,2,0,1,0,1
"TRACIAN",0,2,0,1,2,0,1,0,1
"TRADER",1,1,.5,.5,2,0,0,0,0
"TRANICE",0,2,0,1,2,0,1,0,1
"TREASHA",0,2,0,1,2,0,1,0,1
"TREBOR",2,0,1,0,2,1,0,1,0
"TREP",2,0,1,0,2,1,0,1,0
"TREVAN",2,0,1,0,2,1,0,1,0
"TRIN",0,2,0,1,2,0,1,0,1
"TRINIE",1,1,.5,.5,2,0,0,0,0
"TRIPPER",2,0,1,0,2,1,0,1,0
"TRISHELLE",0,2,0,1,2,0,1,0,1
"TRISIA",0,2,0,1,2,0,1,0,1
"TRISSA",0,2,0,1,2,0,1,0,1
"TRI-STATE",2,0,1,0,2,1,0,1,0
"TRISTYN",1,1,.5,.5,2,0,0,0,0
"TROELS",2,0,1,0,2,1,0,1,0
"TRONG",2,0,1,0,2,1,0,1,0
"TROYE",2,0,1,0,2,1,0,1,0
"TRUDYANN",0,2,0,1,2,0,1,0,1
"TSAI",2,0,1,0,2,1,0,1,0
"TSILYA",0,2,0,1,2,0,1,0,1
"TUANA",0,2,0,1,2,0,1,0,1
"TUCSON",2,0,1,0,2,1,0,1,0
"TUGRA",2,0,1,0,2,1,0,1,0
"TUM",1,1,.5,.5,2,0,0,0,0
"TURANGA",0,2,0,1,2,0,1,0,1
"TURNING",2,0,1,0,2,1,0,1,0
"TUWANA",0,2,0,1,2,0,1,0,1
"TUWANNA",0,2,0,1,2,0,1,0,1
"TUYA",0,2,0,1,2,0,1,0,1
"TWIX",0,2,0,1,2,0,1,0,1
"TYANN",0,2,0,1,2,0,1,0,1
"TYGA",2,0,1,0,2,1,0,1,0
"TYNEEQUA",0,2,0,1,2,0,1,0,1
"TYNIQUA",0,2,0,1,2,0,1,0,1
"TYREASE",2,0,1,0,2,1,0,1,0
"TYRENE",1,1,.5,.5,2,0,0,0,0
"TYRIKE",2,0,1,0,2,1,0,1,0
"TYRONN",2,0,1,0,2,1,0,1,0
"TYSHAN",2,0,1,0,2,1,0,1,0
"TZALI",2,0,1,0,2,1,0,1,0
"UB",2,0,1,0,2,1,0,1,0
"UBER",2,0,1,0,2,1,0,1,0
"UCHECHI",0,2,0,1,2,0,1,0,1
"UCHENDU",2,0,1,0,2,1,0,1,0
"UG",1,1,.5,.5,2,0,0,0,0
"UKE",2,0,1,0,2,1,0,1,0
"UKEME",0,2,0,1,2,0,1,0,1
"UL",1,1,.5,.5,2,0,0,0,0
"ULGEN",1,1,.5,.5,2,0,0,0,0
"ULLAS",2,0,1,0,2,1,0,1,0
"UMAID",2,0,1,0,2,1,0,1,0
"UMAIMA",0,2,0,1,2,0,1,0,1
"UMBER",0,2,0,1,2,0,1,0,1
"UMIDA",0,2,0,1,2,0,1,0,1
"UMIKA",0,2,0,1,2,0,1,0,1
"UOMO",2,0,1,0,2,1,0,1,0
"UPSCALE",1,1,.5,.5,2,0,0,0,0
"UPTON",2,0,1,0,2,1,0,1,0
"URBAIN",2,0,1,0,2,1,0,1,0
"URIE",2,0,1,0,2,1,0,1,0
"UZOAMAKA",0,2,0,1,2,0,1,0,1
"VADIK",2,0,1,0,2,1,0,1,0
"VAGNER",2,0,1,0,2,1,0,1,0
"VAID",2,0,1,0,2,1,0,1,0
"VALAER",0,2,0,1,2,0,1,0,1
"VALINE",0,2,0,1,2,0,1,0,1
"VALLI",0,2,0,1,2,0,1,0,1
"VALORA",0,2,0,1,2,0,1,0,1
"VAMP",2,0,1,0,2,1,0,1,0
"VANDAL",2,0,1,0,2,1,0,1,0
"VANDI",1,1,.5,.5,2,0,0,0,0
"VANETTE",0,2,0,1,2,0,1,0,1
"VANGEL",2,0,1,0,2,1,0,1,0
"VANY",1,1,.5,.5,2,0,0,0,0
"VARIAN",1,1,.5,.5,2,0,0,0,0
"VARINDA",0,2,0,1,2,0,1,0,1
"VASHTEE",0,2,0,1,2,0,1,0,1
"VASHTY",0,2,0,1,2,0,1,0,1
"VASYLYNA",0,2,0,1,2,0,1,0,1
"VAVA",1,1,.5,.5,2,0,0,0,0
"VAZQUE",0,2,0,1,2,0,1,0,1
"VECTOR",2,0,1,0,2,1,0,1,0
"VEDETTE",0,2,0,1,2,0,1,0,1
"VEENU",1,1,.5,.5,2,0,0,0,0
"VEER",2,0,1,0,2,1,0,1,0
"VENIECE",0,2,0,1,2,0,1,0,1
"VENITIA",0,2,0,1,2,0,1,0,1
"VENNY",1,1,.5,.5,2,0,0,0,0
"VENO",2,0,1,0,2,1,0,1,0
"VENTON",2,0,1,0,2,1,0,1,0
"VERANICA",0,2,0,1,2,0,1,0,1
"VERGEL",2,0,1,0,2,1,0,1,0
"VERGIL",2,0,1,0,2,1,0,1,0
"VERRY",2,0,1,0,2,1,0,1,0
"VIANCEY",1,1,.5,.5,2,0,0,0,0
"VICI",1,1,.5,.5,2,0,0,0,0
"VIGOR",2,0,1,0,2,1,0,1,0
"VILAN",2,0,1,0,2,1,0,1,0
"VILLAR",0,2,0,1,2,0,1,0,1
"VILLI",2,0,1,0,2,1,0,1,0
"VINCIA",0,2,0,1,2,0,1,0,1
"VIR",2,0,1,0,2,1,0,1,0
"VIRAG",2,0,1,0,2,1,0,1,0
"VITALII",2,0,1,0,2,1,0,1,0
"VITALINA",0,2,0,1,2,0,1,0,1
"VITORIO",2,0,1,0,2,1,0,1,0
"VIVIE",0,2,0,1,2,0,1,0,1
"VIVY",0,2,0,1,2,0,1,0,1
"VLADIMYR",2,0,1,0,2,1,0,1,0
"VLADISLAVA",0,2,0,1,2,0,1,0,1
"VLADYSLAV",1,1,.5,.5,2,0,0,0,0
"VOJO",2,0,1,0,2,1,0,1,0
"VONDELL",1,1,.5,.5,2,0,0,0,0
"VONLANTHEN",2,0,1,0,2,1,0,1,0
"VONNETTE",0,2,0,1,2,0,1,0,1
"VONTE",2,0,1,0,2,1,0,1,0
"WADDIE",1,1,.5,.5,2,0,0,0,0
"WADIYA",0,2,0,1,2,0,1,0,1
"WAHKUNA",0,2,0,1,2,0,1,0,1
"WAIWAI",0,2,0,1,2,0,1,0,1
"WALTERS",1,1,.5,.5,2,0,0,0,0
"WANYU",0,2,0,1,2,0,1,0,1
"WARIN",1,1,.5,.5,2,0,0,0,0
"WARISARA",0,2,0,1,2,0,1,0,1
"WARLIN",2,0,1,0,2,1,0,1,0
"WARLORD",2,0,1,0,2,1,0,1,0
"WASHIEKA",0,2,0,1,2,0,1,0,1
"WEEZ",2,0,1,0,2,1,0,1,0
"WEIER",1,1,.5,.5,2,0,0,0,0
"WEIMAR",2,0,1,0,2,1,0,1,0
"WELKIN",2,0,1,0,2,1,0,1,0
"WENBO",2,0,1,0,2,1,0,1,0
"WENCHI",1,1,.5,.5,2,0,0,0,0
"WENDELLA",0,2,0,1,2,0,1,0,1
"WENDYL",2,0,1,0,2,1,0,1,0
"WENHAO",2,0,1,0,2,1,0,1,0
"WESTLEE",2,0,1,0,2,1,0,1,0
"WHISKEY",2,0,1,0,2,1,0,1,0
"WID",1,1,.5,.5,2,0,0,0,0
"WIDLER",2,0,1,0,2,1,0,1,0
"WIDLYNE",0,2,0,1,2,0,1,0,1
"WIENER",0,2,0,1,2,0,1,0,1
"WIGBERTO",2,0,1,0,2,1,0,1,0
"WIKTORIA",0,2,0,1,2,0,1,0,1
"WILANDA",0,2,0,1,2,0,1,0,1
"WILHEM",2,0,1,0,2,1,0,1,0
"WILHEMINA",0,2,0,1,2,0,1,0,1
"WILLIAN",2,0,1,0,2,1,0,1,0
"WILLIETTE",0,2,0,1,2,0,1,0,1
"WILLIN",2,0,1,0,2,1,0,1,0
"WILLISE",0,2,0,1,2,0,1,0,1
"WILLO",1,1,.5,.5,2,0,0,0,0
"WILLONA",0,2,0,1,2,0,1,0,1
"WILMARY",0,2,0,1,2,0,1,0,1
"WILTHON",2,0,1,0,2,1,0,1,0
"WINGATE",1,1,.5,.5,2,0,0,0,0
"WINKY",1,1,.5,.5,2,0,0,0,0
"WINTERS",0,2,0,1,2,0,1,0,1
"WIOLETA",0,2,0,1,2,0,1,0,1
"WISHART",2,0,1,0,2,1,0,1,0
"WITNESS",1,1,.5,.5,2,0,0,0,0
"WOEI",2,0,1,0,2,1,0,1,0
"WOLCOTT",2,0,1,0,2,1,0,1,0
"WONHEE",2,0,1,0,2,1,0,1,0
"WOODLY",2,0,1,0,2,1,0,1,0
"WOODSON",1,1,.5,.5,2,0,0,0,0
"WOOGIE",2,0,1,0,2,1,0,1,0
"WOOHYUNG",2,0,1,0,2,1,0,1,0
"WOOJUN",2,0,1,0,2,1,0,1,0
"WORTH",1,1,.5,.5,2,0,0,0,0
"WOUTER",2,0,1,0,2,1,0,1,0
"WYNONA",0,2,0,1,2,0,1,0,1
"XANIA",0,2,0,1,2,0,1,0,1
"XHINO",2,0,1,0,2,1,0,1,0
"XIANGLIN",1,1,.5,.5,2,0,0,0,0
"XIAOCHEN",1,1,.5,.5,2,0,0,0,0
"XIAOCHENG",2,0,1,0,2,1,0,1,0
"XIAODI",0,2,0,1,2,0,1,0,1
"XIAOFAN",1,1,.5,.5,2,0,0,0,0
"XIAOJIE",0,2,0,1,2,0,1,0,1
"XIAOJIN",1,1,.5,.5,2,0,0,0,0
"XIAOLEI",0,2,0,1,2,0,1,0,1
"XIAOQIONG",0,2,0,1,2,0,1,0,1
"XIAOYUN",0,2,0,1,2,0,1,0,1
"XIAOZHI",2,0,1,0,2,1,0,1,0
"XINE",0,2,0,1,2,0,1,0,1
"XIOMY",0,2,0,1,2,0,1,0,1
"XOTIC",0,2,0,1,2,0,1,0,1
"XTINE",0,2,0,1,2,0,1,0,1
"XTRA",2,0,1,0,2,1,0,1,0
"XUELI",1,1,.5,.5,2,0,0,0,0
"YAAD",2,0,1,0,2,1,0,1,0
"YADIEL",2,0,1,0,2,1,0,1,0
"YAE",0,2,0,1,2,0,1,0,1
"YAHNI",1,1,.5,.5,2,0,0,0,0
"YAJAIDA",0,2,0,1,2,0,1,0,1
"YAKUBU",2,0,1,0,2,1,0,1,0
"YALIAN",0,2,0,1,2,0,1,0,1
"YALING",0,2,0,1,2,0,1,0,1
"YAMAZAKI",2,0,1,0,2,1,0,1,0
"YAMEN",2,0,1,0,2,1,0,1,0
"YANERYS",0,2,0,1,2,0,1,0,1
"YANES",1,1,.5,.5,2,0,0,0,0
"YANESA",0,2,0,1,2,0,1,0,1
"YANFANG",0,2,0,1,2,0,1,0,1
"YANIRE",0,2,0,1,2,0,1,0,1
"YANIZA",0,2,0,1,2,0,1,0,1
"YANPING",0,2,0,1,2,0,1,0,1
"YANSI",2,0,1,0,2,1,0,1,0
"YANSONG",1,1,.5,.5,2,0,0,0,0
"YANTO",2,0,1,0,2,1,0,1,0
"YARILIZ",0,2,0,1,2,0,1,0,1
"YARIM",0,2,0,1,2,0,1,0,1
"YASHEKA",0,2,0,1,2,0,1,0,1
"YASHUNDA",0,2,0,1,2,0,1,0,1
"YASINA",0,2,0,1,2,0,1,0,1
"YASSAR",2,0,1,0,2,1,0,1,0
"YASUAKI",2,0,1,0,2,1,0,1,0
"YASUTAKA",2,0,1,0,2,1,0,1,0
"YASUYUKI",2,0,1,0,2,1,0,1,0
"YATING",0,2,0,1,2,0,1,0,1
"YAVINDRA",2,0,1,0,2,1,0,1,0
"YC",1,1,.5,.5,2,0,0,0,0
"YEDETTA",0,2,0,1,2,0,1,0,1
"YEDIDYAH",2,0,1,0,2,1,0,1,0
"YEEDLE",2,0,1,0,2,1,0,1,0
"YEELING",0,2,0,1,2,0,1,0,1
"YEH",2,0,1,0,2,1,0,1,0
"YENCI",0,2,0,1,2,0,1,0,1
"YENNIFER",0,2,0,1,2,0,1,0,1
"YENSY",2,0,1,0,2,1,0,1,0
"YEONSOO",0,2,0,1,2,0,1,0,1
"YEONSU",0,2,0,1,2,0,1,0,1
"YERACHMIEL",2,0,1,0,2,1,0,1,0
"YERIEL",2,0,1,0,2,1,0,1,0
"YERIN",0,2,0,1,2,0,1,0,1
"YERLAN",2,0,1,0,2,1,0,1,0
"YERLIN",0,2,0,1,2,0,1,0,1
"YERMY",0,2,0,1,2,0,1,0,1
"YESSE",0,2,0,1,2,0,1,0,1
"YIH",0,2,0,1,2,0,1,0,1
"YILDIRIM",2,0,1,0,2,1,0,1,0
"YINAN",1,1,.5,.5,2,0,0,0,0
"YINGLIN",0,2,0,1,2,0,1,0,1
"YIQING",0,2,0,1,2,0,1,0,1
"YIRAN",1,1,.5,.5,2,0,0,0,0
"YIRONG",1,1,.5,.5,2,0,0,0,0
"YISAN",1,1,.5,.5,2,0,0,0,0
"YISELIS",0,2,0,1,2,0,1,0,1
"YISELL",0,2,0,1,2,0,1,0,1
"YISSY",1,1,.5,.5,2,0,0,0,0
"YITZIE",2,0,1,0,2,1,0,1,0
"YIXING",2,0,1,0,2,1,0,1,0
"YIYANG",2,0,1,0,2,1,0,1,0
"YLANDA",0,2,0,1,2,0,1,0,1
"YLKA",0,2,0,1,2,0,1,0,1
"YOANI",0,2,0,1,2,0,1,0,1
"YOANNY",0,2,0,1,2,0,1,0,1
"YOGESHWAR",2,0,1,0,2,1,0,1,0
"YOICHI",2,0,1,0,2,1,0,1,0
"YOJANY",1,1,.5,.5,2,0,0,0,0
"YOLLANDA",0,2,0,1,2,0,1,0,1
"YOMAR",2,0,1,0,2,1,0,1,0
"YONEL",2,0,1,0,2,1,0,1,0
"YONGBOK",1,1,.5,.5,2,0,0,0,0
"YOOJUNG",0,2,0,1,2,0,1,0,1
"YOONKI",1,1,.5,.5,2,0,0,0,0
"YOONMI",0,2,0,1,2,0,1,0,1
"YORIMAR",2,0,1,0,2,1,0,1,0
"YOSHINOBU",2,0,1,0,2,1,0,1,0
"YOUNGHO",2,0,1,0,2,1,0,1,0
"YOUNGJOO",0,2,0,1,2,0,1,0,1
"YOUNGJU",0,2,0,1,2,0,1,0,1
"YOUSRA",0,2,0,1,2,0,1,0,1
"YOUSRI",2,0,1,0,2,1,0,1,0
"YOVEN",2,0,1,0,2,1,0,1,0
"YS",2,0,1,0,2,1,0,1,0
"YSA",0,2,0,1,2,0,1,0,1
"YSIA",0,2,0,1,2,0,1,0,1
"YU-AN",2,0,1,0,2,1,0,1,0
"YUBERKA",0,2,0,1,2,0,1,0,1
"YUBERKIS",0,2,0,1,2,0,1,0,1
"YUHI",2,0,1,0,2,1,0,1,0
"YUICHIRO",2,0,1,0,2,1,0,1,0
"YUKE",1,1,.5,.5,2,0,0,0,0
"YUKIO",2,0,1,0,2,1,0,1,0
"YULETTE",0,2,0,1,2,0,1,0,1
"YULIET",0,2,0,1,2,0,1,0,1
"YULLY",0,2,0,1,2,0,1,0,1
"YULYA",0,2,0,1,2,0,1,0,1
"YUMEE",0,2,0,1,2,0,1,0,1
"YUMEI",0,2,0,1,2,0,1,0,1
"YU-MING",1,1,.5,.5,2,0,0,0,0
"YUNFAN",1,1,.5,.5,2,0,0,0,0
"YUNJIN",0,2,0,1,2,0,1,0,1
"YUNSOO",2,0,1,0,2,1,0,1,0
"YURIDIANA",0,2,0,1,2,0,1,0,1
"YVA",0,2,0,1,2,0,1,0,1
"YVANNA",0,2,0,1,2,0,1,0,1
"YVANNE",0,2,0,1,2,0,1,0,1
"YVONNA",0,2,0,1,2,0,1,0,1
"ZAARA",0,2,0,1,2,0,1,0,1
"ZACHARI",2,0,1,0,2,1,0,1,0
"ZACHY",2,0,1,0,2,1,0,1,0
"ZAE",1,1,.5,.5,2,0,0,0,0
"ZAHIDUR",2,0,1,0,2,1,0,1,0
"ZAHOOR",2,0,1,0,2,1,0,1,0
"ZAKEEYAH",0,2,0,1,2,0,1,0,1
"ZAKKIYYA",0,2,0,1,2,0,1,0,1
"ZAKLINA",0,2,0,1,2,0,1,0,1
"ZAMEER",2,0,1,0,2,1,0,1,0
"ZAMENA",0,2,0,1,2,0,1,0,1
"ZAPATA",2,0,1,0,2,1,0,1,0
"ZAPP",2,0,1,0,2,1,0,1,0
"ZARAIDA",0,2,0,1,2,0,1,0,1
"ZARRAH",0,2,0,1,2,0,1,0,1
"ZAVALA",2,0,1,0,2,1,0,1,0
"ZAWAD",2,0,1,0,2,1,0,1,0
"ZECHARIAH",2,0,1,0,2,1,0,1,0
"ZEEMA",0,2,0,1,2,0,1,0,1
"ZEESY",0,2,0,1,2,0,1,0,1
"ZELFDEN",2,0,1,0,2,1,0,1,0
"ZENAB",0,2,0,1,2,0,1,0,1
"ZENGWEI",2,0,1,0,2,1,0,1,0
"ZENJA",0,2,0,1,2,0,1,0,1
"ZERINA",0,2,0,1,2,0,1,0,1
"ZERLINDA",0,2,0,1,2,0,1,0,1
"ZHIHAO",2,0,1,0,2,1,0,1,0
"ZHIMING",2,0,1,0,2,1,0,1,0
"ZHIYUAN",1,1,.5,.5,2,0,0,0,0
"ZHUOYING",0,2,0,1,2,0,1,0,1
"ZIGG",1,1,.5,.5,2,0,0,0,0
"ZIJUN",1,1,.5,.5,2,0,0,0,0
"ZILMA",0,2,0,1,2,0,1,0,1
"ZILVINAS",2,0,1,0,2,1,0,1,0
"ZIO",2,0,1,0,2,1,0,1,0
"ZIOMARA",0,2,0,1,2,0,1,0,1
"ZIPORA",0,2,0,1,2,0,1,0,1
"ZIQI",1,1,.5,.5,2,0,0,0,0
"ZIYI",0,2,0,1,2,0,1,0,1
"ZMAN",2,0,1,0,2,1,0,1,0
"ZOHAN",2,0,1,0,2,1,0,1,0
"ZOHN",2,0,1,0,2,1,0,1,0
"ZOIA",0,2,0,1,2,0,1,0,1
"ZOLO",2,0,1,0,2,1,0,1,0
"ZON",0,2,0,1,2,0,1,0,1
"ZONELLA",0,2,0,1,2,0,1,0,1
"ZOOS",2,0,1,0,2,1,0,1,0
"ZORALLA",0,2,0,1,2,0,1,0,1
"ZORIDA",0,2,0,1,2,0,1,0,1
"ZRII",0,2,0,1,2,0,1,0,1
"ZUBIA",0,2,0,1,2,0,1,0,1
"ZUFAN",0,2,0,1,2,0,1,0,1
"ZULEYMA",0,2,0,1,2,0,1,0,1
"ZULFIA",0,2,0,1,2,0,1,0,1
"ZULIE",1,1,.5,.5,2,0,0,0,0
"ZUMBA",0,2,0,1,2,0,1,0,1
"ZURA",2,0,1,0,2,1,0,1,0
"ZURAB",2,0,1,0,2,1,0,1,0
"ZURIA",0,2,0,1,2,0,1,0,1
